id,symbol,date,zero_balance_addresses_all_time,unique_addresses_all_time,new_addresses,active_addresses,total_addresses_all_time,transaction_count,transaction_count_all_time,large_transaction_count,average_transaction_value,block_height,hashrate,difficulty,block_time,block_size,current_supply
1182,BTC,2009-09-01,1272,22099,78,78,22099,78,22162,0,50.0,22017,4.07788606261483e-06,1.0,1053.23376623377,215,1100900.0
1182,BTC,2009-09-02,1272,22165,66,66,22165,66,22228,0,50.0,22083,3.37316040066213e-06,1.0,1273.27692307692,215,1104200.0
1182,BTC,2009-09-03,1286,22226,61,76,22226,62,22290,0,60.4838709677419,22144,3.02661418021235e-06,1.0,1419.06666666667,242,1107250.0
1182,BTC,2009-09-04,1286,22290,64,64,22290,64,22354,0,50.0,22208,3.25317631076646e-06,1.0,1320.23809523809,215,1110450.0
1182,BTC,2009-09-05,1286,22366,76,76,22366,76,22430,0,50.0,22284,3.77913989464669e-06,1.0,1136.49333333333,215,1114250.0
1182,BTC,2009-09-06,1286,22434,68,68,22434,68,22498,0,50.0,22352,3.53096198426936e-06,1.0,1216.37313432836,215,1117650.0
1182,BTC,2009-09-07,1299,22512,78,92,22512,79,22577,0,57.5949367088608,22430,3.84343818180973e-06,1.0,1117.48051948052,235,1121550.0
1182,BTC,2009-09-08,1299,22581,69,69,22581,69,22646,0,50.0,22499,3.45413854183766e-06,1.0,1243.42647058824,215,1125000.0
1182,BTC,2009-09-09,1299,22635,54,54,22635,54,22700,0,50.0,22553,2.69213253725977e-06,1.0,1595.37735849057,215,1127700.0
1182,BTC,2009-09-10,1299,22702,67,67,22702,67,22767,0,50.0,22620,3.32845466489755e-06,1.0,1290.37878787879,215,1131050.0
1182,BTC,2009-09-11,1299,22769,67,67,22769,67,22834,0,50.0,22687,3.30601730212379e-06,1.0,1299.13636363636,215,1134400.0
1182,BTC,2009-09-12,1299,22838,69,69,22838,69,22903,0,50.0,22756,3.48967375768293e-06,1.0,1230.76470588235,215,1137850.0
1182,BTC,2009-09-13,1299,22913,75,75,22913,75,22978,0,50.0,22831,3.74986821034251e-06,1.0,1145.36486486487,215,1141600.0
1182,BTC,2009-09-14,1299,22987,74,74,22987,74,23052,0,50.0,22905,3.79887575403778e-06,1.0,1130.58904109589,215,1145300.0
1182,BTC,2009-09-15,1299,23031,44,44,23031,44,23096,0,50.0,22949,2.33930680610022e-06,1.0,1836.0,215,1147500.0
1182,BTC,2009-09-16,1300,23103,72,74,23103,73,23169,0,49.3287671232877,23021,3.70035649038333e-06,1.0,1160.69014084507,218,1151100.0
1182,BTC,2009-09-17,1400,23187,84,186,23187,85,23254,0,108.823529411765,23105,4.24489795744174e-06,1.0,1011.79518072289,354,1155300.0
1182,BTC,2009-09-18,1400,23265,78,78,23265,78,23332,0,50.0,23183,3.90769909125498e-06,1.0,1099.1038961039,215,1159200.0
1182,BTC,2009-09-19,1400,23339,74,74,23339,74,23406,0,50.0,23257,3.63478144434784e-06,1.0,1181.6301369863,215,1162900.0
1182,BTC,2009-09-20,1400,23417,78,78,23417,78,23484,0,50.0,23335,3.8992675948782e-06,1.0,1101.48051948052,215,1166800.0
1182,BTC,2009-09-21,1408,23486,69,78,23486,70,23554,0,55.0,23404,3.43917024208382e-06,1.0,1248.83823529412,229,1170250.0
1182,BTC,2009-09-22,1448,23511,25,66,23511,26,23580,0,125.0,23429,1.2779312815859e-06,1.0,3360.875,399,1171500.0
1182,BTC,2009-09-23,1448,23547,36,36,23547,36,23616,0,50.0,23465,1.77091188502091e-06,1.0,2425.28571428571,215,1173300.0
1182,BTC,2009-09-24,1448,23644,97,97,23644,97,23713,0,50.0,23562,4.86601435570137e-06,1.0,882.645833333333,215,1178150.0
1182,BTC,2009-09-25,1474,23735,91,119,23735,93,23806,0,62.9032258064516,23653,4.55114626227424e-06,1.0,943.711111111111,249,1182700.0
1182,BTC,2009-09-26,1474,23835,100,100,23835,100,23906,0,50.0,23753,4.99285787445104e-06,1.0,860.222222222222,215,1187700.0
1182,BTC,2009-09-27,1490,23922,87,104,23922,88,23994,0,58.5227272727273,23840,4.28326303074158e-06,1.0,1002.73255813954,237,1192050.0
1182,BTC,2009-09-28,1490,24007,85,85,24007,85,24079,0,50.0,23925,4.212522218299e-06,1.0,1019.57142857143,215,1196300.0
1182,BTC,2009-09-29,1533,24095,88,133,24095,90,24169,0,72.7777777777778,24013,4.44804126790944e-06,1.0,965.586206896552,272,1200700.0
1182,BTC,2009-09-30,1533,24180,85,85,24180,85,24254,0,50.0,24098,4.31758320804212e-06,1.0,994.761904761905,215,1204950.0
1182,BTC,2009-10-01,1533,24262,82,82,24262,82,24336,0,50.0,24180,4.1229731446924e-06,1.0,1041.71604938272,215,1209050.0
1182,BTC,2009-10-02,1543,24334,72,83,24334,73,24409,0,56.1643835616438,24252,3.63719797251909e-06,1.0,1180.84507042253,232,1212650.0
1182,BTC,2009-10-03,1543,24392,58,58,24392,58,24467,0,50.0,24310,2.91649058114628e-06,1.0,1472.64912280702,215,1215550.0
1182,BTC,2009-10-04,1543,24445,53,53,24445,53,24520,0,50.0,24363,2.67004159663343e-06,1.0,1608.57692307692,215,1218200.0
1182,BTC,2009-10-05,1543,24500,55,55,24500,55,24575,0,50.0,24418,2.7637154158653e-06,1.0,1554.05555555556,215,1220950.0
1182,BTC,2009-10-06,1557,24544,44,58,24544,45,24620,0,67.7777777777778,24461,2.35571173923604e-06,1.0,1823.21428571429,259,1223100.0
1182,BTC,2009-10-07,1557,24604,60,60,24604,60,24680,0,50.0,24521,3.07304232917779e-06,1.0,1397.62711864407,215,1226100.0
1182,BTC,2009-10-08,1557,24674,70,70,24674,70,24750,0,50.0,24591,3.50630316403218e-06,1.0,1224.92753623188,215,1229600.0
1182,BTC,2009-10-09,1557,24753,79,79,24753,79,24829,0,50.0,24671,3.98282606836042e-06,1.0,1078.37179487179,215,1233550.0
1182,BTC,2009-10-10,1557,24830,77,77,24830,77,24906,0,50.0,24747,3.83677552419014e-06,1.0,1119.42105263158,215,1237400.0
1182,BTC,2009-10-11,1557,24904,74,74,24904,74,24980,0,50.0,24821,3.66533332485387e-06,1.0,1171.78082191781,215,1241100.0
1182,BTC,2009-10-12,1629,24962,58,132,24962,59,25039,0,134.745762711864,24879,2.93621905168092e-06,1.0,1462.75438596491,364,1244000.0
1182,BTC,2009-10-13,1629,25019,57,57,25019,57,25096,0,50.0,24936,2.81907884122928e-06,1.0,1523.53571428571,215,1246850.0
1182,BTC,2009-10-14,1629,25088,69,69,25088,69,25165,0,50.0,25005,3.48264122927225e-06,1.0,1233.25,215,1250300.0
1182,BTC,2009-10-15,1629,25159,71,71,25159,71,25236,0,50.0,25076,3.53653261563074e-06,1.0,1214.45714285714,215,1253850.0
1182,BTC,2009-10-16,1709,25220,61,141,25220,61,25297,0,208.196721311475,25136,3.00732323543234e-06,1.0,1428.16949152542,372,1256850.0
1182,BTC,2009-10-17,1709,25277,57,57,25277,57,25354,0,50.0,25193,2.83914499883138e-06,1.0,1512.76785714286,215,1259700.0
1182,BTC,2009-10-18,1716,25351,74,82,25351,75,25429,0,54.0,25267,3.69592385665787e-06,1.0,1162.08219178082,226,1263400.0
1182,BTC,2009-10-19,1716,25463,112,112,25463,112,25541,0,50.0,25379,5.56771739723916e-06,1.0,771.405405405405,215,1269000.0
1182,BTC,2009-10-20,1816,25558,95,197,25558,96,25637,0,102.082083333333,25474,4.70341374726517e-06,1.0,913.159574468085,337,1273750.0
1182,BTC,2009-10-21,1834,25638,80,99,25638,81,25718,0,60.4908641975309,25554,4.02412818748295e-06,1.0,1067.30379746835,241,1277750.0
1182,BTC,2009-10-22,1873,25729,91,130,25729,91,25809,0,180.769230769231,25644,4.44556712617317e-06,1.0,966.123595505618,268,1282250.0
1182,BTC,2009-10-23,1873,25818,89,89,25818,89,25898,0,50.0,25733,4.53490499673642e-06,1.0,947.090909090909,215,1286700.0
1182,BTC,2009-10-24,1880,25881,63,70,25881,63,25961,0,243.650793650794,25795,3.14219413828422e-06,1.0,1366.86885245902,230,1289800.0
1182,BTC,2009-10-25,1880,25957,76,76,25957,76,26037,0,50.0,25871,3.87250303190594e-06,1.0,1109.09333333333,215,1293600.0
1182,BTC,2009-10-26,1880,26028,71,71,26028,71,26108,0,50.0,25942,3.55510016460127e-06,1.0,1208.11428571429,215,1297150.0
1182,BTC,2009-10-27,1896,26093,65,81,26093,65,26173,0,249.230769230769,26006,3.2558381321429e-06,1.0,1319.15873015873,245,1300350.0
1182,BTC,2009-10-28,1896,26159,66,66,26159,66,26239,0,50.0,26072,3.46988259719598e-06,1.0,1237.78461538461,215,1303650.0
1182,BTC,2009-10-29,1937,26205,46,89,26205,48,26287,0,90.625,26118,2.24303702527679e-06,1.0,1914.8,319,1305950.0
1182,BTC,2009-10-30,1937,26265,60,60,26265,60,26347,0,50.0,26178,3.01605692189769e-06,1.0,1424.03389830508,215,1308950.0
1182,BTC,2009-10-31,1937,26311,46,46,26311,46,26393,0,50.0,26224,2.2711609809751e-06,1.0,1891.08888888889,215,1311250.0
1182,BTC,2009-11-01,1937,26336,25,25,26336,25,26418,0,50.0,26249,1.20056389084429e-06,1.0,3577.45833333333,215,1312500.0
1182,BTC,2009-11-02,1937,26369,33,33,26369,33,26451,0,50.0,26282,1.64927403876015e-06,1.0,2604.15625,215,1314150.0
1182,BTC,2009-11-03,1937,26431,62,62,26431,62,26513,0,50.0,26344,3.15194722219415e-06,1.0,1362.63934426229,215,1317250.0
1182,BTC,2009-11-04,1978,26495,64,105,26495,64,26577,0,291.40625,26407,3.12540900167838e-06,1.0,1374.20967741936,294,1320400.0
1182,BTC,2009-11-05,1978,26552,57,57,26552,57,26634,0,50.0,26464,2.92206592771319e-06,1.0,1469.83928571429,215,1323250.0
1182,BTC,2009-11-06,1978,26614,62,62,26614,62,26696,0,50.0,26526,3.11744273694982e-06,1.0,1377.72131147541,215,1326350.0
1182,BTC,2009-11-07,1978,26683,69,69,26683,69,26765,0,50.0,26595,3.49790737323193e-06,1.0,1227.86764705882,215,1329800.0
1182,BTC,2009-11-08,1978,26756,73,73,26756,73,26838,0,50.0,26668,3.60580736362682e-06,1.0,1191.125,215,1333450.0
1182,BTC,2009-11-09,1978,26820,64,64,26820,64,26902,0,50.0,26732,3.16763956928624e-06,1.0,1355.88888888889,215,1336650.0
1182,BTC,2009-11-10,1978,26898,78,78,26898,78,26980,0,50.0,26810,3.9004172922431e-06,1.0,1101.15584415584,215,1340550.0
1182,BTC,2009-11-11,2029,26963,65,116,26963,73,27053,0,1276.71232876712,26874,3.25791580956968e-06,1.0,1318.31746031746,331,1343750.0
1182,BTC,2009-11-12,2029,27029,66,66,27029,66,27119,0,50.0,26940,3.27925568510448e-06,1.0,1309.73846153846,215,1347050.0
1182,BTC,2009-11-13,2040,27110,81,93,27110,83,27202,0,55.421686746988,27020,4.12636104956949e-06,1.0,1040.86075949367,238,1351050.0
1182,BTC,2009-11-14,2040,27189,79,79,27189,79,27281,0,50.0,27099,4.06355315358676e-06,1.0,1056.94871794872,215,1355000.0
1182,BTC,2009-11-15,2040,27285,96,96,27285,96,27377,0,50.0,27195,4.83592965901414e-06,1.0,888.136842105263,215,1359800.0
1182,BTC,2009-11-16,2040,27382,97,97,27382,97,27474,0,50.0,27292,4.84053604620803e-06,1.0,887.291666666667,215,1364650.0
1182,BTC,2009-11-17,2040,27474,92,92,27474,92,27566,0,50.0,27384,4.56452507341228e-06,1.0,940.945054945055,215,1369250.0
1182,BTC,2009-11-18,2040,27553,79,79,27553,79,27645,0,50.0,27463,3.91117109636444e-06,1.0,1098.12820512821,215,1373200.0
1182,BTC,2009-11-19,2122,27625,72,153,27625,72,27717,0,664.583333333333,27533,3.46578967376152e-06,1.0,1239.24637681159,375,1376700.0
1182,BTC,2009-11-20,2122,27711,86,86,27711,86,27803,0,50.0,27619,4.34439113395928e-06,1.0,988.623529411765,215,1381000.0
1182,BTC,2009-11-21,2122,27784,73,73,27784,73,27876,0,50.0,27692,3.61537687132602e-06,1.0,1187.97222222222,215,1384650.0
1182,BTC,2009-11-22,2122,27890,106,106,27890,106,27982,0,50.0,27798,5.27186989093205e-06,1.0,814.695238095238,215,1389950.0
1182,BTC,2009-11-23,2122,27986,96,96,27986,96,28078,0,50.0,27894,4.74874762133097e-06,1.0,904.442105263158,215,1394750.0
1182,BTC,2009-11-24,2122,28079,93,93,28079,93,28171,0,50.0,27987,4.65381705924198e-06,1.0,922.891304347826,215,1399400.0
1182,BTC,2009-11-25,2122,28169,90,90,28169,90,28261,0,50.0,28077,4.52032318323617e-06,1.0,950.14606741573,215,1403900.0
1182,BTC,2009-11-26,2122,28253,84,84,28253,84,28345,0,50.0,28161,4.16899337568415e-06,1.0,1030.21686746988,215,1408100.0
1182,BTC,2009-11-27,2122,28327,74,74,28327,74,28419,0,50.0,28235,3.6361303606527e-06,1.0,1181.19178082192,215,1411800.0
1182,BTC,2009-11-28,2122,28398,71,71,28398,71,28490,0,50.0,28306,3.51910515515082e-06,1.0,1220.47142857143,215,1415350.0
1182,BTC,2009-11-29,2122,28458,60,60,28458,60,28550,0,50.0,28366,2.94706135330581e-06,1.0,1457.37288135593,215,1418350.0
1182,BTC,2009-11-30,2122,28533,75,75,28533,75,28625,0,50.0,28441,3.75385427503041e-06,1.0,1144.14864864865,215,1422100.0
1182,BTC,2009-12-01,2286,28608,75,240,28608,74,28699,0,185.135135135135,28514,3.69693647485265e-06,1.0,1161.76388888889,483,1425750.0
1182,BTC,2009-12-02,2286,28702,94,94,28702,94,28793,0,50.0,28608,4.69246444547826e-06,1.0,915.290322580645,215,1430450.0
1182,BTC,2009-12-03,2286,28790,88,88,28790,88,28881,0,50.0,28696,4.63278807220789e-06,1.0,927.080459770115,215,1434850.0
1182,BTC,2009-12-04,2286,28826,36,36,28826,36,28917,0,50.0,28732,1.80871190768972e-06,1.0,2374.6,215,1436650.0
1182,BTC,2009-12-05,2304,28892,66,84,28892,65,28982,0,63.0769230769231,28796,3.20046057895795e-06,1.0,1341.98412698413,249,1439850.0
1182,BTC,2009-12-06,2307,28997,105,107,28997,105,29087,0,50.3809523809524,28899,5.25939617979255e-06,1.0,816.627450980392,220,1445000.0
1182,BTC,2009-12-07,2307,29109,112,112,29109,112,29199,0,50.0,29011,5.69318202815892e-06,1.0,754.405405405405,215,1450600.0
1182,BTC,2009-12-08,2337,29214,105,136,29214,107,29306,0,63.0841121495327,29116,5.33077858010311e-06,1.0,805.692307692307,249,1455850.0
1182,BTC,2009-12-09,2352,29321,107,119,29321,109,29415,0,65.6422018348624,29212,4.92524284634791e-06,1.0,872.031578947369,263,1460650.0
1182,BTC,2009-12-10,2352,29425,104,104,29425,104,29519,0,50.0,29316,5.18254020018744e-06,1.0,828.73786407767,215,1465850.0
1182,BTC,2009-12-11,2352,29537,112,112,29537,112,29631,0,50.0,29428,5.72854978077912e-06,1.0,749.747747747748,215,1471450.0
1182,BTC,2009-12-12,2418,29647,110,178,29647,112,29743,0,95.5357142857143,29538,5.50462021310569e-06,1.0,780.247706422018,286,1476950.0
1182,BTC,2009-12-13,2418,29761,114,114,29761,114,29857,0,50.0,29652,5.65614647516491e-06,1.0,759.345132743363,215,1482650.0
1182,BTC,2009-12-14,2749,29868,107,437,29868,107,29964,0,351.828971962617,29754,5.07958754664574e-06,1.0,845.534653465347,591,1487750.0
1182,BTC,2009-12-15,2754,29979,111,119,29979,112,30076,0,97.8482142857143,29864,5.51733550888027e-06,1.0,778.449541284404,226,1493250.0
1182,BTC,2009-12-16,2771,30116,137,154,30116,137,30213,0,55.8394160583942,30000,6.81316269649719e-06,1.0,630.392592592592,230,1500050.0
1182,BTC,2009-12-17,2777,30288,172,179,30288,172,30385,0,50.8691860465116,30169,8.36197132608645e-06,1.0,513.630952380952,224,1508500.0
1182,BTC,2009-12-18,2777,30513,225,225,30513,225,30610,0,50.0,30394,1.12030447890447e-05,1.0,383.375,215,1519750.0
1182,BTC,2009-12-19,2778,30711,198,200,30711,199,30809,0,50.0,30592,9.88179060897189e-06,1.0,434.634517766497,216,1529650.0
1182,BTC,2009-12-20,2778,30886,175,175,30886,175,30984,0,50.0,30767,8.90032048095657e-06,1.0,482.563218390805,215,1538400.0
1182,BTC,2009-12-21,2779,31062,176,177,31062,176,31160,0,50.0,30942,8.72869067479589e-06,1.0,492.051724137931,216,1547150.0
1182,BTC,2009-12-22,2779,31224,162,162,31224,162,31322,0,50.0,31104,8.08514059649697e-06,1.0,531.217391304348,215,1555250.0
1182,BTC,2009-12-23,2779,31378,154,154,31378,154,31476,0,50.0,31258,7.61942855489077e-06,1.0,563.686274509804,215,1562950.0
1182,BTC,2009-12-24,2779,31532,154,154,31532,154,31630,0,50.0,31412,7.64931840581093e-06,1.0,561.483660130719,215,1570650.0
1182,BTC,2009-12-25,2779,31682,150,151,31682,150,31780,0,50.0,31561,7.48111241653328e-06,1.0,574.108108108108,217,1578100.0
1182,BTC,2009-12-26,2779,31856,174,174,31856,174,31954,0,50.0,31735,8.64329318809762e-06,1.0,496.913294797688,215,1586800.0
1182,BTC,2009-12-27,2784,32024,168,173,32024,168,32122,0,51.1904761904762,31902,8.45345709196111e-06,1.0,508.072289156626,219,1595150.0
1182,BTC,2009-12-28,2784,32161,137,137,32161,137,32259,0,50.0,32039,6.97976450650639e-06,1.0,615.345588235294,215,1602000.0
1182,BTC,2009-12-29,2784,32332,171,171,32332,171,32430,0,50.0,32210,8.71450069009966e-06,1.0,492.85294117647,215,1610550.0
1182,BTC,2009-12-30,2784,32473,141,141,32473,141,32571,0,50.0,32351,7.84760445128277e-06,1.12452734251087,615.45,215,1617600.0
1182,BTC,2009-12-31,2784,32611,138,138,32611,138,32709,0,50.0,32489,8.48869479313175e-06,1.18289953431284,598.503649635036,215,1624500.0
1182,BTC,2010-01-01,2786,32745,134,136,32745,134,32843,0,50.0,32622,7.80453628383825e-06,1.18289953431284,650.969465648855,217,1631100.0
1182,BTC,2010-01-02,2786,32871,126,126,32871,126,32969,0,50.0,32747,7.59192291441614e-06,1.18289953431284,669.2,215,1637400.0
1182,BTC,2010-01-03,2786,33057,186,186,33057,186,33155,0,50.0,32933,1.12953244240611e-05,1.18289953431284,449.789189189189,215,1646700.0
1182,BTC,2010-01-04,2868,33240,183,266,33240,183,33338,0,163.138524590164,33114,1.0636480297974e-05,1.18289953431284,477.65,269,1655750.0
1182,BTC,2010-01-05,2868,33438,198,198,33438,198,33536,0,50.0,33312,1.16107866315063e-05,1.18289953431284,437.568527918782,215,1665650.0
1182,BTC,2010-01-06,2868,33601,163,163,33601,163,33699,0,50.0,33475,9.67523716507012e-06,1.18289953431284,525.104938271605,215,1673800.0
1182,BTC,2010-01-07,2868,33755,154,154,33755,154,33853,0,50.0,33629,9.03785466987656e-06,1.18289953431284,562.137254901961,215,1681500.0
1182,BTC,2010-01-08,2868,33908,153,153,33908,153,34006,0,50.0,33782,8.9632556267439e-06,1.18289953431284,566.815789473684,215,1689150.0
1182,BTC,2010-01-09,2868,34059,151,151,34059,151,34157,0,50.0,33933,8.90807867010826e-06,1.18289953431284,570.326666666667,215,1696700.0
1182,BTC,2010-01-10,2868,34249,190,190,34249,190,34347,0,50.0,34123,1.12170986987355e-05,1.18289953431284,452.925925925926,215,1706200.0
1182,BTC,2010-01-11,2868,34408,159,159,34408,159,34506,0,50.0,34282,9.56345899624876e-06,1.1913510347535,535.037974683544,215,1714150.0
1182,BTC,2010-01-12,3082,34567,159,375,34567,161,34667,0,116.458881987578,34441,1.05786266939071e-05,1.30506213159152,529.860759493671,372,1722100.0
1182,BTC,2010-01-13,3082,34733,166,168,34733,166,34833,0,49.7469879518072,34605,1.06537869986787e-05,1.30506213159152,526.122699386503,218,1730300.0
1182,BTC,2010-01-14,3091,34878,145,155,34878,145,34978,0,52.1034482758621,34748,9.55026616555372e-06,1.30506213159152,586.915492957746,224,1737450.0
1182,BTC,2010-01-15,3096,35019,141,147,35019,142,35120,0,51.0615492957746,34889,9.13717364811092e-06,1.30506213159152,613.45,219,1744500.0
1182,BTC,2010-01-16,3102,35145,126,132,35145,126,35246,0,51.5952380952381,35014,8.12775182868236e-06,1.30506213159152,689.637096774194,222,1750750.0
1182,BTC,2010-01-17,3102,35276,131,131,35276,131,35377,0,50.0,35145,8.58953346782943e-06,1.30506213159152,652.561538461538,215,1757300.0
1182,BTC,2010-01-18,3103,35403,127,128,35403,126,35503,0,50.0,35270,8.12053484162788e-06,1.30506213159152,690.25,217,1763550.0
1182,BTC,2010-01-19,3103,35527,124,124,35527,124,35627,0,50.0,35394,8.0707939040005e-06,1.30506213159152,694.50406504065,215,1769750.0
1182,BTC,2010-01-20,3103,35685,158,158,35685,158,35785,0,50.0,35552,1.02216936381132e-05,1.30506213159152,548.363057324841,215,1777650.0
1182,BTC,2010-01-21,3114,35868,183,187,35868,184,35969,0,51.2950543478261,35727,1.14078725565707e-05,1.30506213159152,491.344827586207,235,1786400.0
1182,BTC,2010-01-22,3119,36003,135,141,36003,136,36105,0,50.7352941176471,35860,8.57272632608295e-06,1.30506213159152,653.840909090909,221,1793050.0
1182,BTC,2010-01-23,3120,36164,161,164,36164,162,36267,0,49.6975308641975,36020,1.04228503951133e-05,1.30506213159152,537.779874213837,218,1801050.0
1182,BTC,2010-01-24,3121,36318,154,156,36318,155,36422,0,50.0,36174,9.98330062615215e-06,1.30506213159152,561.457516339869,216,1808750.0
1182,BTC,2010-01-25,3178,36533,215,272,36533,215,36637,0,64.4186046511628,36385,1.39616490686027e-05,1.32325150713461,407.066666666667,251,1819300.0
1182,BTC,2010-01-26,3194,36730,197,215,36730,201,36838,0,52.8507462686567,36580,1.3142462056699e-05,1.34422497077103,439.29381443299,230,1829050.0
1182,BTC,2010-01-27,3214,36894,164,181,36894,166,37004,0,55.421686746988,36744,1.09925892480029e-05,1.34422497077103,525.208588957055,230,1837250.0
1182,BTC,2010-01-28,3235,37071,177,199,37071,179,37183,0,55.3072625698324,36921,1.19411333663402e-05,1.34422497077103,483.488636363636,229,1846100.0
1182,BTC,2010-01-29,3254,37269,198,213,37269,201,37384,0,53.7313432835821,37118,1.31332472369944e-05,1.34422497077103,439.602040816326,227,1855950.0
1182,BTC,2010-01-30,3287,37481,212,248,37481,214,37598,0,57.0093457943925,37328,1.40616130586636e-05,1.34422497077103,410.578947368421,235,1866450.0
1182,BTC,2010-01-31,3305,37647,166,184,37647,167,37765,0,55.9880239520958,37493,1.10124329803814e-05,1.34422497077103,524.262195121952,229,1874700.0
1182,BTC,2010-02-01,3322,37839,192,203,37839,193,37958,0,61.139896373057,37677,1.24049855429241e-05,1.34422497077103,465.409836065574,233,1883900.0
1182,BTC,2010-02-02,3343,37984,145,167,37984,146,38104,0,56.8493150684931,37822,1.00130066538396e-05,1.34422497077103,576.590277777777,232,1891150.0
1182,BTC,2010-02-03,3349,38254,270,277,38254,272,38376,0,50.7352941176471,38092,1.80714834411928e-05,1.34422497077103,319.475836431227,218,1904650.0
1182,BTC,2010-02-04,3390,38487,233,269,38487,234,38610,0,57.692264957265,38321,1.58130394592757e-05,1.38151590604063,375.232456140351,237,1916100.0
1182,BTC,2010-02-05,3634,38714,227,472,38714,227,38837,0,103.079295154185,38544,2.02299425880181e-05,1.81864853614541,386.112612612613,342,1927250.0
1182,BTC,2010-02-06,3664,38908,194,224,38908,206,39043,0,56.7961165048544,38736,1.73689722715129e-05,1.81864853614541,449.712041884817,237,1936850.0
1182,BTC,2010-02-07,3674,39130,222,230,39130,222,39265,0,51.1216216216216,38953,1.98723663196331e-05,1.81864853614541,393.060185185185,222,1947700.0
1182,BTC,2010-02-08,3797,39335,205,329,39335,208,39473,0,80.3028846153846,39153,1.80722725397849e-05,1.81864853614541,432.211055276382,290,1957700.0
1182,BTC,2010-02-09,4214,39545,210,623,39545,210,39683,0,148.809523809524,39360,1.86598178523813e-05,1.81864853614541,418.601941747573,446,1968050.0
1182,BTC,2010-02-10,4820,39714,169,777,39714,173,39856,0,223.699421965318,39528,1.52240585601075e-05,1.81864853614541,513.071856287425,628,1976450.0
1182,BTC,2010-02-11,4894,39883,169,245,39883,174,40030,0,69.8275862068966,39697,1.52882779037602e-05,1.81864853614541,510.916666666667,266,1984900.0
1182,BTC,2010-02-12,4933,40070,187,225,40070,188,40218,0,89.3617021276596,39880,1.69170639192545e-05,1.81864853614541,461.725274725275,255,1994050.0
1182,BTC,2010-02-13,5018,40304,234,318,40304,235,40453,0,75.7404255319149,40112,2.11698577140993e-05,1.81864853614541,368.969696969697,258,2005650.0
1182,BTC,2010-02-14,5071,40516,212,263,40516,219,40672,0,137.098219178082,40320,1.88929034091177e-05,1.82205762114026,414.212560386473,252,2016050.0
1182,BTC,2010-02-15,5162,40699,183,271,40699,185,40857,0,72.1620540540541,40496,2.2184170957619e-05,2.52773821507236,489.382857142857,278,2024850.0
1182,BTC,2010-02-16,5178,40898,199,217,40898,201,41058,0,52.3053233830846,40691,2.43840379220553e-05,2.52773821507236,445.231958762887,227,2034600.0
1182,BTC,2010-02-17,5201,41141,243,267,41141,250,41308,0,282.69,40930,3.01163178475369e-05,2.52773821507236,360.487394957983,234,2046550.0
1182,BTC,2010-02-18,5259,41352,211,267,41352,215,41523,0,61.8558139534884,41138,2.62229459052875e-05,2.52773821507236,414.009661835749,249,2056950.0
1182,BTC,2010-02-19,5263,41549,197,198,41549,195,41718,0,49.743641025641,41330,2.41091236570333e-05,2.52773821507236,450.30890052356,220,2066550.0
1182,BTC,2010-02-20,5276,41758,209,221,41758,210,41928,0,52.6190476190476,41538,2.63067468608652e-05,2.52773821507236,412.690821256039,223,2076950.0
1182,BTC,2010-02-21,5402,41983,225,344,41983,227,42155,0,76.7261233480176,41761,2.79632760016465e-05,2.52773821507236,388.243243243243,281,2088100.0
1182,BTC,2010-02-22,5669,42246,263,531,42246,265,42420,0,103.018867924528,42021,3.27984885087724e-05,2.52773821507236,331.007722007722,334,2101100.0
1182,BTC,2010-02-23,5670,42497,251,252,42497,251,42671,0,50.0,42271,3.13576662105572e-05,2.52773821507236,346.216867469879,216,2113600.0
1182,BTC,2010-02-24,5777,42670,173,283,42670,177,42848,0,78.2485875706215,42442,2.80357377697768e-05,3.31205512124119,507.394117647059,289,2122150.0
1182,BTC,2010-02-25,5920,42826,156,300,42826,158,43006,0,115.822784810127,42596,2.88814197955785e-05,3.78117925203377,562.300653594771,322,2129850.0
1182,BTC,2010-02-26,5940,43000,174,196,43000,176,43182,0,111.073863636364,42768,3.22949999994603e-05,3.78117925203377,502.865497076023,231,2138450.0
1182,BTC,2010-02-27,5949,43172,172,184,43172,175,43357,0,51.72,42940,3.29303227751786e-05,3.78117925203377,493.163742690059,223,2147050.0
1182,BTC,2010-02-28,6055,43329,157,264,43329,159,43516,0,82.3836477987421,43096,2.95894769111543e-05,3.78117925203377,548.845161290323,294,2154850.0
1182,BTC,2010-03-01,6087,43525,196,227,43525,199,43715,0,57.035175879397,43291,3.67079274618185e-05,3.78117925203377,442.41237113402,235,2164600.0
1182,BTC,2010-03-02,6127,43714,189,233,43714,193,43908,0,59.0673575129534,43479,3.52437994336456e-05,3.78117925203377,460.791443850267,241,2174000.0
1182,BTC,2010-03-03,6231,43866,152,260,43866,158,44066,0,112.658227848101,43631,2.87212169615911e-05,3.78117925203377,565.437086092716,310,2181600.0
1182,BTC,2010-03-04,6618,44052,186,575,44052,188,44254,0,152.127659574468,43816,3.49771465717175e-05,3.78117925203377,464.304347826087,455,2190850.0
1182,BTC,2010-03-05,6619,44224,172,175,44224,173,44427,0,50.2890173410405,43987,3.25743564755149e-05,3.78117925203377,498.552941176471,217,2199400.0
1182,BTC,2010-03-06,6711,44402,178,274,44402,183,44610,0,178.12781420765,44164,3.32412310995241e-05,3.78117925203377,488.551136363637,278,2208250.0
1182,BTC,2010-03-07,6825,44582,180,297,44582,183,44793,0,89.8907103825137,44343,3.36589003475447e-05,3.78117925203377,482.488764044944,290,2217200.0
1182,BTC,2010-03-08,7005,44710,128,313,44710,130,44923,0,117.655230769231,44468,2.78578491770701e-05,4.48308799019633,691.177419354839,383,2223450.0
1182,BTC,2010-03-09,7086,44857,147,229,44857,148,45071,0,76.6891891891892,44614,3.29871871473777e-05,4.53108175007069,589.951724137931,279,2230750.0
1182,BTC,2010-03-10,7126,45025,168,211,45025,169,45240,0,63.313550295858,44776,3.66807525001877e-05,4.53108175007069,530.546583850931,249,2238850.0
1182,BTC,2010-03-11,7190,45159,134,200,45159,136,45376,0,72.4264705882353,44909,2.98008344203179e-05,4.53108175007069,653.030303030303,271,2245500.0
1182,BTC,2010-03-12,7197,45280,121,130,45280,123,45499,0,52.0325203252033,45030,2.73010176860465e-05,4.53108175007069,712.825,222,2251550.0
1182,BTC,2010-03-13,7233,45434,154,190,45434,154,45653,0,61.3636363636364,45183,3.43927179526617e-05,4.53108175007069,565.842105263158,242,2259200.0
1182,BTC,2010-03-14,7241,45559,125,134,45559,127,45780,0,61.4173228346457,45308,2.8161996353923e-05,4.53108175007069,691.032258064516,227,2265450.0
1182,BTC,2010-03-15,7246,45702,143,145,45702,140,45920,0,49.3,45443,3.11954640631566e-05,4.53108175007069,623.835820895522,224,2272200.0
1182,BTC,2010-03-16,7271,45831,129,154,45831,129,46049,0,58.1472868217054,45569,2.82018385928911e-05,4.53108175007069,690.056,239,2278500.0
1182,BTC,2010-03-17,7296,45969,138,164,45969,139,46188,0,57.9136690647482,45705,3.06906822287486e-05,4.53108175007069,634.096296296296,238,2285300.0
1182,BTC,2010-03-18,7377,46117,148,225,46117,149,46337,0,73.489932885906,45845,3.20337485499952e-05,4.53108175007069,607.510791366906,286,2292300.0
1182,BTC,2010-03-19,7504,46276,159,289,46276,162,46499,0,86.3950617283951,45998,3.49828977574006e-05,4.53108175007069,556.296052631579,313,2299950.0
1182,BTC,2010-03-20,7573,46478,202,273,46478,204,46703,0,71.3235294117647,46190,4.32614287130204e-05,4.53108175007069,449.842931937173,265,2309550.0
1182,BTC,2010-03-21,7582,46663,185,193,46663,190,46893,0,50.5368421052632,46373,4.19821511510713e-05,4.53219916516139,463.664835164835,223,2318700.0
1182,BTC,2010-03-22,7622,46844,181,224,46844,186,47079,0,61.2903225806452,46552,4.04849504256518e-05,4.56516291033707,484.308988764045,243,2327650.0
1182,BTC,2010-03-23,7698,47056,212,289,47056,220,47299,0,65.1678636363636,46759,4.7277295135038e-05,4.56516291033707,414.728155339806,262,2338000.0
1182,BTC,2010-03-24,7729,47233,177,208,47233,182,47481,0,56.8681318681319,46930,3.94548935647556e-05,4.56516291033707,496.952941176471,243,2346550.0
1182,BTC,2010-03-25,8070,47427,194,539,47427,202,47683,0,165.59900990099,47117,4.23408440963468e-05,4.56516291033707,463.08064516129,430,2355900.0
1182,BTC,2010-03-26,8145,47626,199,280,47626,213,47896,0,65.0234741784038,47314,4.45190294424283e-05,4.56516291033707,440.423469387755,264,2365750.0
1182,BTC,2010-03-27,8168,47806,180,206,47806,184,48080,0,62.5,47492,4.06836595698133e-05,4.56516291033707,481.943502824859,234,2374650.0
1182,BTC,2010-03-28,8184,47992,186,207,47992,192,48272,0,59.6354166666667,47678,4.21901076945872e-05,4.56516291033707,464.735135135135,229,2383950.0
1182,BTC,2010-03-29,8252,48188,196,268,48188,207,48479,0,63.768115942029,47873,4.4369034862035e-05,4.56516291033707,441.912371134021,258,2393700.0
1182,BTC,2010-03-30,8263,48404,216,226,48404,221,48700,0,51.131221719457,48088,4.88901267218181e-05,4.56516291033707,401.046728971963,222,2404450.0
1182,BTC,2010-03-31,8286,48615,211,238,48615,214,48914,0,55.7205607476636,48297,4.76403859936039e-05,4.56516291033707,411.567307692308,231,2414900.0
1182,BTC,2010-04-01,8312,48783,168,199,48783,179,49093,0,54.7486033519553,48465,4.46617488069708e-05,5.30722093203008,510.377245508982,237,2423300.0
1182,BTC,2010-04-02,8332,48939,156,179,48939,161,49254,0,54.6583850931677,48621,4.91230040285032e-05,6.08547690600079,532.070967741935,231,2431100.0
1182,BTC,2010-04-03,8356,49103,164,192,49103,166,49420,0,58.8763855421687,48782,4.88283949640244e-05,6.08547690600079,535.28125,236,2439150.0
1182,BTC,2010-04-04,8424,49276,173,241,49276,183,49603,0,65.5737704918033,48953,5.18747183974156e-05,6.08547690600079,503.847058823529,265,2447700.0
1182,BTC,2010-04-05,8560,49450,174,307,49450,181,49784,0,101.034198895028,49106,4.63204515945245e-05,6.08547690600079,564.263157894737,342,2455350.0
1182,BTC,2010-04-06,8655,49613,163,267,49613,174,49958,0,75.2356321839081,49265,4.80765805337811e-05,6.08547690600079,543.651898734177,296,2463300.0
1182,BTC,2010-04-07,8756,49811,198,303,49811,204,50162,0,74.2800980392157,49458,5.87738714267786e-05,6.08547690600079,444.703125,282,2472950.0
1182,BTC,2010-04-08,8779,50002,191,217,50002,195,50357,0,62.7627692307692,49641,5.54380838299685e-05,6.08547690600079,471.461538461539,261,2482100.0
1182,BTC,2010-04-09,8881,50227,225,320,50227,224,50581,0,174.142678571429,49830,5.74498341755071e-05,6.08547690600079,454.952127659574,350,2491550.0
1182,BTC,2010-04-10,9159,50515,288,556,50515,298,50879,0,93.6545302013423,50090,7.9198167786905e-05,6.08547690600079,330.019305019305,350,2504550.0
1182,BTC,2010-04-11,9321,50762,247,403,50762,265,51144,0,103.144,50313,6.74015495113983e-05,6.08547690600079,387.779279279279,323,2515700.0
1182,BTC,2010-04-12,9458,50985,223,355,50985,247,51391,0,154.800647773279,50516,7.19800549324231e-05,7.08506040462299,422.757425742574,331,2525850.0
1182,BTC,2010-04-13,9492,51178,193,241,51178,209,51600,0,56.5071770334928,50705,7.39229081705672e-05,7.81979699335383,454.335106382979,245,2535300.0
1182,BTC,2010-04-14,9590,51384,206,312,51384,223,51823,0,69.277533632287,50885,7.04805886452048e-05,7.81979699335383,476.525139664804,311,2544300.0
1182,BTC,2010-04-15,10274,51659,275,927,51659,290,52113,0,428.018275862069,51101,8.39380782170711e-05,7.81979699335383,400.125581395349,624,2555100.0
1182,BTC,2010-04-16,10483,51878,219,434,51878,234,52347,0,98.3447863247863,51303,8.06983556304609e-05,7.81979699335383,416.189054726368,355,2565200.0
1182,BTC,2010-04-17,10553,52111,233,305,52111,250,52597,0,61.17152,51524,8.67533540350476e-05,7.81979699335383,387.140909090909,274,2576250.0
1182,BTC,2010-04-18,13746,55456,3345,3468,55456,3351,55948,0,14.7332169501641,51769,9.54919533532194e-05,7.81979699335383,351.713114754098,3619,2588500.0
1182,BTC,2010-04-19,14034,55709,253,546,55709,276,56224,0,130.51402173913,52001,9.0219241020827e-05,7.81979699335383,372.268398268398,384,2600100.0
1182,BTC,2010-04-20,14236,55929,220,426,55929,243,56467,0,101.995884773663,52206,7.93888689727359e-05,7.81979699335383,423.053921568628,356,2610350.0
1182,BTC,2010-04-21,14382,56166,237,375,56166,251,56718,0,75.6127888446215,52425,8.67521464368166e-05,7.98621337747074,395.385321100918,307,2621300.0
1182,BTC,2010-04-22,14431,56345,179,233,56345,199,56917,0,148.20527638191,52584,9.03622755096167e-05,11.4643158055141,544.905063291139,280,2629250.0
1182,BTC,2010-04-23,14502,56532,187,243,56532,200,57117,0,57.27015,52734,8.74142472434934e-05,11.4643158055141,563.281879194631,307,2636750.0
1182,BTC,2010-04-24,14601,56715,183,285,56715,202,57319,0,101.648811881188,52902,9.6068531241696e-05,11.4643158055141,512.538922155689,356,2645150.0
1182,BTC,2010-04-25,14762,56887,172,344,56887,205,57524,0,116.320975609756,53060,9.09363751152188e-05,11.4643158055141,541.464968152866,371,2653050.0
1182,BTC,2010-04-26,14847,57077,190,278,57077,211,57735,0,96.4241232227488,53224,9.29228733533894e-05,11.4643158055141,529.889570552147,320,2661250.0
1182,BTC,2010-04-27,14914,57287,210,273,57287,233,57968,0,74.8237768240343,53404,0.000102977674707849,11.4643158055141,478.150837988827,302,2670250.0
1182,BTC,2010-04-28,15032,57486,199,323,57486,227,58195,0,76.7512775330397,53584,0.000102164787302308,11.4643158055141,481.95530726257,328,2679250.0
1182,BTC,2010-04-29,15080,57646,160,217,57646,180,58375,0,71.8075555555556,53731,8.34586039974931e-05,11.4643158055141,589.979452054794,280,2686600.0
1182,BTC,2010-04-30,15118,57806,160,207,57806,170,58545,0,403.648941176471,53875,8.32337276217857e-05,11.4643158055141,591.573426573426,274,2693800.0
1182,BTC,2010-05-01,15182,57998,192,264,57998,210,58755,0,68.3266666666667,54058,0.000105386936812772,11.4643158055141,467.21978021978,270,2702950.0
1182,BTC,2010-05-02,15222,58159,161,206,58159,180,58935,0,55.8277777777778,54213,8.82879209214159e-05,11.4643158055141,557.707792207793,258,2710700.0
1182,BTC,2010-05-03,15331,58327,168,279,58327,188,59123,0,85.1117021276596,54372,9.1638476606677e-05,11.4643158055141,537.316455696202,315,2718650.0
1182,BTC,2010-05-04,15497,58476,149,325,58476,177,59300,0,144.91593220339,54508,8.28670464782468e-05,12.2483951096159,634.829629629629,426,2725450.0
1182,BTC,2010-05-05,15632,58621,145,296,58621,162,59462,0,159.627530864198,54645,8.74419828088214e-05,12.8491831478238,631.125000000001,395,2732300.0
1182,BTC,2010-05-06,15905,58776,155,441,58776,177,59639,0,131.926610169492,54794,9.45953877816637e-05,12.8491831478238,583.398648648648,446,2739750.0
1182,BTC,2010-05-07,15989,58914,138,234,58914,158,59797,0,255.974683544304,54926,8.50686435497092e-05,12.8491831478238,648.732824427481,314,2746350.0
1182,BTC,2010-05-08,16263,59079,165,446,59079,182,59979,0,138.353076923077,55080,9.99039681275161e-05,12.8491831478238,552.398692810458,434,2754050.0
1182,BTC,2010-05-09,16356,59248,169,256,59248,183,60162,0,93.0513661202186,55223,9.13753018683203e-05,12.8491831478238,603.957746478873,344,2761200.0
1182,BTC,2010-05-10,16501,59384,136,297,59384,157,60319,0,97.2215286624204,55351,8.35715294560021e-05,12.8491831478238,660.354330708661,371,2767600.0
1182,BTC,2010-05-11,16536,59500,116,160,59500,130,60449,0,58.4626923076923,55462,7.45923639337936e-05,12.8491831478238,739.845454545454,270,2773150.0
1182,BTC,2010-05-12,16648,59633,133,262,59633,159,60608,0,176.227106918239,55589,8.10539754097542e-05,12.8491831478238,680.865079365079,366,2779500.0
1182,BTC,2010-05-13,16751,59774,141,257,59774,167,60775,0,103.639401197605,55717,8.31698862920093e-05,12.8491831478238,663.543307086614,344,2785900.0
1182,BTC,2010-05-14,16852,59912,138,249,59912,153,60928,0,142.881960784314,55840,8.07531299649359e-05,12.8491831478238,683.401639344262,1554,2792050.0
1182,BTC,2010-05-15,16906,60006,94,160,60006,113,61041,0,68.8198230088496,55931,5.81083817024811e-05,12.8491831478238,949.722222222223,2215,2796600.0
1182,BTC,2010-05-16,16950,60123,117,169,60123,133,61174,0,60.8168421052632,56044,7.66189088622226e-05,12.8491831478238,720.276785714286,273,2802250.0
1182,BTC,2010-05-17,17079,60275,152,291,60275,178,61352,0,100.429662921348,56187,9.13316392064483e-05,12.8491831478238,604.24647887324,347,2809400.0
1182,BTC,2010-05-18,17200,60467,192,303,60467,223,61575,0,79.9143497757848,56355,0.000108520349172648,12.8491831478238,508.538922155689,338,2817800.0
1182,BTC,2010-05-19,17319,60660,193,312,60660,207,61782,0,113.54884057971,56519,0.000101645000510054,12.4088614413325,524.331288343558,340,2826000.0
1182,BTC,2010-05-20,17387,60877,217,287,60877,237,62019,0,59.0083122362869,56722,0.000120335224121337,11.8462281497047,422.811881188119,274,2836150.0
1182,BTC,2010-05-21,17520,61069,192,333,61069,235,62254,0,206.918978723404,56898,0.000105329911805908,11.8462281497047,483.045714285714,373,2844950.0
1182,BTC,2010-05-22,17651,61278,209,345,61278,226,62480,0,240.829778761062,57093,0.000114892825387711,11.8462281497047,442.840206185567,429,2854700.0
1182,BTC,2010-05-23,17825,61566,288,449,61566,309,62789,0,105.463948220065,57304,0.000124284615636178,11.8462281497047,409.37619047619,372,2865250.0
1182,BTC,2010-05-24,17936,61792,226,328,61792,250,63039,0,62.624,57492,0.000111886770126724,11.8462281497047,454.737967914439,311,2874650.0
1182,BTC,2010-05-25,18048,62025,233,345,62025,254,63293,0,71.0629921259843,57702,0.000124680435221165,11.8462281497047,408.076555023923,297,2885150.0
1182,BTC,2010-05-26,18192,62287,262,403,62287,287,63580,0,97.529512195122,57925,0.000131026901820473,11.8462281497047,388.310810810811,337,2896300.0
1182,BTC,2010-05-27,18350,62518,231,382,62518,267,63847,0,90.6798127340824,58117,0.000112846858126618,11.8462281497047,450.869109947644,362,2905900.0
1182,BTC,2010-05-28,18440,62783,265,360,62783,277,64124,0,146.415559566787,58340,0.000131258341620093,11.8462281497047,387.626126126126,296,2917050.0
1182,BTC,2010-05-29,18577,63003,220,360,63003,239,64363,0,223.644351464435,58524,0.000122645970272254,13.4285318819401,470.256830601093,348,2926250.0
1182,BTC,2010-05-30,18656,63189,186,271,63189,200,64563,0,64.5615,58673,0.000123308974564014,16.6190787518574,578.858108108109,310,2933700.0
1182,BTC,2010-05-31,18748,63368,179,281,63368,194,64757,0,71.9639175257732,58815,0.000117996041477378,16.6190787518574,604.921985815603,321,2940800.0
1182,BTC,2010-06-01,18846,63534,166,276,63534,183,64940,0,75.9233879781421,58950,0.000113750437814942,16.6190787518574,627.5,341,2947550.0
1182,BTC,2010-06-02,18917,63711,177,257,63711,194,65134,0,77.099381443299,59097,0.000121345191141415,16.6190787518574,588.22602739726,300,2954900.0
1182,BTC,2010-06-03,19116,63919,208,402,63919,235,65369,0,73.5068085106383,59249,0.000124994356412115,16.6190787518574,571.05298013245,450,2962500.0
1182,BTC,2010-06-04,19179,64081,162,236,64081,173,65542,0,223.568497109827,59374,0.000103141966443087,16.6190787518574,692.040322580645,306,2968750.0
1182,BTC,2010-06-05,19264,64250,169,261,64250,190,65732,0,71.3157894736842,59519,0.000123072100686792,16.6190787518574,579.972222222222,313,2976000.0
1182,BTC,2010-06-06,19344,64429,179,270,64429,200,65932,0,80.01655,59667,0.000123144200644846,16.6190787518574,579.632653061225,337,2983400.0
1182,BTC,2010-06-07,19626,64616,187,480,64616,209,66141,0,167.702392344498,59824,0.000129284673482545,16.6190787518574,552.102564102564,463,2991250.0
1182,BTC,2010-06-08,19754,64828,212,340,64828,223,66364,0,78.0313901345291,59984,0.000132954927389455,16.6190787518574,536.861635220126,341,2999250.0
1182,BTC,2010-06-09,19898,65038,210,352,65038,220,66584,0,366.779863636364,60152,0.000139936287225412,16.6190787518574,510.077844311377,367,3007650.0
1182,BTC,2010-06-10,19981,65240,202,287,65240,217,66801,0,182.790921658986,60312,0.000132145283835071,16.6190787518574,540.150943396226,310,3015650.0
1182,BTC,2010-06-11,20117,65474,234,354,65474,247,67048,0,75.825020242915,60480,0.000141494372561083,16.6236169030852,504.598802395209,368,3024050.0
1182,BTC,2010-06-12,20225,65667,193,293,65667,213,67261,0,98.0333333333333,60615,0.00011636432245086,17.3814881581401,641.544776119403,370,3030800.0
1182,BTC,2010-06-13,20356,65887,220,341,65887,239,67500,0,95.5313807531381,60788,0.000149510439623215,17.3814881581401,499.315789473684,352,3039400.0
1182,BTC,2010-06-14,20561,66120,233,422,66120,257,67757,0,199.770505836576,60948,0.000138653770473425,17.3814881581401,538.4125,453,3047450.0
1182,BTC,2010-06-15,20683,66375,255,365,66375,269,68026,0,167.371747211896,61132,0.000158662605043775,17.3814881581401,470.513661202186,358,3056650.0
1182,BTC,2010-06-16,20792,66558,183,294,66558,192,68218,0,186.453541666667,61274,0.000127678394149805,17.3814881581401,584.695035460993,408,3063750.0
1182,BTC,2010-06-17,20870,66746,188,282,66746,204,68422,0,142.590441176471,61420,0.000127512620457744,17.3814881581401,585.455172413793,321,3071050.0
1182,BTC,2010-06-18,20964,66920,174,274,66920,193,68615,0,98.8947150259067,61570,0.00012938716928263,17.3814881581401,576.973154362416,333,3078550.0
1182,BTC,2010-06-19,21146,67124,204,379,67124,214,68829,0,307.816775700935,61720,0.000129545392202302,17.3814881581401,576.268456375839,480,3086050.0
1182,BTC,2010-06-20,21237,67346,222,308,67346,228,69057,0,159.28951754386,61905,0.000160068728504489,17.3814881581401,466.380434782609,297,3095300.0
1182,BTC,2010-06-21,21373,67589,243,346,67589,242,69299,0,188.876404958678,62059,0.000135120810694757,17.3814881581401,552.490196078431,394,3103000.0
1182,BTC,2010-06-22,21515,67808,219,364,67808,227,69526,0,171.800176211454,62215,0.00013452228158653,17.3814881581401,554.948387096774,388,3110800.0
1182,BTC,2010-06-23,21632,68059,251,350,68059,257,69783,0,190.233463035019,62402,0.000161742637820758,17.3814881581401,461.55376344086,351,3120150.0
1182,BTC,2010-06-24,21774,68281,222,368,68281,240,70023,0,170.193208333333,62571,0.000153076158347052,18.2913782228643,513.214285714286,362,3128600.0
1182,BTC,2010-06-25,21832,68476,195,249,68476,210,70233,0,127.704761904762,62721,0.000145213783113983,19.4047963283822,573.93288590604,315,3136100.0
1182,BTC,2010-06-26,21889,68662,186,249,68662,201,70434,0,331.939004975124,62880,0.000155816267318087,19.4047963283822,534.879746835443,286,3144050.0
1182,BTC,2010-06-27,21997,68873,211,316,68873,234,70668,0,91.7435897435897,63058,0.000171276529282252,19.4047963283822,486.598870056497,312,3152950.0
1182,BTC,2010-06-28,22099,69067,194,289,69067,230,70898,0,229.500217391304,63210,0.000146025710798163,19.4047963283822,570.741721854305,349,3160550.0
1182,BTC,2010-06-29,22299,69296,229,401,69296,264,71162,0,186.58178030303,63379,0.00016351490994264,19.4047963283822,509.696428571429,440,3169000.0
1182,BTC,2010-06-30,22529,69540,244,450,69540,273,71435,0,235.461355311355,63561,0.000178338004379935,19.4047963283822,467.331491712707,1207,3178100.0
1182,BTC,2010-07-01,22690,69789,249,401,69789,284,71719,0,131.816514084507,63773,0.000205565154030936,19.4047963283822,405.433333333333,356,3188650.0
1182,BTC,2010-07-02,22863,69994,205,378,69994,241,71960,0,475.330829875519,63939,0.000162033804062242,19.4047963283822,514.355421686747,679,3197000.0
1182,BTC,2010-07-03,22992,70238,244,358,70238,286,72246,0,164.51048951049,64151,0.000204747645130447,19.4047963283822,407.052132701422,341,3207600.0
1182,BTC,2010-07-04,23235,70429,191,437,70429,224,72470,0,120.131696428571,64317,0.00016017412498696,19.4047963283822,520.327272727273,473,3215900.0
1182,BTC,2010-07-05,23405,70633,204,380,70633,252,72722,0,246.218293650794,64499,0.000172346246728368,19.4047963283822,483.578651685393,362,3224850.0
1182,BTC,2010-07-06,23483,70821,188,268,70821,208,72930,0,133.584134615385,64665,0.000196403547694434,23.1376660192475,505.976190476191,296,3233300.0
1182,BTC,2010-07-07,23664,71028,207,383,71028,218,73148,0,261.148211009174,64821,0.000181900422439533,23.5012572229032,554.903225806452,421,3241100.0
1182,BTC,2010-07-08,23771,71236,208,314,71236,223,73371,0,109.519910313901,64972,0.000181474148435089,23.5012572229032,556.206666666667,345,3248650.0
1182,BTC,2010-07-09,23884,71489,253,348,71489,268,73639,0,80.4925373134328,65171,0.000232330705808701,23.5012572229032,434.454545454546,310,3258600.0
1182,BTC,2010-07-10,24065,71718,229,402,71718,240,73879,0,126.678083333333,65369,0.00023148562099987,23.5012572229032,436.040609137056,341,3268500.0
1182,BTC,2010-07-11,24320,72150,432,587,72150,353,74232,0,159.155779036827,65548,0.000208870242055023,23.5012572229032,483.252808988764,503,3277450.0
1182,BTC,2010-07-12,26013,75473,3323,3551,75473,2300,76532,0,1145.1391173913,66207,0.000771676259715719,23.5012572229032,130.802431610942,912,3310400.0
1182,BTC,2010-07-13,26853,77206,1733,1998,77206,1479,78011,0,227.835240027045,66899,0.00121175145223542,35.2657922285921,124.997105643994,520,3345000.0
1182,BTC,2010-07-14,32510,83684,6478,6763,83684,6132,84143,0,57.1356572080887,67477,0.00130614745067963,45.3858223410126,149.240901213172,2847,3373900.0
1182,BTC,2010-07-15,33510,85192,1508,2008,85192,1330,85473,0,88.0067067669173,68103,0.00140996595784484,45.3858223410126,138.252006420546,872,3405099.99999999
1182,BTC,2010-07-16,34294,86532,1340,1723,86532,1181,86654,0,72.9416088060965,68606,0.00156985683535731,62.3718033755698,170.642857142857,611,3430349.99999999
1182,BTC,2010-07-17,34727,86979,447,804,86979,408,87062,0,80.2644117647059,68779,0.00158774750361467,181.543289364051,491.087209302325,730,3438999.99999999
1182,BTC,2010-07-18,35257,87446,467,917,87446,420,87482,0,106.357357142857,68951,0.0016247385686439,181.543289364051,479.906432748538,846,3447599.99999999
1182,BTC,2010-07-19,35744,88051,605,972,88051,528,88010,0,105.776041666667,69125,0.0015779793982318,181.543289364051,494.127167630058,837,3456299.99999999
1182,BTC,2010-07-20,36257,88725,674,906,88725,594,88604,0,65.57632996633,69306,0.00163368697838244,181.543289364051,477.277777777778,1065,3465349.99999999
1182,BTC,2010-07-21,36679,89194,469,809,89194,463,89067,0,82.0832397408207,69513,0.0018658848690713,181.543289364051,417.883495145631,623,3475700.0
1182,BTC,2010-07-22,36914,89628,434,599,89628,397,89464,0,121.994005037783,69689,0.00160009657773727,181.543289364051,487.297142857143,572,3484500.0
1182,BTC,2010-07-23,37184,90062,434,652,90062,411,89875,0,73.7586131386861,69883,0.00174819577712834,181.543289364051,446.015544041451,528,3494200.0
1182,BTC,2010-07-24,37807,90768,706,964,90768,894,90769,0,59.498836689038,70072,0.00171664591809361,181.543289364051,454.212765957447,1526,3503650.0
1182,BTC,2010-07-25,39571,92615,1847,2132,92615,1823,92592,0,32.153280307186,70303,0.00211593620251523,181.543289364051,368.5,3225,3515200.0
1182,BTC,2010-07-26,40379,93076,461,1238,93076,467,93059,0,212.209571734475,70546,0.00220959568523134,181.543289364051,352.880165289256,999,3527350.0
1182,BTC,2010-07-27,40786,93547,471,771,93547,426,93485,0,94.3643192488263,70712,0.00196633372176528,239.305336716061,522.70303030303,760,3535649.99999999
1182,BTC,2010-07-28,41108,93939,392,674,93939,1951,95436,0,38.7035007688365,70871,0.00196072352069681,244.213223092375,534.949367088608,3424,3543599.99999999
1182,BTC,2010-07-29,41311,94328,389,530,94328,1867,97303,0,15.0301178361007,71051,0.00218000693594606,244.213223092375,481.139664804469,2451,3552600.0
1182,BTC,2010-07-30,41582,94676,348,583,94676,325,97628,0,90.0363692307692,71233,0.00220574756551973,244.213223092375,475.524861878453,619,3561699.99999999
1182,BTC,2010-07-31,41765,94993,317,475,94993,295,97923,0,86.7236949152542,71436,0.0024673390266835,244.213223092375,425.108910891089,470,3571849.99999999
1182,BTC,2010-08-01,42028,95390,397,620,95390,364,98287,0,774.863241758242,71675,0.00292789549654515,244.213223092375,358.239495798319,432,3583799.99999999
1182,BTC,2010-08-02,42303,95780,390,627,95780,398,98685,0,190.108969849246,71917,0.0029508540501288,244.213223092375,355.452282157676,437,3595900.0
1182,BTC,2010-08-03,42897,96433,653,974,96433,648,99333,0,79.9901234567901,72144,0.00276738476562313,244.213223092375,379.017699115044,824,3607249.99999999
1182,BTC,2010-08-04,43190,96893,460,731,96893,439,99772,0,104.29715261959,72387,0.00296791405035564,244.213223092375,353.409090909091,489,3619400.0
1182,BTC,2010-08-05,43668,97488,595,819,97488,515,100287,0,100.392252427184,72605,0.00281582109835577,259.068450520215,395.15668202765,927,3630299.99999999
1182,BTC,2010-08-06,44006,97868,380,638,97868,359,100646,0,72.2340111420613,72752,0.00257309370413846,352.16120906801,587.821917808219,757,3637650.0
1182,BTC,2010-08-07,44265,98143,275,514,98143,273,100919,0,120.963076923077,72907,0.00272449779965268,352.16120906801,555.155844155844,640,3645399.99999999
1182,BTC,2010-08-08,44561,98552,409,584,98552,391,101310,0,51.8799232736573,73106,0.00347403437644743,352.16120906801,435.378787878788,529,3655349.99999999
1182,BTC,2010-08-09,44945,99018,466,778,99018,424,101734,0,204.86608490566,73296,0.0033118976485993,352.16120906801,456.693121693122,1564,3664850.0
1182,BTC,2010-08-10,45210,99359,341,590,99359,340,102074,0,127.711323529412,73487,0.00338045177639292,352.16120906801,447.431578947369,475,3674400.0
1182,BTC,2010-08-11,45553,99765,406,701,99765,412,102486,0,161.498567961165,73720,0.00409959510720399,352.16120906801,368.943965517241,496,3686049.99999999
1182,BTC,2010-08-12,45774,100180,415,579,100180,392,102878,0,67.7368112244898,73937,0.00379619699035864,352.16120906801,398.430555555556,459,3696900.0
1182,BTC,2010-08-13,46283,100746,566,847,100746,516,103394,0,88.7840891472868,74152,0.00375411119735005,352.16120906801,402.897196261682,837,3707650.0
1182,BTC,2010-08-14,46509,101154,408,563,101154,434,103828,0,69.7044700460829,74433,0.00492420028187591,352.16120906801,307.160714285714,492,3721699.99999999
1182,BTC,2010-08-15,46689,101432,278,425,101432,315,104143,0,86.5605714285714,74640,0.00400901695830374,389.943836769658,417.757281553398,403,3732049.99999999
1182,BTC,2010-08-16,47099,101897,465,772,101897,453,104596,0,168.929094922737,74787,0.00372175057137794,511.773534256604,590.595890410959,1049,3739400.0
1182,BTC,2010-08-17,47320,102228,331,494,102228,318,104914,0,177.503113207547,74916,0.00332939442460893,511.773534256604,660.1953125,675,3745850.0
1182,BTC,2010-08-18,47727,102643,415,726,102643,377,105291,0,116.81299734748,75049,0.00337441910868357,511.773534256604,651.386363636364,2005,3752500.0
1182,BTC,2010-08-19,47928,102959,316,470,102959,325,105616,0,83.5449230769231,75184,0.00344651040729137,511.773534256604,637.76119402985,623,3759250.0
1182,BTC,2010-08-20,48259,103362,403,656,103362,423,106039,0,92.7385579196218,75377,0.00499007619189773,511.773534256604,440.484375,595,3768900.0
1182,BTC,2010-08-21,48479,103702,340,528,103702,342,106381,0,138.386871345029,75550,0.00440296161374185,511.773534256604,499.220930232558,539,3777550.0
1182,BTC,2010-08-22,48753,104048,346,586,104048,366,106747,0,84.7491530054645,75762,0.00538737890340797,511.773534256604,408.0,472,3788150.0
1182,BTC,2010-08-23,49067,104427,379,653,104427,369,107116,0,77.0355284552845,75975,0.00542425298725585,511.773534256604,405.22641509434,488,3798800.0
1182,BTC,2010-08-24,49377,104823,396,632,104823,379,107495,0,84.020870712401,76190,0.00549345790781254,511.773534256604,400.121495327103,836,3809550.0
1182,BTC,2010-08-25,49582,105178,355,499,105178,365,107860,0,73.181095890411,76406,0.00555304604311184,511.773534256604,395.827906976744,415,3820350.0
1182,BTC,2010-08-26,49927,105525,347,652,105525,368,108228,0,67.2494293478261,76616,0.00541032406049118,516.556966782847,410.066985645933,562,3830850.0
1182,BTC,2010-08-27,50155,105825,300,497,105825,294,108522,0,126.691496598639,76787,0.00528545825301088,623.386959868928,506.564705882353,474,3839400.0
1182,BTC,2010-08-28,50404,106175,350,527,106175,339,108861,0,74.1283775560472,76957,0.00529476235751524,623.386959868928,505.674556213018,607,3847900.0
1182,BTC,2010-08-29,50530,106439,264,390,106439,260,109121,0,64.2484230769231,77119,0.00503746182709035,623.386959868928,531.503105590062,413,3856000.0
1182,BTC,2010-08-30,50772,106762,323,522,106762,329,109450,0,64.7079331334347,77268,0.00463471821092548,623.386959868928,577.689189189189,671,3863450.0
1182,BTC,2010-08-31,51177,107173,411,734,107173,441,109891,0,111.91151926644,77452,0.00570461134924151,623.386959868928,469.344262295082,976,3872650.0
1182,BTC,2010-09-01,51480,107562,389,603,107562,380,110271,0,96.3357631510526,77609,0.00496899187980568,623.386959868928,538.826923076923,894,3880500.0
1182,BTC,2010-09-02,51749,107867,305,543,107867,321,110592,0,132.513084112461,77765,0.00487995489094137,623.386959868928,548.658064516129,607,3888300.0
1182,BTC,2010-09-03,51960,108206,339,500,108206,319,110911,0,119.298871473354,77929,0.00513109949771386,623.386959868928,521.803680981595,507,3896500.0
1182,BTC,2010-09-04,52139,108481,275,451,108481,274,111185,0,142.614452554745,78110,0.00562819592626544,623.386959868928,475.716666666667,409,3905550.0
1182,BTC,2010-09-05,52407,108804,323,548,108804,311,111496,0,467.716109324759,78275,0.00514292698771296,623.386959868928,520.603658536585,546,3913800.0
1182,BTC,2010-09-06,52631,109081,277,511,109081,278,111774,0,300.367410066187,78433,0.00498980303462858,623.386959868928,536.579617834395,505,3921700.0
1182,BTC,2010-09-07,52795,109336,255,403,109336,282,112056,0,93.0541134751773,78593,0.00525017981447858,623.386959868928,509.968553459119,467,3929700.0
1182,BTC,2010-09-08,53048,109687,351,545,109687,339,112395,0,76.3947197539823,78758,0.00572337271207453,696.612518246066,522.756097560975,560,3937950.0
1182,BTC,2010-09-09,53269,109999,312,514,109999,324,112719,0,126.289351846296,78893,0.00479650566993223,712.884864552097,638.343283582089,714,3944700.0
1182,BTC,2010-09-10,53521,110356,357,541,110356,360,113079,0,63.9536944388889,79070,0.00628790589976054,712.884864552097,486.9375,561,3953550.0
1182,BTC,2010-09-11,53707,110645,289,433,110645,305,113384,0,59.7324918032787,79230,0.00564328110947731,712.884864552097,542.559748427673,505,3961550.0
1182,BTC,2010-09-12,54106,111017,372,711,111017,379,113763,0,72.3413720324538,79407,0.00627165978277502,712.884864552097,488.198863636364,700,3970400.0
1182,BTC,2010-09-13,54479,111461,444,718,111461,436,114199,0,288.366811926835,79578,0.00603306737031144,712.884864552097,507.505882352941,776,3978950.0
1182,BTC,2010-09-14,54788,111860,399,664,111860,424,114623,0,95.3869679369811,79781,0.00725310852531967,712.884864552097,422.138613861386,598,3989100.0
1182,BTC,2010-09-15,55115,112277,417,662,112277,430,115053,0,112.47337301507,79950,0.00598895418601754,712.884864552097,511.244047619048,767,3997550.0
1182,BTC,2010-09-16,55483,112661,384,685,112661,438,115491,0,103.957785388128,80169,0.00774469043378886,712.884864552097,395.344036697248,551,4008500.0
1182,BTC,2010-09-17,56207,113005,344,1003,113005,361,115852,0,237.390941828255,80377,0.00737117983864697,712.884864552097,415.376811594203,726,4018900.0
1182,BTC,2010-09-18,56458,113384,379,562,113384,399,116251,0,139.029022556391,80614,0.00844678715847914,712.884864552097,362.483050847458,452,4030750.0
1182,BTC,2010-09-19,56801,113740,356,654,113740,355,116606,0,173.468336911324,80823,0.00926248474313636,893.31568427407,414.225961538462,509,4041200.0
1182,BTC,2010-09-20,57178,114229,489,705,114229,465,117071,0,111.189462365591,81026,0.00925816427700259,917.830741301512,425.792079207921,692,4051350.0
1182,BTC,2010-09-21,58069,115151,922,1216,115151,810,117881,0,44.8292098766667,81198,0.00783972676234225,917.830741301512,502.830409356725,1555,4059950.0
1182,BTC,2010-09-22,58743,115936,785,1039,115936,673,118554,0,79.3246508172362,81372,0.0079992395984698,917.830741301512,492.803468208093,1243,4068650.0
1182,BTC,2010-09-23,59337,116600,664,1049,116600,655,119209,0,211.141664122137,81606,0.0106627314867107,917.830741301512,369.703862660944,833,4080350.0
1182,BTC,2010-09-24,59748,117128,528,807,117128,501,119710,0,61.3649900199601,81834,0.0104602853974286,917.830741301512,376.859030837004,613,4091750.0
1182,BTC,2010-09-25,60267,117698,570,825,117698,532,120242,0,75.7483082706767,82041,0.00947807980500952,917.830741301512,415.912621359223,777,4102100.0
1182,BTC,2010-09-26,60599,118107,409,623,118107,400,120642,0,81.836275,82246,0.00940428028229137,917.830741301512,419.176470588235,585,4112350.0
1182,BTC,2010-09-27,61513,118761,654,1269,118761,603,121245,0,74.3333499170813,82475,0.0106584930852997,917.830741301512,369.850877192982,957,4123800.0
1182,BTC,2010-09-28,62876,119209,448,1699,119209,491,121736,0,187.936160963747,82687,0.0102723237033593,978.334787920694,409.052132701422,1222,4134400.0
1182,BTC,2010-09-29,63763,120144,935,1198,120144,975,122711,0,104.842830769231,82851,0.0107485806231228,1318.67005015359,526.920245398773,2200,4142600.0
1182,BTC,2010-09-30,64072,120563,419,638,120563,365,123076,0,134.013780821918,82997,0.00969664770279993,1318.67005015359,584.08275862069,752,4149900.0
1182,BTC,2010-10-01,64623,121187,624,847,121187,584,123660,0,112.985253631986,83151,0.0101084602347362,1318.67005015359,560.287581699347,1105,4157600.0
1182,BTC,2010-10-02,65090,121711,524,780,121711,501,124161,0,736.301093349561,83251,0.00659539404360237,1318.67005015359,858.727272727273,1816,4162600.0
1182,BTC,2010-10-03,65408,122098,387,672,122098,377,124538,0,217.122116090849,83373,0.00802883268109129,1318.67005015359,705.413223140496,938,4168700.0
1182,BTC,2010-10-04,65904,122546,448,828,122546,407,124945,0,1384.92110565354,83526,0.009997375454917,1318.67005015359,566.513157894737,912,4176350.0
1182,BTC,2010-10-05,66292,122987,441,704,122987,371,125316,0,539.142264151482,83652,0.00840103942628509,1318.67005015359,674.16,1001,4182650.0
1182,BTC,2010-10-06,66638,123407,420,692,123407,407,125723,0,319.536756759435,83823,0.0111569167968683,1318.67005015359,507.635294117647,710,4191200.0
1182,BTC,2010-10-07,66988,123766,359,647,123766,340,126063,0,398.144382352941,83983,0.010503277623433,1318.67005015359,539.226415094339,668,4199199.99999999
1182,BTC,2010-10-08,67483,124173,407,813,124173,363,126426,0,443.125702479339,84137,0.0103298204151123,1318.67005015359,548.281045751634,864,4206900.0
1182,BTC,2010-10-09,67918,124618,445,750,124618,401,126827,0,482.703017456359,84295,0.0104033159879379,1318.67005015359,544.407643312102,904,4214799.99999999
1182,BTC,2010-10-10,68200,125007,389,623,125007,363,127190,0,350.82129476584,84473,0.0116569777889172,1318.67005015359,485.858757062147,630,4223700.0
1182,BTC,2010-10-11,68498,125383,376,631,125383,342,127532,0,183.651198833597,84632,0.0104251813791492,1318.67005015359,543.26582278481,656,4231650.0
1182,BTC,2010-10-12,68831,125785,402,646,125785,352,127884,0,243.818039772727,84787,0.0105742730646545,1363.09289742142,553.649350649351,698,4239400.0
1182,BTC,2010-10-13,69411,126190,405,926,126190,364,128248,0,338.054368131868,84963,0.0121105236225126,1378.02816503733,488.714285714286,869,4248200.0
1182,BTC,2010-10-14,69723,126588,398,634,126588,367,128615,0,512.696321525886,85168,0.0140546349420612,1378.02816503733,421.112745098039,568,4258450.0
1182,BTC,2010-10-15,69987,126950,362,581,126950,328,128943,0,473.525884146341,85345,0.0122983603154332,1378.02816503733,481.25,531,4267300.0
1182,BTC,2010-10-16,70534,127427,477,933,127427,441,129384,0,478.664149662336,85603,0.0177650204008685,1378.02816503733,333.15953307393,568,4280200.0
1182,BTC,2010-10-17,70906,127926,499,752,127926,457,129841,0,266.940350109409,85873,0.0185063304380425,1378.02816503733,319.814126394052,487,4293700.0
1182,BTC,2010-10-18,71429,128569,643,947,128569,579,130420,0,397.23,86122,0.0170548580550166,1378.02816503733,347.032258064516,734,4306150.0
1182,BTC,2010-10-19,72155,129527,958,1408,129527,924,131344,0,301.334956709957,86378,0.0176494457498312,1378.02816503733,335.341176470588,1164,4318950.0
1182,BTC,2010-10-20,72760,130255,728,1183,130255,713,132057,0,298.543856942496,86642,0.0181390925976412,1378.02816503733,326.28897338403,868,4332150.0
1182,BTC,2010-10-21,73289,130812,557,994,130812,552,132609,0,354.355050300996,86828,0.0186748881643238,1962.49109319445,451.345945945946,971,4341450.0
1182,BTC,2010-10-22,73807,131403,591,972,131403,602,133211,0,227.787591362126,86982,0.0166598246617603,2149.02181494673,554.026143790849,1262,4349150.0
1182,BTC,2010-10-23,74191,131921,518,835,131921,517,133728,0,100.377814313346,87157,0.018706364804949,2149.02181494673,493.413793103448,902,4357900.0
1182,BTC,2010-10-24,74553,132451,530,851,132451,552,134280,0,208.41375,87362,0.0218086543164273,2149.02181494673,423.225490196078,788,4368150.0
1182,BTC,2010-10-25,74953,132920,469,752,132920,410,134690,0,390.596707317073,87565,0.0216010987863303,2149.02181494673,427.292079207921,656,4378300.0
1182,BTC,2010-10-26,75350,133541,621,866,133541,518,135208,0,373.345,87806,0.0258051887662456,2149.02181494673,357.679166666667,635,4390350.0
1182,BTC,2010-10-27,75966,134207,666,1117,134207,568,135776,0,374.137623239437,88019,0.0231308638061397,2149.02181494673,399.033018867924,909,4401000.0
1182,BTC,2010-10-28,76493,134753,546,998,134753,486,136262,0,408.587530864198,88238,0.0235084504879184,2149.02181494673,392.623853211009,728,4411950.0
1182,BTC,2010-10-29,76933,135227,474,848,135227,467,136729,0,208.191199143469,88461,0.0238192991318368,2149.02181494673,387.5,729,4423100.0
1182,BTC,2010-10-30,77244,135651,424,659,135651,426,137155,0,166.880375586854,88713,0.0277895401230158,2186.4311433382,337.9203187251,475,4435700.0
1182,BTC,2010-10-31,77524,135953,302,572,135953,307,137462,0,240.573713355049,88892,0.0277599155817497,3091.7368904118,478.348314606742,541,4444650.0
1182,BTC,2010-11-01,77795,136300,347,597,136300,351,137813,0,145.604700854701,89069,0.0274570355795408,3091.7368904118,483.625,581,4453500.0
1182,BTC,2010-11-02,77977,136594,294,458,136594,286,138099,0,249.391923076923,89245,0.027093178878959,3091.7368904118,490.12,449,4462300.0
1182,BTC,2010-11-03,78239,136950,356,574,136950,347,138446,0,191.584956772334,89435,0.0293994537553285,3091.7368904118,451.671957671957,521,4471800.0
1182,BTC,2010-11-04,78520,137291,341,607,137291,342,138788,0,487.859009028889,89636,0.0312905068209848,3091.7368904118,424.375,513,4481850.0
1182,BTC,2010-11-05,79000,137719,428,835,137719,442,139230,0,119.818619909502,89855,0.0336475785502061,3091.7368904118,394.646788990826,705,4492800.0
1182,BTC,2010-11-06,79267,138123,404,596,138123,394,139624,0,348.820710659898,90073,0.0337957052482053,3091.7368904118,392.917050691244,528,4503700.0
1182,BTC,2010-11-07,79563,138544,421,690,138544,451,140075,0,225.72889135255,90314,0.0372066793499188,3091.7368904118,356.895833333333,528,4515750.0
1182,BTC,2010-11-08,80705,139061,517,1571,139061,515,140590,0,996.490524271845,90589,0.0422164067994498,3091.7368904118,314.543795620438,844,4529500.0
1182,BTC,2010-11-09,81012,139461,400,648,139461,409,140999,0,153.098337408313,90806,0.0398240705721159,3670.91506764268,395.902777777778,546,4540350.0
1182,BTC,2010-11-10,81283,139870,409,651,139870,397,141396,0,173.036675062972,91009,0.0459897537735599,4536.35372327504,423.648514851485,549,4550500.0
1182,BTC,2010-11-11,81514,140262,392,601,140262,395,141791,0,133.084835443038,91228,0.049704527785248,4536.35372327504,391.98623853211,510,4561450.0
1182,BTC,2010-11-12,81694,140543,281,456,140543,286,142077,0,147.341958041958,91397,0.0391407854951761,4536.35372327504,497.779761904762,467,4569900.0
1182,BTC,2010-11-13,81946,140876,333,579,140876,343,142420,0,143.603381924198,91620,0.0504677087261072,4536.35372327504,386.058558558558,445,4581050.0
1182,BTC,2010-11-14,82495,141293,417,901,141293,414,142834,0,116.219516908213,91876,0.0577688008041731,4536.35372327504,337.266666666667,560,4593850.0
1182,BTC,2010-11-15,86512,145457,4164,4396,145457,4871,147705,0,55.8381667008828,92076,0.0452607242952263,4536.35372327504,430.472361809045,8786,4603850.0
1182,BTC,2010-11-16,89471,148487,3030,3365,148487,9105,156810,0,42.6009071938495,92273,0.0448828110594667,4536.35372327504,434.09693877551,10953,4613700.0
1182,BTC,2010-11-17,89756,148937,450,675,148937,435,157245,0,171.10924137931,92520,0.055855247146024,4536.35372327504,348.821138211382,504,4626050.0
1182,BTC,2010-11-18,90022,149361,424,632,149361,1494,158739,0,48.4260114376707,92777,0.0629758727561358,4917.22098739684,335.35546875,1375,4638900.0
1182,BTC,2010-11-19,90343,149715,354,641,149715,9632,168371,0,6.42637250830565,92927,0.0529575765924777,6866.89864897274,556.919463087248,14581,4646400.0
1182,BTC,2010-11-20,90738,150273,558,784,150273,9731,178102,0,16.9458699003186,93043,0.039651002338848,6866.89864897274,743.817391304348,19051,4652200.0
1182,BTC,2010-11-21,91115,150782,509,758,150782,10044,188146,0,13.2453205894066,93183,0.0476341936952877,6866.89864897274,619.158273381295,16434,4659200.0
1182,BTC,2010-11-22,91378,151156,374,624,151156,343,188489,0,115.315889212828,93346,0.0559385928349325,6866.89864897274,527.240740740741,627,4667350.0
1182,BTC,2010-11-23,91720,151525,369,660,151525,341,188830,0,145.548768328446,93486,0.048109909543228,6866.89864897274,613.035971223022,753,4674350.0
1182,BTC,2010-11-24,92234,152077,552,963,152077,3936,192766,0,12.0576930894309,93663,0.0607678120056435,6866.89864897274,485.340909090909,5500,4683200.0
1182,BTC,2010-11-25,92664,152668,591,912,152668,4983,197749,0,11.971139875577,93844,0.0621619976348471,6866.89864897274,474.455555555556,9517,4692250.0
1182,BTC,2010-11-26,93424,153579,911,1197,153579,1314,199063,0,75.1949771689498,94038,0.0659403552772831,6866.89864897274,447.269430051814,1913,4701950.0
1182,BTC,2010-11-27,93847,154100,521,822,154100,445,199508,0,74.786202247191,94218,0.0611578255472409,6866.89864897274,482.245810055866,745,4710949.99999999
1182,BTC,2010-11-28,94189,154604,504,706,154604,454,199962,0,72.4308370044053,94390,0.058699919409554,6866.89864897274,502.438596491228,715,4719549.99999999
1182,BTC,2010-11-29,94673,155115,511,900,155115,454,200416,0,99.4270484581498,94599,0.0720196981114498,6866.89864897274,409.514423076923,692,4730000.0
1182,BTC,2010-11-30,95024,155640,525,797,155640,454,200870,0,153.856607929515,94801,0.0734530494269648,7166.72454227777,419.054726368159,645,4740100.0
1182,BTC,2010-12-01,95658,156287,647,1109,156287,512,201382,0,125.8684765625,94989,0.0762137236101578,8078.19525792509,455.24064171123,869,4749500.0
1182,BTC,2010-12-02,96089,156808,521,812,156808,460,201842,0,153.596630434783,95177,0.0758209474113045,8078.19525792509,457.598930481283,696,4758900.0
1182,BTC,2010-12-03,96583,157242,434,881,157242,384,202226,0,96.4394270833333,95366,0.0759318053546002,8078.19525792509,456.93085106383,685,4768350.0
1182,BTC,2010-12-04,96865,157738,496,729,157738,418,202644,0,183.389406638995,95595,0.0921991311450698,8078.19525792509,376.311403508772,579,4779800.0
1182,BTC,2010-12-05,97166,158240,502,695,158240,434,203078,0,76.9050460829493,95834,0.0960738696631851,8078.19525792509,361.134453781512,489,4791750.0
1182,BTC,2010-12-06,97444,158759,519,734,158759,465,203543,0,232.43020673757,96075,0.0973398827101261,8078.19525792509,356.4375,502,4803800.0
1182,BTC,2010-12-07,98036,159437,678,1142,159437,573,204116,0,172.428087860419,96314,0.0957308203013141,8078.19525792509,362.428571428571,753,4815750.0
1182,BTC,2010-12-08,98450,160057,620,903,160057,523,204639,0,79.4403733951434,96552,0.0962514018694298,8078.19525792509,360.46835443038,623,4827649.99999999
1182,BTC,2010-12-09,98835,160612,555,835,160612,486,205125,0,110.375693976564,96775,0.0927195608100826,8227.92815487395,381.135135135135,650,4838799.99999999
1182,BTC,2010-12-10,99096,161070,458,636,161070,373,205498,0,91.1321983914209,96922,0.0905296999833336,12251.9997603745,581.267123287672,704,4846149.99999999
1182,BTC,2010-12-11,99559,161844,774,1070,161844,550,206048,0,160.949176410655,97097,0.106993903279678,12251.9997603745,491.82183908046,962,4854899.99999999
1182,BTC,2010-12-12,100117,162752,908,1194,162752,643,206691,0,87.6222028709642,97268,0.104049147527675,12251.9997603745,505.741176470588,1054,4863450.0
1182,BTC,2010-12-13,101194,163662,910,1676,163662,646,207337,0,287.536470161765,97409,0.0863473711529339,12251.9997603745,609.421428571429,1753,4870500.00000001
1182,BTC,2010-12-14,101704,164472,810,1131,164472,653,207990,0,191.219512289372,97581,0.103919815850277,12251.9997603745,506.370588235294,1034,4879050.0
1182,BTC,2010-12-15,102183,165228,756,1093,165228,642,208632,0,191.243792615389,97776,0.120557809609054,12251.9997603745,436.48717948718,918,4888850.0
1182,BTC,2010-12-16,102629,165869,641,949,165869,531,209163,0,175.876654556422,97949,0.10482336422957,12251.9997603745,502.005813953488,885,4897500.0
1182,BTC,2010-12-17,102980,166402,533,796,166402,462,209625,0,154.521431142814,98115,0.100708923231832,12251.9997603745,522.515151515151,986,4905800.0
1182,BTC,2010-12-18,103342,167013,611,858,167013,499,210124,0,182.82688726002,98276,0.0983369360191702,12251.9997603745,535.11875,871,4913850.0
1182,BTC,2010-12-19,103909,167689,676,1088,167689,551,210675,0,194.593442714283,98460,0.111968079826728,12251.9997603745,469.972677595628,1033,4923049.99999999
1182,BTC,2010-12-20,104857,168716,1027,1461,168716,932,211607,0,97.7250504332833,98619,0.0964476103295924,12251.9997603745,545.601265822785,1688,4931000.0
1182,BTC,2010-12-21,105398,169459,743,1088,169459,629,212236,0,177.034705230906,98815,0.122747127797093,12606.8563789713,441.118556701031,933,4940750.0
1182,BTC,2010-12-22,106067,170246,787,1210,170246,660,212896,0,137.308044723455,98972,0.113994415990949,14484.1623612254,545.71974522293,1227,4948650.0
1182,BTC,2010-12-23,106519,170927,681,1018,170927,519,213415,0,135.182369942197,99117,0.105457608167686,14484.1623612254,589.895833333333,1118,4955900.0
1182,BTC,2010-12-24,106951,171542,615,851,171542,531,213946,0,127.695494313842,99265,0.109240294542698,14484.1623612254,569.469387755102,1000,4963300.0
1182,BTC,2010-12-25,107477,172361,819,1076,172361,634,214580,0,190.847172603344,99433,0.121607206014125,14484.1623612254,511.556886227545,996,4971700.0
1182,BTC,2010-12-26,107988,173081,720,1028,173081,584,215164,0,132.345780494366,99578,0.104082825308238,14484.1623612254,597.6875,1146,4978950.0
1182,BTC,2010-12-27,108683,173688,607,1140,173688,526,215690,0,189.770294604696,99744,0.120544510369624,14484.1623612254,516.066666666667,1105,4987250.0
1182,BTC,2010-12-28,109186,174439,751,1030,174439,661,216351,0,98.4429560630106,99913,0.12181635794389,14484.1623612254,510.678571428571,1114,4995700.0
1182,BTC,2010-12-29,109698,175039,600,990,175039,513,216864,0,232.160979691189,100078,0.118722235655648,14484.1623612254,523.987804878049,980,5003950.0
1182,BTC,2010-12-30,110263,175715,676,1091,175715,593,217457,0,123.18821650172,100247,0.121695788416704,14484.1623612254,511.184523809524,1052,5012400.0
1182,BTC,2010-12-31,110704,176327,612,898,176327,555,218012,0,121.651303334432,100409,0.118371502716851,14484.1623612254,525.540372670808,951,5020499.99999999
1182,BTC,2011-01-01,111266,177077,750,1077,177077,659,218671,0,97.5662050873748,100590,0.130123186107039,14484.1623612254,478.077777777778,1109,5029550.0
1182,BTC,2011-01-02,111796,177705,628,1051,177705,569,219240,0,97.2126233137786,100765,0.125839852998205,14484.1623612254,494.350574712644,1023,5038300.0
1182,BTC,2011-01-03,112648,178615,910,1398,178615,1128,220368,0,66.8479827944769,100921,0.126591210952664,15910.0440691127,539.793548387097,2482,5046100.0
1182,BTC,2011-01-04,113223,179381,766,1078,179381,979,221347,0,48.2527240429214,101062,0.114284120580761,16307.420938524,612.857142857143,1778,5053150.0
1182,BTC,2011-01-05,114238,180351,970,1540,180351,1310,222657,0,43.6079536968779,101216,0.125694627421255,16307.420938524,557.222222222223,2457,5060850.0
1182,BTC,2011-01-06,114895,181060,709,1161,181060,694,223351,0,56.2455508218156,101357,0.115291917058545,16307.420938524,607.5,1541,5067900.0
1182,BTC,2011-01-07,115616,181923,863,1254,181923,1020,224371,0,63.4786636217059,101521,0.132455753581346,16307.420938524,528.779141104294,1676,5076099.99999999
1182,BTC,2011-01-08,116468,182959,1036,1473,182959,1436,225807,0,46.9895473537605,101691,0.137934753007763,16307.420938524,507.775147928994,2278,5084599.99999999
1182,BTC,2011-01-09,117258,183893,934,1383,183893,1223,227030,0,37.9666350705969,101854,0.131975411372237,16307.420938524,530.703703703704,2144,5092750.0
1182,BTC,2011-01-10,118065,184884,991,1437,184884,1312,228342,0,68.787864756311,102016,0.136001328819061,16307.420938524,514.993788819876,2288,5100850.0
1182,BTC,2011-01-11,118995,185955,1071,1552,185955,1362,229704,0,82.9022229618796,102188,0.139250689739845,16307.420938524,502.976608187135,2305,5109450.0
1182,BTC,2011-01-12,119700,186836,881,1263,186836,1162,230866,0,58.1142358144406,102355,0.136581225192879,16307.420938524,512.807228915663,1920,5117799.99999999
1182,BTC,2011-01-13,120798,187822,986,1696,187822,1266,232132,0,102.188889106746,102543,0.154147492645891,16307.420938524,454.368983957219,2019,5127200.0
1182,BTC,2011-01-14,121784,188722,900,1607,188722,1262,233394,0,74.7345297405785,102724,0.146564336887069,16307.420938524,477.877777777778,2047,5136250.0
1182,BTC,2011-01-15,122578,189715,993,1422,189715,962,234356,0,67.4650752280561,102881,0.135858305594989,17202.9288871889,543.846153846154,1916,5144100.00000001
1182,BTC,2011-01-16,123517,190768,1053,1536,190768,931,235287,0,78.9797168600859,103055,0.160696649751048,18437.6443921663,492.78612716763,1689,5152800.0
1182,BTC,2011-01-17,124231,191700,932,1348,191700,830,236117,0,81.2136562720964,103236,0.167892041723601,18437.6443921663,471.666666666667,1335,5161850.0
1182,BTC,2011-01-18,125099,192679,979,1416,192679,818,236935,0,136.837079367421,103377,0.131740275627403,18437.6443921663,601.1,1846,5168900.0
1182,BTC,2011-01-19,126036,193722,1043,1545,193722,917,237852,0,74.433221055747,103546,0.156189644929713,18437.6443921663,507.005952380953,1694,5177350.00000001
1182,BTC,2011-01-20,126858,194738,1016,1453,194738,924,238776,0,66.5074099961255,103732,0.171905747887632,18437.6443921663,460.654054054054,1421,5186650.0
1182,BTC,2011-01-21,128090,196069,1331,1969,196069,1166,239942,0,59.7571054582676,103906,0.160047089705091,18437.6443921663,494.78612716763,2186,5195350.0
1182,BTC,2011-01-22,129487,197600,1531,2196,197600,1422,241364,0,54.8007217451969,104071,0.150853863020788,18437.6443921663,524.939024390244,3150,5203600.0
1182,BTC,2011-01-23,130740,198843,1243,1932,198843,1081,242445,0,81.9791127787419,104241,0.156405049503983,18437.6443921663,506.307692307692,2216,5212100.0
1182,BTC,2011-01-24,132021,200308,1465,2058,200308,1319,243764,0,59.2742743560046,104429,0.173717304444784,18437.6443921663,455.850267379679,2312,5221500.0
1182,BTC,2011-01-25,132830,201291,983,1445,201291,889,244653,0,70.207506260315,104585,0.14353900447122,18437.6443921663,551.690322580645,1655,5229300.00000001
1182,BTC,2011-01-26,133772,202335,1044,1586,202335,1005,245658,0,74.3082189054726,104765,0.164848701113589,18437.6443921663,480.374301675978,1686,5238300.00000001
1182,BTC,2011-01-27,134778,203285,950,1653,203285,841,246499,2,1240.43738294791,104925,0.164018958216511,20537.80234784,537.798742138365,1867,5246300.0
1182,BTC,2011-01-28,135797,204494,1209,1690,204494,1081,247580,0,49.8984828862165,105083,0.178390571578264,22012.3813379939,529.974522292994,2095,5254200.00000001
1182,BTC,2011-01-29,137162,205995,1501,2077,205995,1347,248927,0,56.1744335234447,105244,0.179621127739741,22012.3813379939,526.34375,3012,5262250.0
1182,BTC,2011-01-30,139711,208655,2660,3198,208655,2592,251519,0,153.624752577323,105400,0.170018690847461,22012.3813379939,556.070967741936,6428,5270050.00000001
1182,BTC,2011-01-31,141213,210244,1589,2229,210244,1393,252912,0,141.965240361271,105570,0.188631753234079,22012.3813379939,501.201183431953,3036,5278550.0
1182,BTC,2011-02-01,142351,211384,1140,1916,211384,1013,253925,0,127.745648452764,105734,0.180245162361996,22012.3813379939,524.521472392638,2580,5286750.0
1182,BTC,2011-02-02,143234,212319,935,1490,212319,896,254821,0,135.849677503884,105892,0.175175739071448,22012.3813379939,539.700636942676,1893,5294650.0
1182,BTC,2011-02-03,143980,213135,816,1266,213135,789,255610,0,93.4525703586692,106052,0.174958400524314,22012.3813379939,540.37106918239,1523,5302650.0
1182,BTC,2011-02-04,144863,214107,972,1509,214107,954,256564,0,65.8807072184486,106246,0.211855545061728,22012.3813379939,446.259067357513,1525,5312350.00000001
1182,BTC,2011-02-05,145789,214982,875,1525,214982,832,257396,0,94.4357596870553,106425,0.195952044291171,22012.3813379939,482.477528089888,1564,5321300.0
1182,BTC,2011-02-06,146617,215898,916,1393,215898,909,258305,0,95.3492866057646,106602,0.195959071047573,22012.3813379939,482.460227272727,1755,5330150.0
1182,BTC,2011-02-07,147434,216801,903,1398,216801,892,259197,0,184.885870264451,106805,0.22458489453355,22012.3813379939,420.965346534653,1321,5340300.0
1182,BTC,2011-02-08,148252,217706,905,1427,217706,846,260043,0,88.7458446806856,106973,0.211516355528169,25001.5052811093,507.670658682635,1564,5348700.0
1182,BTC,2011-02-09,149430,219192,1486,2088,219192,1227,261270,0,112.295969705689,107165,0.247588994710668,25997.8799288144,450.989528795811,1942,5358300.0
1182,BTC,2011-02-10,151480,221886,2694,3549,221886,2034,263304,0,111.403545905457,107351,0.240699923690293,25997.8799288144,463.897297297297,3678,5367600.0
1182,BTC,2011-02-11,154004,225294,3408,4310,225294,2355,265659,0,110.917524269635,107537,0.245447513112067,25997.8799288144,454.924324324324,3843,5376900.00000001
1182,BTC,2011-02-12,155845,227883,2589,3300,227883,1912,267571,0,74.0117187024686,107733,0.25395041511104,25997.8799288144,439.692307692308,3058,5386700.0
1182,BTC,2011-02-13,157773,230199,2316,3266,230199,1822,269393,0,62.635871668359,107931,0.256575982174189,25997.8799288144,435.192893401015,2744,5396599.99999999
1182,BTC,2011-02-14,160506,232692,2493,4117,232692,2006,271399,0,69.7788341860668,108127,0.254499545223781,25997.8799288144,438.74358974359,3769,5406399.99999999
1182,BTC,2011-02-15,162668,235197,2505,3410,235197,2224,273623,0,46.3364945845638,108352,0.291520197083251,25997.8799288144,383.026785714286,2962,5417650.0
1182,BTC,2011-02-16,164621,237407,2210,2982,237407,2090,275713,0,34.9480766247177,108584,0.299533981068445,25997.8799288144,372.779220779221,2591,5429250.0
1182,BTC,2011-02-17,166640,240162,2755,3492,240162,2250,277963,0,46.7488244948622,108815,0.298604866331492,25997.8799288144,373.939130434783,2920,5440800.0
1182,BTC,2011-02-18,168736,242722,2560,3608,242722,2056,280019,0,62.7597391486333,109027,0.358323839306793,34091.130624035,408.625592417062,3308,5451400.0
1182,BTC,2011-02-19,170390,244695,1973,2892,244695,1583,281602,0,117.180031585597,109188,0.291578437005538,36459.8869250751,537.05625,3089,5459450.0
1182,BTC,2011-02-20,172253,247036,2341,3177,247036,1939,283541,0,116.402294997421,109386,0.359805714221628,36459.8869250751,435.218274111675,2875,5469350.0
1182,BTC,2011-02-21,174133,249534,2498,3291,249534,1970,285511,0,121.314862944162,109580,0.350960891818958,36459.8869250751,446.186528497409,2881,5479050.0
1182,BTC,2011-02-22,176355,252317,2783,3781,252317,2196,287707,0,163.000603582978,109791,0.387385227902339,36459.8869250751,404.233333333333,3213,5489600.00000001
1182,BTC,2011-02-23,178501,255103,2786,3798,255103,2263,289970,0,164.251002144839,110034,0.442878134258434,36459.8869250751,353.582644628099,2859,5501750.0
1182,BTC,2011-02-24,180676,257740,2637,3676,257740,2109,292079,0,108.823868039222,110241,0.376388408185817,36459.8869250751,416.043689320388,3199,5512100.0
1182,BTC,2011-02-25,182675,260296,2556,3416,260296,2060,294139,0,90.7267859961165,110466,0.409143047820891,36459.8869250751,382.736607142857,2804,5523350.0
1182,BTC,2011-02-26,184840,262757,2461,3581,262757,1952,296091,0,91.5916396033504,110742,0.49961546806284,36459.8869250751,313.429090909091,2234,5537150.00000001
1182,BTC,2011-02-27,187058,265431,2674,3633,265431,2269,298360,0,88.9971478851961,110986,0.547034566042926,44848.7006078288,352.123456790123,2943,5549350.0
1182,BTC,2011-02-28,188729,267543,2112,3028,267543,1720,300080,0,76.967155728936,111136,0.423309644223988,55589.5181268687,564.020134228188,3751,5556850.0
1182,BTC,2011-03-01,191680,271451,3908,5194,271451,2729,302809,3,381.01994956166,111266,0.360644675634169,55589.5181268687,662.023255813954,6774,5563350.0
1182,BTC,2011-03-02,193911,273953,2502,3728,273953,2009,304818,6,1216.68235967339,111434,0.463526803535674,55589.5181268687,515.083832335329,3826,5571750.0
1182,BTC,2011-03-03,196999,277785,3832,4894,277785,3204,308022,0,74.2832579863546,111620,0.514720439044556,55589.5181268687,463.854054054054,5051,5581050.00000001
1182,BTC,2011-03-04,198851,280057,2272,3281,280057,1982,310004,0,158.197525965954,111841,0.612092848697951,55589.5181268687,390.063636363637,3136,5592100.00000001
1182,BTC,2011-03-05,200966,282447,2390,3610,282447,2048,312052,0,69.3636460066699,112118,0.774050002467495,55589.5181268687,308.449275362319,3037,5605950.0
1182,BTC,2011-03-06,202908,284815,2368,3316,284815,2031,314083,0,96.8484861153816,112392,0.760588577464753,55589.5181268687,313.908424908425,2355,5619650.0
1182,BTC,2011-03-07,204883,287162,2347,3409,287162,1926,316009,0,113.057573583811,112603,0.58828769998842,55589.5181268687,405.847619047619,3016,5630200.0
1182,BTC,2011-03-08,207379,290080,2918,3867,290080,2440,318449,0,80.1362128885246,112790,0.514701671280549,55589.5181268687,463.870967741936,4463,5639550.0
1182,BTC,2011-03-09,209520,292453,2373,3384,292453,1834,320283,0,137.706544618282,112950,0.498980821542437,62671.8341714654,539.446540880503,3956,5647550.00000001
1182,BTC,2011-03-10,211391,294610,2157,2912,294610,1661,321944,0,207.168817807568,113060,0.415362663655295,76192.6193475137,787.853211009175,4933,5653050.00000001
1182,BTC,2011-03-11,213306,296707,2097,3048,296707,1884,323828,0,134.900642420637,113190,0.491873837970091,76192.6193475137,665.302325581396,4819,5659550.0
1182,BTC,2011-03-12,215387,298946,2239,3232,298946,2956,326784,0,55.3120015725677,113330,0.529275887841644,76192.6193475137,618.287769784173,6119,5666550.00000001
1182,BTC,2011-03-13,217242,300982,2036,2893,300982,2711,329495,0,77.8363801367134,113447,0.449246109518819,76192.6193475137,728.431034482759,6795,5672400.0
1182,BTC,2011-03-14,219142,302788,1806,2900,302788,2643,332138,0,80.684890016924,113559,0.430289437331499,76192.6193475137,760.522522522523,7601,5678000.0
1182,BTC,2011-03-15,221431,305234,2446,3299,305234,2854,334992,0,44.5411691066433,113671,0.431859967431732,76192.6193475137,757.756756756757,8244,5683600.0
1182,BTC,2011-03-16,223500,307319,2085,3166,307319,3183,338175,0,50.439749234323,113807,0.51790168014478,76192.6193475137,631.866666666666,6970,5690400.0
1182,BTC,2011-03-17,225532,309584,2265,3225,309584,3367,341542,0,49.7696634308732,113948,0.533226331325792,76192.6193475137,613.707142857143,6695,5697450.0
1182,BTC,2011-03-18,227555,311671,2087,3094,311671,2371,343913,0,74.5314399976466,114068,0.454549119747451,76192.6193475137,719.932773109243,6209,5703450.0
1182,BTC,2011-03-19,229589,313909,2238,3176,313909,3189,347102,0,39.1715170250706,114183,0.44034358056578,76192.6193475137,743.157894736842,8085,5709200.00000001
1182,BTC,2011-03-20,232943,317481,3572,4449,317481,4076,351178,0,35.766707460265,114320,0.517280866696935,76192.6193475137,632.625,10225,5716050.0
1182,BTC,2011-03-21,235836,321167,3686,4652,321167,5855,357033,0,27.1333556241418,114468,0.575205208824955,76192.6193475137,568.918367346939,10744,5723450.0
1182,BTC,2011-03-22,238161,323974,2807,3862,323974,2238,359271,0,94.1245752093566,114587,0.450987320915052,76192.6193475137,725.618644067796,6028,5729400.00000001
1182,BTC,2011-03-23,242393,329531,5557,6864,329531,4570,363841,0,57.4192086570459,114744,0.602795995865899,76192.6193475137,542.878205128205,9205,5737250.0
1182,BTC,2011-03-24,244668,332551,3020,4388,332551,2164,366005,0,119.866990714843,114896,0.57670003795827,76192.6193475137,567.443708609272,5180,5744850.0
1182,BTC,2011-03-25,246943,335245,2694,4170,335245,1999,368004,0,146.99699378024,115069,0.610314496591247,69603.3483340221,489.819767441861,4319,5753500.0
1182,BTC,2011-03-26,250011,338657,3412,4828,338657,3335,371339,0,97.7910402726717,115207,0.471330988617237,68977.7846302096,628.554744525548,8149,5760400.0
1182,BTC,2011-03-27,252244,341635,2978,4772,341635,2463,373802,0,61.8419050970849,115350,0.496313687,68977.7846302096,596.915492957747,6660,5767550.00000001
1182,BTC,2011-03-28,255502,344895,3260,5336,344895,2931,376733,0,49.0973055155647,115518,0.573875724561848,68977.7846302096,516.239520958084,6379,5775950.0
1182,BTC,2011-03-29,258399,348069,3174,4653,348069,2718,379451,0,43.5065751396247,115681,0.564611688060887,68977.7846302096,524.70987654321,5658,5784100.0
1182,BTC,2011-03-30,260454,350416,2347,3662,350416,1756,381207,0,74.0208003543679,115837,0.548827953199855,68977.7846302096,539.8,4123,5791900.0
1182,BTC,2011-03-31,262789,353094,2678,4159,353094,2095,383302,0,70.2898439068067,116038,0.702139735118636,68977.7846302096,421.935,3937,5801950.0
1182,BTC,2011-04-01,264483,355007,1913,3279,355007,1579,384881,0,55.3264776890754,116214,0.607162896848825,68977.7846302096,487.937142857143,3512,5810749.99999999
1182,BTC,2011-04-02,266238,357076,2069,3304,357076,1772,386653,0,58.6994778332167,116394,0.615019564112188,68977.7846302096,481.703910614525,3544,5819750.0
1182,BTC,2011-04-03,268040,359336,2260,3626,359336,1805,388458,0,49.9489851156454,116569,0.607736000163722,68977.7846302096,487.477011494253,3536,5828500.0
1182,BTC,2011-04-04,270633,362324,2988,4621,362324,2309,390767,0,66.2127565463101,116747,0.611566509887674,68977.7846302096,484.423728813559,4634,5837400.00000001
1182,BTC,2011-04-05,272928,365056,2732,4306,365056,2119,392886,0,61.1698135841246,116941,0.711168790513387,69942.4755207179,422.40414507772,3922,5847100.0
1182,BTC,2011-04-06,274984,367484,2428,3867,367484,1864,394750,0,50.1170591724732,117089,0.616467204834141,82345.6441129666,573.707482993197,4507,5854500.00000001
1182,BTC,2011-04-07,276793,369525,2041,3423,369525,1677,396427,0,70.3474389780024,117236,0.59984073360889,82345.6441129666,589.609589041095,4101,5861850.0
1182,BTC,2011-04-08,278713,371734,2209,3649,371734,1767,398194,0,77.1147402685116,117402,0.684734992390474,82345.6441129666,516.509090909091,4145,5870150.00000002
1182,BTC,2011-04-09,280531,373928,2194,3615,373928,1733,399927,0,86.2072014425851,117558,0.64441548534294,82345.6441129666,548.825806451613,4020,5877950.00000001
1182,BTC,2011-04-10,282304,376043,2115,3513,376043,1744,401671,0,53.7029579639966,117731,0.706981985153159,82345.6441129666,500.255813953488,3867,5886600.00000001
1182,BTC,2011-04-11,284476,378420,2377,4060,378420,1943,403614,0,48.9514423848121,117894,0.664511423506871,82345.6441129666,532.228395061728,4757,5894750.0
1182,BTC,2011-04-12,286864,380936,2516,4330,380936,2077,405691,0,70.5260407113866,118057,0.686511052819214,82345.6441129666,515.172839506173,5618,5902900.0
1182,BTC,2011-04-13,289514,383683,2747,4672,383683,2371,408062,0,79.1603727857318,118251,0.800153173216929,82345.6441129666,442.00518134715,4836,5912600.00000001
1182,BTC,2011-04-14,292600,388091,4408,5966,388091,2881,410943,0,53.3953419583339,118411,0.65804418532211,82345.6441129666,537.459119496855,6310,5920600.0
1182,BTC,2011-04-15,294848,390394,2303,4147,390394,2018,412961,0,53.4618282097621,118547,0.561067234699855,82345.6441129666,630.355555555556,7102,5927400.0
1182,BTC,2011-04-16,298501,392852,2458,5369,392852,2154,415115,0,163.590539101857,118720,0.711238970764517,82345.6441129666,497.261627906977,6164,5936050.0
1182,BTC,2011-04-17,300779,395393,2541,4349,395393,2257,417372,0,580.100505881205,118900,0.737872663024944,82345.6441129666,479.312849162011,4610,5945050.0
1182,BTC,2011-04-18,304001,398856,3463,5540,398856,3035,420407,0,44.7377420872949,119048,0.666767562055351,89441.6199109964,576.136054421769,7418,5952449.99999999
1182,BTC,2011-04-19,307705,403029,4173,6348,403029,3598,424005,26,738.356454768382,119202,0.725117663008944,92347.5909520943,546.986928104575,8239,5960150.0
1182,BTC,2011-04-20,310928,406392,3363,5387,406392,2969,426974,11,1614.7060953021,119346,0.663982782565401,92347.5909520943,597.34965034965,9102,5967350.0
1182,BTC,2011-04-21,312926,408839,2447,4047,408839,1915,428889,0,229.282376879802,119493,0.677373263443601,92347.5909520943,585.541095890411,4664,5974699.99999999
1182,BTC,2011-04-22,315147,411347,2508,4248,411347,2097,430986,0,79.4221479452218,119669,0.812632935182,92347.5909520943,488.08,4423,5983500.0
1182,BTC,2011-04-23,317787,414163,2816,4936,414163,2310,433296,0,75.6170286658225,119841,0.799327173440747,92347.5909520943,496.204678362573,5494,5992100.0
1182,BTC,2011-04-24,320219,416842,2679,4657,416842,2273,435569,0,48.2766486123493,120003,0.748410894514843,92347.5909520943,529.962732919255,5801,6000199.99999999
1182,BTC,2011-04-25,322882,419981,3139,5074,419981,2592,438161,0,41.4854016331327,120195,0.899227353864793,92347.5909520943,441.078534031414,6000,6009800.0
1182,BTC,2011-04-26,326625,424035,4054,6147,424035,3455,441616,0,54.4098083624573,120390,0.894889715559921,92347.5909520943,443.216494845361,6517,6019550.00000001
1182,BTC,2011-04-27,331600,429279,5244,7489,429279,4580,446196,0,56.0500280032948,120573,0.844011770492245,92347.5909520943,469.934065934066,10654,6028700.0
1182,BTC,2011-04-28,335073,433214,3935,6221,433214,3035,449231,0,51.7182880659835,120737,0.7582055510812,92347.5909520943,523.116564417178,7537,6036900.0
1182,BTC,2011-04-29,338996,437569,4355,6747,437569,3534,452765,3,222.587467616135,120937,0.928613324208177,92347.5909520943,427.120603015075,6751,6046899.99999999
1182,BTC,2011-04-30,344022,443113,5544,8157,443113,4473,457238,1,92.4890892139168,121126,1.01586384237178,107653.752702592,455.148936170213,9596,6056350.0
1182,BTC,2011-05-01,348295,447879,4766,7490,447879,3949,461187,0,43.3787503322436,121305,0.987216088490021,109670.133292477,477.129213483146,9391,6065300.00000001
1182,BTC,2011-05-02,351652,451540,3661,5987,451540,3095,464282,0,41.8049487810727,121502,1.07213806322696,109670.133292477,439.336734693877,5798,6075149.99999999
1182,BTC,2011-05-03,354942,455220,3680,6050,455220,2935,467217,0,67.3761899710664,121698,1.0663336195669,109670.133292477,441.728205128205,6118,6084950.0
1182,BTC,2011-05-04,358512,458991,3771,6372,458991,2800,470017,0,103.460236961796,121895,1.08868773510305,109670.133292477,432.658163265306,5970,6094800.0
1182,BTC,2011-05-05,362503,463442,4451,7096,463442,3464,473481,0,49.0310647952107,122114,1.1904892597785,109670.133292477,395.660550458716,6656,6105750.0
1182,BTC,2011-05-06,366253,467840,4398,6852,467840,3290,476771,2,88.6747638752857,122332,1.18969029024973,109670.133292477,395.926267281106,6148,6116650.0
1182,BTC,2011-05-07,370619,472471,4631,7278,472471,3887,480658,0,59.870367390512,122546,1.17743589289683,109670.133292477,400.046948356808,6394,6127350.00000001
1182,BTC,2011-05-08,373868,476385,3914,6400,476385,2898,483556,2,186.638970484931,122765,1.20104403262065,109670.133292477,392.183486238532,5374,6138300.00000001
1182,BTC,2011-05-09,378065,480887,4502,7565,480887,3516,487072,0,46.8184351785609,123004,1.38477522195223,115463.613576929,358.117647058824,6168,6150250.0
1182,BTC,2011-05-10,381782,484904,4017,7165,484904,3151,490223,2,183.051719848264,123187,1.42930027755037,157416.401843649,473.027472527473,7986,6159400.0
1182,BTC,2011-05-11,385448,489000,4096,7085,489000,3090,493313,1,60.1264532839579,123378,1.49507892804749,157416.401843649,452.215789473684,7125,6168950.0
1182,BTC,2011-05-12,389143,493076,4076,7229,493076,3361,496674,2,64.3693387412199,123547,1.32245705533624,157416.401843649,511.244047619048,8426,6177400.00000001
1182,BTC,2011-05-13,394811,498828,5752,9451,498828,4064,500738,5,113.958989206511,123754,1.61322595201344,157416.401843649,419.097087378641,9412,6187750.00000001
1182,BTC,2011-05-14,399685,504561,5733,8975,504561,4414,505152,7,407.668144199762,123996,1.89132673750931,157416.401843649,357.473029045643,7686,6199849.99999999
1182,BTC,2011-05-15,404026,509847,5286,8317,509847,3770,508922,1,85.5859575018886,124216,1.75146711788983,157416.401843649,386.018264840183,7757,6210850.00000001
1182,BTC,2011-05-16,409141,517963,8116,11771,517963,4349,513271,1,66.7970765598137,124463,1.95046652185978,157416.401843649,346.634146341463,8022,6223200.0
1182,BTC,2011-05-17,414181,524800,6837,10497,524800,4464,517735,1,50.7821149259162,124720,2.01285254023528,157416.401843649,335.890625,7413,6236050.0
1182,BTC,2011-05-18,420703,533202,8402,12939,533202,5581,523316,1,35.0116081058412,125008,2.34054484955501,162533.879138169,298.254355400697,8189,6250449.98999998
1182,BTC,2011-05-19,426240,541184,7982,11998,541184,4663,527979,0,40.7720526064658,125179,2.06942348989441,244112.487774336,506.641176470589,11566,6258999.98999999
1182,BTC,2011-05-20,431765,548408,7224,11600,548408,4795,532774,0,74.3256352767737,125399,2.66661647488419,244112.487774336,393.178082191781,9464,6269999.98999998
1182,BTC,2011-05-21,437447,555218,6810,10772,555218,4964,537738,2,133.955242950304,125619,2.69345530905568,244112.487774336,389.260273972603,9006,6280999.98999998
1182,BTC,2011-05-22,443179,562023,6805,10834,562023,5282,543020,3,168.736071102838,125871,3.05846128766131,244112.487774336,342.804780876494,8164,6293599.99
1182,BTC,2011-05-23,449648,569447,7424,12092,569447,5745,548765,3,82.2532720728268,126157,3.48234664057423,244112.487774336,301.077192982456,8178,6307899.99
1182,BTC,2011-05-24,456046,577911,8464,13185,577911,5865,554630,0,62.9708581314271,126456,3.62837806477437,244112.487774336,288.959731543624,7671,6322849.99
1182,BTC,2011-05-25,462867,587342,9431,14562,587342,6258,560888,0,63.454019783597,126763,3.73128730528137,244112.487774336,280.990196078432,8554,6338199.98999999
1182,BTC,2011-05-26,470253,596057,8715,14476,596057,6967,567855,0,61.3901450501866,127059,4.12533999903099,277625.180352617,289.040677966102,9633,6352999.98999999
1182,BTC,2011-05-27,475477,602148,6091,10813,602148,4853,572708,2,112.227047241278,127226,3.60307635222302,434877.045527628,518.385542168675,11312,6361349.98999999
1182,BTC,2011-05-28,481019,609016,6868,11640,609016,5013,577721,0,46.4209798041672,127381,3.35047797322806,434877.045527628,557.467532467533,12765,6369099.99
1182,BTC,2011-05-29,486670,615177,6161,11196,615177,4753,582474,0,57.8543864071597,127561,3.95477946521351,434877.045527628,472.284916201117,10702,6378099.98999998
1182,BTC,2011-05-30,492370,622928,7751,12750,622928,5337,587811,0,51.8821490492205,127715,3.351795720256,434877.045527628,557.248366013072,14349,6385799.98999999
1182,BTC,2011-05-31,499328,631484,8556,14046,631484,6063,593874,0,47.4334559197328,127865,3.22793472858886,434877.045527628,578.630872483222,17156,6393299.98999999
1182,BTC,2011-06-01,506535,639649,8165,13981,639649,6540,600414,0,42.9634235781988,128053,4.06564344499719,434877.045527628,459.4064171123,14577,6402699.98999999
1182,BTC,2011-06-02,514908,648679,9030,15519,648679,7136,607550,2,50.9142106308086,128243,4.10926976105171,434877.045527628,454.529100529101,16117,6412199.98999999
1182,BTC,2011-06-03,524499,659388,10709,17815,659388,8441,615991,7,73.7141649374268,128445,4.35537159044032,434877.045527628,428.845771144279,20057,6422299.98999998
1182,BTC,2011-06-04,534206,671661,12273,19418,671661,8811,624802,2,55.3181802745125,128669,4.83544474559271,434877.045527628,386.269058295964,16756,6433499.98999999
1182,BTC,2011-06-05,543407,682471,10810,17861,682471,8592,633394,5,65.639649888608,128877,4.48887179392679,434877.045527628,416.091787439613,15776,6443899.98999999
1182,BTC,2011-06-06,554481,695023,12552,20962,695023,9703,643097,4,86.4765216033186,129110,5.62713767389989,484311.149232465,369.655172413793,18303,6455549.99
1182,BTC,2011-06-07,564597,706442,11419,18964,706442,9002,652099,3,59.3539705932448,129280,4.76968143837926,567269.530162422,510.810650887574,21104,6464049.99
1182,BTC,2011-06-08,580562,721992,15550,27306,721992,11815,663914,19,67.4457732953237,129465,5.26715798867303,567269.530162422,462.565217391305,30671,6473299.98999999
1182,BTC,2011-06-09,594947,738485,16493,26278,738485,12176,676090,15,64.2686033296616,129687,6.25539112299848,567269.530162422,389.488687782805,23544,6484399.98999999
1182,BTC,2011-06-10,607875,753380,14895,24145,753380,11269,687359,12,82.7758117918546,129910,6.27786141316904,567269.530162422,388.094594594595,21142,6495549.98999999
1182,BTC,2011-06-11,620499,767590,14210,23770,767590,10897,698256,29,136.547114461673,130162,7.15951840517335,567269.530162422,340.302788844621,17512,6508149.98999999
1182,BTC,2011-06-12,635504,784008,16418,27014,784008,12440,710696,31,147.919131207469,130395,6.60056222353979,567269.530162422,369.120689655172,22714,6519799.98999999
1182,BTC,2011-06-13,648876,799127,15119,25809,799127,11246,721942,21,113.72679774442,130622,6.62480535750836,567269.530162422,367.769911504425,21722,6531149.98999998
1182,BTC,2011-06-14,664679,817272,18145,29778,817272,14158,736100,31,109.403859721733,130869,6.96382357577193,567269.530162422,349.865853658537,22612,6543499.99
1182,BTC,2011-06-15,679428,833913,16641,27541,833913,12605,748705,186,336.584544609291,131148,9.54958694178894,688257.562439381,309.546762589928,19427,6557449.99
1182,BTC,2011-06-16,694973,851390,17477,28868,851390,12746,761451,437,688.099692089504,131328,7.92181448858541,876954.493513537,475.458100558659,30178,6566449.98999999
1182,BTC,2011-06-17,708453,866811,15421,26054,866811,11296,772747,27,139.554065902085,131514,8.07398218926982,876954.493513537,466.497297297297,26441,6575749.98999999
1182,BTC,2011-06-18,721827,883188,16377,26115,883188,11563,784310,20,109.592665953919,131711,8.8951141718614,876954.493513537,423.433673469388,24290,6585599.99
1182,BTC,2011-06-19,735494,899560,16372,27766,899560,11472,795782,53,398.700797724691,131934,9.8232042983287,876954.493513537,383.427927927928,22123,6596749.98999999
1182,BTC,2011-06-20,747082,914520,14960,25961,914520,11225,807007,21,119.709230345783,132168,10.1805316827137,876954.493513537,369.969957081545,18501,6608449.98999999
1182,BTC,2011-06-21,757829,929258,14738,24996,929258,9704,816711,99,342.503681819187,132421,11.0428576318138,876954.493513537,341.079365079365,15847,6621099.98999999
1182,BTC,2011-06-22,769521,945093,15835,26764,945093,11519,828230,8,115.9038923097,132681,11.3604417754479,876954.493513537,331.544401544402,16768,6634099.98999999
1182,BTC,2011-06-23,780252,959101,14008,24369,959101,10418,838648,7,156.927895220979,132921,10.4744050390181,876954.493513537,359.589958158996,16861,6646099.99000001
1182,BTC,2011-06-24,792490,973795,14694,25212,973795,10922,849570,183,438.166372847795,133137,11.4773496077373,1067618.84150702,399.516279069767,19923,6656899.98999999
1182,BTC,2011-06-25,803275,986783,12988,22628,986783,9693,859263,251,1106.48296470984,133280,9.98918342805227,1379192.28822808,593.0,28028,6664049.98999999
1182,BTC,2011-06-26,815137,1000801,14018,23539,1000801,9985,869248,116,405.769829731908,133429,10.5624112285344,1379192.28822808,560.817567567567,28848,6671499.98999999
1182,BTC,2011-06-27,829480,1018473,17672,30137,1018473,11751,880999,28,159.814476229776,133598,11.6507728041149,1379192.28822808,508.428571428572,32423,6679949.99
1182,BTC,2011-06-28,842478,1033818,15345,26180,1033818,10719,891718,283,641.071503795788,133758,10.960539710707,1379192.28822808,540.446540880503,28019,6687949.99
1182,BTC,2011-06-29,853512,1048291,14473,24333,1048291,10002,901720,146,278.467638732738,133930,11.7836363834156,1379192.28822808,502.695906432748,24108,6696549.98999999
1182,BTC,2011-06-30,864616,1061595,13304,23459,1061595,9636,911356,76,156.327078467699,134121,13.3848832961331,1379192.28822808,442.557894736842,21155,6706099.98999999
1182,BTC,2011-07-01,876278,1081938,20343,30214,1081938,10603,921959,39,105.422797511393,134294,11.8438662806614,1379192.28822808,500.139534883721,26486,6714749.99
1182,BTC,2011-07-02,885251,1105456,23518,32230,1105456,8018,929977,33,109.12491808295,134463,11.549228937253,1379192.28822808,512.89880952381,21917,6723199.98999999
1182,BTC,2011-07-03,894743,1118870,13414,22246,1118870,8364,938341,26,69.1678174489861,134628,11.3244514395866,1379192.28822808,523.079268292683,20713,6731449.99
1182,BTC,2011-07-04,905740,1132814,13944,23558,1132814,9604,947945,17,141.95734182075,134798,11.7075126959947,1379192.28822808,505.96449704142,23844,6739949.98999999
1182,BTC,2011-07-05,916298,1145330,12516,23298,1145330,8965,956910,2,46.2431973631824,134937,9.59645512192844,1379192.28822808,617.268115942029,28898,6746899.98999999
1182,BTC,2011-07-06,928635,1161236,15906,26919,1161236,10519,967429,5,54.8241006469817,135094,10.9187435062531,1406123.63396965,553.108974358974,30170,6754749.99
1182,BTC,2011-07-07,938543,1175508,14272,22941,1175508,9180,976609,3,51.4417382266275,135225,10.3848309243156,1563027.99611622,646.438461538462,29157,6761299.98999998
1182,BTC,2011-07-08,947831,1190460,14952,24626,1190460,8528,985137,2,36.704396890652,135390,13.0224533867081,1563027.99611622,515.506097560976,21960,6769549.99000001
1182,BTC,2011-07-09,956617,1204580,14120,22762,1204580,7851,992988,43,265.343618714435,135539,11.6004858390327,1563027.99611622,578.695945945946,22822,6776999.98999999
1182,BTC,2011-07-10,965590,1224518,19938,28708,1224518,8392,1001380,54,289.825613785443,135676,10.8092081969007,1563027.99611622,621.058823529412,28664,6783849.98999999
1182,BTC,2011-07-11,976790,1240348,15830,25850,1240348,10523,1011903,17,96.3978155200732,135833,12.297752925903,1563027.99611622,545.884615384615,27230,6791699.98999999
1182,BTC,2011-07-12,985741,1254147,13799,23044,1254147,8147,1020050,21,131.884775262189,135974,10.9208981936488,1563027.99611622,614.707142857143,24730,6798749.98999999
1182,BTC,2011-07-13,995644,1271312,17165,27175,1271312,9193,1029243,32,156.196951326452,136165,14.9778565266126,1563027.99611622,448.205263157895,19822,6808299.99
1182,BTC,2011-07-14,1004919,1290010,18698,28843,1290010,8716,1037959,48,221.592729151,136309,11.4745169853145,1563027.99611622,585.048951048951,26339,6815499.98999999
1182,BTC,2011-07-15,1013601,1305405,15395,24433,1305405,7998,1045957,10,75.6383379697862,136471,13.1360105773564,1563027.99611622,511.049689440994,20376,6823599.98999999
1182,BTC,2011-07-16,1023287,1320030,14625,24053,1320030,8876,1054833,30,141.493167215137,136628,12.1612286464924,1563027.99611622,552.012820512821,23598,6831449.99
1182,BTC,2011-07-17,1032288,1335560,15530,24674,1335560,8379,1063212,10,68.1551713169793,136798,13.1413965540323,1563027.99611622,510.84023668639,21549,6839949.99
1182,BTC,2011-07-18,1045868,1350916,15356,27882,1350916,8976,1072188,87,368.766345947697,136968,13.3939725078239,1563027.99611622,501.207100591716,27003,6848449.99
1182,BTC,2011-07-19,1056209,1366789,15873,24900,1366789,9185,1081373,89,298.490329701973,137110,11.1565729164269,1583738.97892983,609.695035460993,29297,6855549.98999999
1182,BTC,2011-07-20,1066782,1382629,15840,25886,1382629,8863,1090236,6,62.1324486333916,137259,12.4733276303579,1690895.80305239,582.22972972973,25920,6862999.98999999
1182,BTC,2011-07-21,1076492,1399115,16486,25435,1399115,8163,1098399,43,164.193315942242,137411,12.7743452552054,1690895.80305239,568.509933774835,24297,6870599.98999999
1182,BTC,2011-07-22,1087374,1415108,15993,24454,1415108,8991,1107390,38,173.40175366123,137562,12.7269589721015,1690895.80305239,570.626666666667,25327,6878149.98999999
1182,BTC,2011-07-23,1096100,1429151,14043,21907,1429151,7415,1114805,15,82.4437428958409,137708,12.3795259440977,1690895.80305239,586.641379310345,22457,6885449.98999999
1182,BTC,2011-07-24,1105173,1443947,14796,23227,1443947,8219,1123024,12,66.9027977626573,137874,14.000472711258,1690895.80305239,518.721212121212,21670,6893749.99
1182,BTC,2011-07-25,1115650,1460969,17022,26960,1460969,9485,1132509,50,152.029898650268,138039,13.9138331391215,1690895.80305239,521.951219512195,26272,6901999.98999998
1182,BTC,2011-07-26,1125825,1475438,14469,23820,1475438,8370,1140879,46,141.994156203896,138215,14.8985965562505,1690895.80305239,487.451428571429,21533,6910799.98999999
1182,BTC,2011-07-27,1134655,1490113,14675,23479,1490113,7995,1148874,58,159.688904197485,138389,14.6847738499981,1690895.80305239,494.549132947977,20902,6919499.98999999
1182,BTC,2011-07-28,1144940,1506418,16305,25901,1506418,8119,1156993,206,418.807408654475,138544,13.0144957812098,1690895.80305239,558.019480519481,24038,6927249.98999999
1182,BTC,2011-07-29,1152878,1520488,14070,22221,1520488,7315,1164308,22,95.3852019674983,138708,14.0237856977616,1690895.80305239,517.858895705521,18739,6935449.98999999
1182,BTC,2011-07-30,1159666,1533085,12597,19760,1533085,6209,1170517,3,53.5051156982928,138860,13.2588584953463,1690895.80305239,547.735099337749,17124,6943049.98999999
1182,BTC,2011-07-31,1168751,1548811,15726,24137,1548811,8099,1178616,7,74.4570958250463,139035,14.7467328563349,1690895.80305239,492.471264367816,19720,6951799.98999999
1182,BTC,2011-08-01,1178080,1564146,15335,23757,1564146,8195,1186811,3,67.0003782783136,139200,14.9537531978524,1807231.66682914,519.067073170732,22571,6960049.99
1182,BTC,2011-08-02,1188146,1576765,12619,21703,1576765,8817,1195628,1,45.9603773566621,139354,14.8299567552927,1888786.70535305,547.019607843138,25117,6967749.99
1182,BTC,2011-08-03,1197093,1586403,9638,18410,1586403,7737,1203365,1,53.7471477590125,139511,14.7573346401178,1888786.70535305,549.711538461538,22168,6975599.98999999
1182,BTC,2011-08-04,1206705,1596633,10230,18966,1596633,8307,1211672,1,39.1533593488443,139640,12.107593951426,1888786.70535305,670.015625,27100,6982049.99
1182,BTC,2011-08-05,1215022,1610425,13792,21510,1610425,7360,1219032,14,68.0576163760557,139780,13.391524302898,1888786.70535305,605.776978417266,22285,6989049.99
1182,BTC,2011-08-06,1222976,1623129,12704,20231,1623129,6834,1225866,2,56.404463315619,139902,11.4608279631735,1888786.70535305,707.826446280992,26062,6995149.98999999
1182,BTC,2011-08-07,1230458,1635948,12819,20060,1635948,6710,1232576,1,55.2558433966587,140028,11.8289255301997,1888786.70535305,685.8,22425,7001449.98999999
1182,BTC,2011-08-08,1242210,1649103,13155,24628,1649103,7267,1239843,13,143.749382349521,140164,12.731723736456,1888786.70535305,637.17037037037,27203,7008249.99
1182,BTC,2011-08-09,1252323,1663816,14713,23668,1663816,9219,1249062,51,269.880003892909,140310,13.8464095447851,1888786.70535305,585.875862068965,28177,7015549.98999999
1182,BTC,2011-08-10,1261724,1674312,10496,19710,1674312,8335,1257397,23,137.746005466056,140462,14.28251109321,1888786.70535305,567.986754966887,23049,7023149.98999998
1182,BTC,2011-08-11,1270516,1684227,9915,18290,1684227,7596,1264993,4,64.660691569534,140599,12.9118939387577,1888786.70535305,628.279411764706,22631,7029999.98999999
1182,BTC,2011-08-12,1279337,1693444,9217,17126,1693444,7165,1272158,1,48.172551959693,140730,12.2192666410148,1888786.70535305,663.892307692308,22314,7036549.99
1182,BTC,2011-08-13,1288789,1705290,11846,19184,1705290,7398,1279556,2,41.9810755125858,140860,12.2204235419437,1888786.70535305,663.829457364341,24128,7043049.99
1182,BTC,2011-08-14,1297834,1718493,13203,21506,1718493,7471,1287027,4,60.9130596778611,140992,12.7420002379803,1888786.70535305,636.656488549618,26015,7049649.99
1182,BTC,2011-08-15,1307423,1729245,10752,19220,1729245,8379,1295406,1,40.574789062776,141121,12.2159954658495,1887498.55234282,663.6171875,29744,7056099.98999999
1182,BTC,2011-08-16,1318128,1740977,11732,20992,1740977,9640,1305046,4,38.2072553847884,141268,13.1944183080137,1805700.83619367,587.780821917809,27638,7063449.99
1182,BTC,2011-08-17,1327432,1752951,11974,20363,1752951,7722,1312768,2,42.716513850079,141404,12.2229650245114,1805700.83619367,634.496296296296,25594,7070249.99
1182,BTC,2011-08-18,1335599,1764869,11918,20675,1764869,7415,1320183,1,54.9538345336898,141548,13.0547358909392,1805700.83619367,594.06993006993,21981,7077449.98999999
1182,BTC,2011-08-19,1344112,1779107,14238,22233,1779107,7614,1327797,3,73.8985513600565,141679,11.9259204026014,1805700.83619367,650.3,27046,7083999.98999999
1182,BTC,2011-08-20,1351534,1792101,12994,21113,1792101,7191,1334988,0,32.2933873735322,141831,13.670016829229,1805700.83619367,567.331125827814,20510,7091599.98999999
1182,BTC,2011-08-21,1359982,1806952,14851,22784,1806952,7667,1342655,0,32.7244382569701,141991,14.3115612452364,1805700.83619367,541.899371069182,20296,7099599.98999999
1182,BTC,2011-08-22,1368565,1823202,16250,25202,1823202,7815,1350470,0,36.0449022907844,142160,15.1891672128652,1805700.83619367,510.589285714286,20855,7108049.99
1182,BTC,2011-08-23,1376365,1837292,14090,22694,1837292,7277,1357747,1,61.4911950784966,142315,14.0147337458695,1805700.83619367,553.376623376623,20649,7115799.98999998
1182,BTC,2011-08-24,1384635,1850969,13677,22129,1850969,7367,1365114,2,76.8823827075798,142449,12.0230754161736,1805700.83619367,645.045112781955,23619,7122499.99
1182,BTC,2011-08-25,1392842,1865504,14535,23113,1865504,7241,1372355,2,52.5306707256014,142584,12.4303512878183,1805700.83619367,623.910447761194,23503,7129249.98999999
1182,BTC,2011-08-26,1402064,1877906,12402,21536,1877906,7421,1379776,0,38.4054246591807,142731,13.378533721516,1805700.83619367,579.691780821918,22968,7136599.99
1182,BTC,2011-08-27,1411003,1889761,11855,20857,1889761,6361,1386137,16,426.28443037225,142853,11.1574269442752,1805700.83619367,695.090909090909,24946,7142699.99
1182,BTC,2011-08-28,1417395,1901322,11561,18476,1901322,5589,1391726,0,33.8584353450295,142969,10.4403108462101,1805700.83619367,742.834782608696,21234,7148499.98999999
1182,BTC,2011-08-29,1426217,1912735,11413,18891,1912735,8094,1399820,0,30.1562377463281,143107,12.3994137775,1805700.83619367,625.467153284671,24845,7155399.99
1182,BTC,2011-08-30,1434839,1922010,9275,17534,1922010,7804,1407624,0,31.2899671582355,143253,12.9533817930661,1783130.22116161,591.234482758621,21783,7162699.99
1182,BTC,2011-08-31,1443147,1930984,8974,17029,1930984,7292,1414916,0,37.2891002918417,143408,13.8044660955434,1777774.48200146,553.116883116883,19086,7170449.98999999
1182,BTC,2011-09-01,1451622,1939705,8721,16984,1939705,7203,1422119,0,46.5455965007261,143537,11.5222684829647,1777774.48200146,662.671875,23808,7176899.98999999
1182,BTC,2011-09-02,1459529,1948198,8493,16099,1948198,7026,1429145,0,37.1669074040919,143693,13.8776504177747,1777774.48200146,550.2,18376,7184699.99
1182,BTC,2011-09-03,1466349,1955676,7478,14464,1955676,5925,1435070,0,39.090239931784,143838,12.8742165404406,1777774.48200146,593.083333333333,17124,7191949.99
1182,BTC,2011-09-04,1474796,1965666,9990,17537,1965666,7258,1442328,0,240.46547435779,143972,11.8138584639522,1777774.48200146,646.315789473684,40163,7198649.99
1182,BTC,2011-09-05,1483135,1975620,9954,18243,1975620,7039,1449367,0,322.992830397879,144128,13.8631826786722,1777774.48200146,550.774193548387,19832,7206449.98999999
1182,BTC,2011-09-06,1492888,1985622,10002,18776,1985622,7830,1457197,0,403.008689750636,144279,13.4606048982682,1777774.48200146,567.246666666667,23172,7213999.99
1182,BTC,2011-09-07,1501104,1994404,8782,16824,1994404,7090,1464287,2,89.7279768708378,144415,12.0474309566397,1777774.48200146,633.785185185185,22320,7220799.98999999
1182,BTC,2011-09-08,1508690,2002406,8002,15802,2002406,6497,1470784,0,60.777366227762,144544,11.6404265940381,1777774.48200146,655.9453125,21924,7227249.99
1182,BTC,2011-09-09,1518368,2011129,8723,18605,2011129,7376,1478160,0,55.337415314821,144698,13.6392488063154,1777774.48200146,559.816993464052,25458,7234949.99
1182,BTC,2011-09-10,1526812,2018424,7295,15938,2018424,5993,1484153,0,45.3551231732254,144831,11.9450062256476,1777774.48200146,639.219696969697,21831,7241599.98999999
1182,BTC,2011-09-11,1534484,2026581,8157,15421,2026581,6443,1490596,14,158.288755884233,144956,11.1619344079812,1777774.48200146,684.064516129032,23454,7247849.98999999
1182,BTC,2011-09-12,1542516,2034773,8192,16637,2034773,6575,1497171,0,95.4337876745445,145089,11.775306278568,1777774.48200146,648.431818181818,23229,7254499.99
1182,BTC,2011-09-13,1549959,2042772,7999,14870,2042772,6519,1503690,1,54.9997871013652,145231,12.4931701563249,1765183.40500273,606.843971631206,19008,7261599.98999998
1182,BTC,2011-09-14,1556997,2050199,7427,14793,2050199,6200,1509890,0,48.8095200878097,145377,13.0724958088249,1755425.3203287,576.744827586207,18007,7268899.98999999
1182,BTC,2011-09-15,1564570,2058234,8035,15457,2058234,6474,1516364,0,46.2196680020853,145533,13.5522216246388,1755425.3203287,556.329032258064,18239,7276699.99
1182,BTC,2011-09-16,1571909,2065958,7724,14561,2065958,6209,1522573,0,108.649840769565,145652,10.3499422076257,1755425.3203287,728.457627118644,22135,7282649.98999999
1182,BTC,2011-09-17,1578274,2072696,6738,13124,2072696,5454,1528027,0,64.9429676893326,145786,11.6148069984458,1755425.3203287,649.127819548872,17116,7289349.99
1182,BTC,2011-09-18,1584920,2079889,7193,14359,2079889,5986,1534013,0,49.9306187859121,145944,13.8510936425302,1755425.3203287,544.324840764331,15729,7297249.98999999
1182,BTC,2011-09-19,1593085,2088310,8421,16062,2088310,6653,1540666,0,50.3164489077845,146071,11.1883013027529,1755425.3203287,673.873015873016,24278,7303599.98999999
1182,BTC,2011-09-20,1602170,2102171,13861,21913,2102171,8145,1548811,0,43.4039975404837,146211,12.202670099114,1755425.3203287,617.856115107914,28120,7310599.98999999
1182,BTC,2011-09-21,1612305,2111339,9168,17933,2111339,7684,1556495,1,51.5298062200416,146357,12.751378443796,1755425.3203287,591.268965517241,25639,7317899.99
1182,BTC,2011-09-22,1619327,2121985,10646,17540,2121985,6139,1562634,0,50.6725569531015,146505,13.3317174669887,1755425.3203287,565.530612244897,17998,7325299.99
1182,BTC,2011-09-23,1626411,2135610,13625,19994,2135610,6328,1568962,0,54.5410681854788,146638,11.5727853977213,1755425.3203287,651.484848484848,20118,7331949.99
1182,BTC,2011-09-24,1633281,2148465,12855,19433,2148465,5728,1574690,0,40.5184391115416,146767,11.2249665677636,1755425.3203287,671.671875,20834,7338399.98999999
1182,BTC,2011-09-25,1639622,2161704,13239,19237,2161704,5722,1580412,1,51.7615732751241,146904,12.0013487023101,1755425.3203287,628.220588235294,19060,7345249.98999999
1182,BTC,2011-09-26,1645861,2173099,11395,17763,2173099,5639,1586051,0,50.5736144058078,147038,12.0313485800446,1755425.3203287,626.654135338346,18030,7351949.98999998
1182,BTC,2011-09-27,1652920,2185156,12057,18692,2185156,6101,1592152,0,70.5010735340649,147171,11.5912217167078,1753437.62361497,649.712121212121,19895,7358599.98999999
1182,BTC,2011-09-28,1659403,2192203,7047,13750,2192203,6017,1598169,0,59.454741386819,147318,12.3105503647161,1689334.4045971,589.383561643836,16838,7365949.99
1182,BTC,2011-09-29,1665564,2198908,6705,12797,2198908,5589,1603758,0,59.7216837686384,147443,10.649970601561,1689334.4045971,681.282258064516,18062,7372199.99
1182,BTC,2011-09-30,1672257,2205931,7023,13468,2205931,5865,1609623,0,49.8609056810776,147565,10.4282315578231,1689334.4045971,695.768595041322,19798,7378299.98999999
1182,BTC,2011-10-01,1678521,2212295,6364,12999,2212295,5374,1614997,0,77.9934749383122,147708,12.0446611503952,1689334.4045971,602.394366197183,16188,7385449.98999999
1182,BTC,2011-10-02,1684204,2218315,6020,11839,2218315,5035,1620032,0,64.0013721233962,147829,10.3080094046156,1689334.4045971,703.883333333333,17314,7391499.99
1182,BTC,2011-10-03,1691440,2225957,7642,13848,2225957,6521,1626553,0,62.6692102622343,147974,12.4194561418369,1689334.4045971,584.215277777778,18042,7398749.99
1182,BTC,2011-10-04,1698380,2233306,7349,13799,2233306,5809,1632362,0,72.1929757736581,148086,9.47746002721283,1689334.4045971,765.567567567568,22648,7404349.99000001
1182,BTC,2011-10-05,1704758,2240240,6934,13654,2240240,5771,1638133,0,70.6208945043372,148231,12.1251446209694,1689334.4045971,598.395833333334,16945,7411599.99
1182,BTC,2011-10-06,1712055,2247593,7353,14442,2247593,5912,1644045,0,90.5529363330565,148359,10.9035010177199,1689334.4045971,665.44094488189,20312,7417999.99
1182,BTC,2011-10-07,1718629,2254525,6932,13746,2254525,5674,1649719,0,67.4964020970532,148497,11.5973694707336,1689334.4045971,625.627737226277,17897,7424899.98999999
1182,BTC,2011-10-08,1724707,2260984,6459,12497,2260984,5402,1655121,0,52.4736030929248,148616,9.91792702381416,1689334.4045971,731.567796610169,19187,7430849.98999999
1182,BTC,2011-10-09,1730595,2267497,6513,12276,2267497,5457,1660578,0,55.7215707510152,148743,10.9223323316182,1689334.4045971,664.293650793651,18206,7437199.98999999
1182,BTC,2011-10-10,1737263,2274627,7130,13349,2274627,5882,1666460,0,53.9265711742418,148866,10.4742293241089,1689334.4045971,692.713114754098,19697,7443349.98999998
1182,BTC,2011-10-11,1744065,2282133,7506,13715,2282133,5930,1672390,0,56.1655810650793,148959,7.77096955514268,1689334.4045971,933.684782608695,29022,7447999.98999999
1182,BTC,2011-10-12,1750850,2289350,7217,13584,2289350,5949,1678339,0,54.0949307522592,149079,10.0870437789935,1689334.4045971,719.302521008403,21547,7453999.99
1182,BTC,2011-10-13,1756363,2295587,6237,11659,2295587,4984,1683323,0,61.1508970139125,149176,8.1721033612902,1689334.4045971,887.854166666667,21946,7458849.98999999
1182,BTC,2011-10-14,1763782,2302859,7272,14554,2302859,6111,1689434,0,45.3854950126542,149315,10.2547062363414,1479331.92248438,619.586956521739,18939,7465799.99
1182,BTC,2011-10-15,1770164,2309687,6828,13158,2309687,5579,1695013,0,68.6579856958254,149449,9.89275662925886,1468195.42722083,637.421052631579,17403,7472499.98999999
1182,BTC,2011-10-16,1776005,2315718,6031,11983,2315718,4981,1699994,0,52.4628241035093,149568,8.67127126589744,1468195.42722083,727.21186440678,18075,7478449.99
1182,BTC,2011-10-17,1782680,2322636,6918,14144,2322636,5781,1705775,0,84.0772905218838,149686,8.71704582220394,1468195.42722083,723.393162393163,22782,7484349.98999999
1182,BTC,2011-10-18,1788204,2328613,5977,12316,2328613,4863,1710638,0,70.6982412829447,149806,9.11084236783477,1468195.42722083,692.126050420169,17740,7490349.98999999
1182,BTC,2011-10-19,1794020,2334646,6033,12555,2334646,5130,1715768,0,60.1360527927544,149939,9.7621811694673,1468195.42722083,645.94696969697,16536,7496999.99
1182,BTC,2011-10-20,1798949,2340062,5416,11118,2340062,4649,1720417,0,64.2023868225833,150054,8.48310797868475,1468195.42722083,743.342105263158,16291,7502749.98999999
1182,BTC,2011-10-21,1804662,2346396,6334,12051,2346396,5206,1725623,0,109.049961730667,150175,8.84793752892235,1468195.42722083,712.691666666667,16213,7508799.99
1182,BTC,2011-10-22,1810283,2352618,6222,12109,2352618,5114,1730737,0,110.783042014691,150273,7.32781747619407,1468195.42722083,860.536082474227,22048,7513699.99
1182,BTC,2011-10-23,1816549,2359637,7019,13218,2359637,5608,1736345,0,101.814900615159,150381,7.94094357656263,1468195.42722083,794.093457943926,21027,7519099.99
1182,BTC,2011-10-24,1823401,2366945,7308,13953,2366945,5934,1742279,0,62.3447666189737,150508,9.282845001289,1468195.42722083,679.301587301587,19272,7525449.99
1182,BTC,2011-10-25,1829166,2373498,6553,13107,2373498,5226,1747505,0,72.9974631244795,150637,9.38468929317878,1468195.42722083,671.9296875,16969,7531899.98999999
1182,BTC,2011-10-26,1835249,2379964,6466,12447,2379964,5272,1752777,0,81.534046356874,150754,8.57416021087098,1468195.42722083,735.448275862069,18995,7537749.98999998
1182,BTC,2011-10-27,1840648,2385763,5799,11458,2385763,4677,1757454,0,108.694916677793,150854,7.48276118688911,1468195.42722083,842.717171717172,19232,7542749.98999999
1182,BTC,2011-10-28,1847094,2392317,6554,12708,2392317,5118,1762572,0,88.5658256701876,150959,7.69276879508766,1468195.42722083,819.711538461538,21385,7547999.99
1182,BTC,2011-10-29,1853583,2399098,6781,12873,2399098,5596,1768168,0,78.5505678216083,151072,8.56305819238848,1468195.42722083,736.401785714286,21706,7553649.98999999
1182,BTC,2011-10-30,1859247,2405114,6016,11401,2405114,4980,1773148,0,42.6993534431406,151183,8.05260854950166,1468195.42722083,783.081818181818,18510,7559199.98999999
1182,BTC,2011-10-31,1865030,2411303,6189,12022,2411303,5182,1778330,0,75.152918374423,151314,8.1004135290879,1235795.78907809,655.238461538461,15892,7565749.99
1182,BTC,2011-11-01,1871583,2418592,7289,12768,2418592,5777,1784107,0,93.4460478200225,151464,9.11157187520477,1203461.92637997,567.281879194631,15425,7573249.99
1182,BTC,2011-11-02,1878473,2425808,7216,13117,2425808,5991,1790098,0,68.270787359344,151618,9.16448531416008,1203461.92637997,564.006535947712,15268,7580949.99
1182,BTC,2011-11-03,1885744,2433251,7443,13114,2433251,6253,1796351,0,56.8667608931713,151743,7.46566577392349,1203461.92637997,692.346774193548,19392,7587199.99
1182,BTC,2011-11-04,1894028,2441065,7814,15815,2441065,6540,1802891,0,61.2374349810061,151890,8.90420431263373,1203461.92637997,580.493150684932,18938,7594549.98999999
1182,BTC,2011-11-05,1900855,2448131,7066,13495,2448131,5928,1808819,0,49.2545629188141,152036,8.70810292317091,1203461.92637997,593.565517241379,17127,7601849.98999999
1182,BTC,2011-11-06,1906274,2454199,6068,11541,2454199,5034,1813853,0,45.6231415374116,152180,8.67803126607867,1203461.92637997,595.622377622378,13302,7609049.99000001
1182,BTC,2011-11-07,1912395,2460757,6558,12641,2460757,5496,1819349,0,48.9956876792012,152312,7.88160630964122,1203461.92637997,655.809160305344,18046,7615649.98999998
1182,BTC,2011-11-08,1919467,2468050,7293,13738,2468050,5994,1825343,0,186.957369717166,152461,8.99984450748117,1203461.92637997,574.324324324325,18015,7623099.98999999
1182,BTC,2011-11-09,1926837,2475896,7846,14341,2475896,6448,1831791,2,151.903935201411,152622,9.66621946217489,1203461.92637997,534.73125,16959,7631149.99
1182,BTC,2011-11-10,1934193,2483678,7782,14362,2483678,6541,1838332,0,55.2882396444687,152763,8.71220980266838,1203461.92637997,593.285714285714,19818,7638199.98999999
1182,BTC,2011-11-11,1940258,2489896,6218,12128,2489896,5093,1843425,0,59.9666419924602,152883,7.10169408344287,1203461.92637997,727.830508474576,18932,7644149.99
1182,BTC,2011-11-12,1946119,2495975,6079,12259,2495975,5127,1848552,0,52.0994715252779,153025,8.65606601301053,1203461.92637997,597.133802816901,15348,7651299.98999999
1182,BTC,2011-11-13,1952228,2502667,6692,12538,2502667,5374,1853926,0,46.5255826446539,153169,8.828429882553,1203461.92637997,585.475524475524,14773,7658499.98999999
1182,BTC,2011-11-14,1959276,2509715,7048,13718,2509715,5908,1859834,0,60.4311489952505,153312,8.53722926211272,1196024.68791719,601.704225352113,18401,7665649.98999999
1182,BTC,2011-11-15,1966602,2516940,7225,14168,2516940,6106,1865940,0,59.0283216404209,153477,9.84291888979943,1192497.75008948,520.34756097561,16387,7673899.99
1182,BTC,2011-11-16,1973629,2524163,7223,13156,2524163,6048,1871988,6,336.0327041281,153612,8.28850409022834,1192497.75008948,617.932835820896,19407,7680649.98999999
1182,BTC,2011-11-17,1979676,2530120,5957,12196,2530120,4959,1876947,5,661.595758444275,153751,8.33726478640097,1192497.75008948,614.31884057971,16184,7687599.99
1182,BTC,2011-11-18,1985819,2536630,6510,12421,2536630,5169,1882116,8,981.501580507098,153884,7.9373242052785,1192497.75008948,645.272727272727,16628,7694249.98999999
1182,BTC,2011-11-19,1989985,2541041,4411,10092,2541041,4724,1886840,7,873.561911018268,154007,7.37741314006142,1192497.75008948,694.245901639345,16749,7700399.99
1182,BTC,2011-11-20,1995239,2545856,4815,11420,2545856,5125,1891965,2,300.572624882051,154150,8.43338761906655,1192497.75008948,607.316901408451,16889,7707549.99
1182,BTC,2011-11-21,1999443,2550517,4661,10158,2550517,4770,1896735,2,355.518493005218,154268,7.16755509779299,1192497.75008948,714.57264957265,16562,7713449.99000001
1182,BTC,2011-11-22,2004486,2555849,5332,11490,2555849,5491,1902226,6,654.671919345625,154408,8.55140655322535,1192497.75008948,598.935251798561,16851,7720449.98999999
1182,BTC,2011-11-23,2009562,2561085,5236,11499,2561085,5598,1907824,2,280.428166345679,154542,7.95616885872118,1192497.75008948,643.744360902255,16949,7727149.99000001
1182,BTC,2011-11-24,2014402,2565888,4803,10946,2565888,5018,1912842,2,302.326581702401,154655,6.72656515396573,1192497.75008948,761.419642857143,20124,7732799.99
1182,BTC,2011-11-25,2019116,2571238,5350,11682,2571238,5486,1918328,1,198.418668114003,154790,8.02095487855055,1192497.75008948,638.544776119403,16893,7739549.98999999
1182,BTC,2011-11-26,2023331,2575847,4609,10288,2575847,4752,1923080,2,337.391857690364,154910,7.08986019618639,1192497.75008948,722.403361344538,17325,7745549.99
1182,BTC,2011-11-27,2027713,2580861,5014,10752,2580861,5061,1928141,3,355.781117145884,155024,6.84554365843316,1192497.75008948,748.185840707965,18073,7751249.99
1182,BTC,2011-11-28,2033417,2587187,6326,12621,2587187,5930,1934071,6,676.868648832142,155151,7.64393359177583,1192497.75008948,670.039682539683,20132,7757599.98999999
1182,BTC,2011-11-29,2040536,2594839,7652,14376,2594839,6414,1940485,9,615.29465430479,155289,8.2563305460158,1149719.77862414,598.087591240876,21789,7764499.98999999
1182,BTC,2011-11-30,2048749,2602005,7166,15435,2602005,6857,1947342,19,960.682270147264,155451,8.81003978768342,1090715.68005127,531.732919254658,20404,7772599.98999999
1182,BTC,2011-12-01,2054637,2609094,7089,14028,2609094,6352,1953694,5,334.43568250128,155633,9.92404564237923,1090715.68005127,472.044198895027,16286,7781699.98999999
1182,BTC,2011-12-02,2060475,2615806,6712,13328,2615806,6318,1960012,11,869.219763451991,155779,7.99060424175274,1090715.68005127,586.262068965517,18543,7788999.98999999
1182,BTC,2011-12-03,2066132,2621322,5516,12858,2621322,5631,1965643,7,621.957099096464,155931,8.22612615777516,1090715.68005127,569.476821192053,16359,7796599.98999999
1182,BTC,2011-12-04,2070858,2626875,5553,11873,2626875,5385,1971028,6,547.833202153148,156067,7.46860899219824,1090715.68005127,627.237037037037,16878,7803399.98999998
1182,BTC,2011-12-05,2076253,2633222,6347,13078,2633222,6237,1977265,6,475.90410886151,156225,8.52365180715022,1090715.68005127,549.598726114649,16507,7811299.99
1182,BTC,2011-12-06,2083420,2641229,8007,15244,2641229,7978,1985243,15,865.361807553082,156396,9.35453924752188,1090715.68005127,500.782352941177,19813,7819849.98999999
1182,BTC,2011-12-07,2088930,2647447,6218,12910,2647447,6135,1991378,12,914.465595040409,156534,7.52848841007976,1090715.68005127,622.248175182482,19470,7826749.98999999
1182,BTC,2011-12-08,2095807,2652695,5248,14059,2652695,5820,1997198,18,789.131953506498,156698,8.95483660956127,1090715.68005127,523.134969325153,16858,7834949.98999999
1182,BTC,2011-12-09,2100438,2658033,5338,11780,2658033,5588,2002786,5,360.535932771784,156845,8.06868170679247,1090715.68005127,580.58904109589,16082,7842299.98999999
1182,BTC,2011-12-10,2105602,2663472,5439,11947,2663472,5678,2008464,0,198.867194579218,156989,7.84899598154388,1090715.68005127,596.839160839161,16485,7849499.99
1182,BTC,2011-12-11,2110827,2668448,4976,12136,2668448,5261,2013725,0,165.274030168645,157141,8.39910727182669,1090715.68005127,557.748344370861,17566,7857099.99
1182,BTC,2011-12-12,2115288,2673099,4651,11359,2673099,4862,2018587,0,152.512359626084,157268,7.01151657258231,1101351.70943835,674.642857142857,18983,7863449.98999999
1182,BTC,2011-12-13,2119661,2678923,5824,11983,2678923,5406,2023993,0,65.5638283172216,157400,7.62616873556636,1155038.33396364,650.503816793893,18647,7870049.99000001
1182,BTC,2011-12-14,2124309,2684078,5155,11973,2684078,5692,2029685,0,76.452763491077,157553,8.90890222400787,1155038.33396364,556.842105263158,15678,7877699.99
1182,BTC,2011-12-15,2128293,2688442,4364,10026,2688442,4850,2034535,0,93.5384983834969,157665,6.75111331539287,1155038.33396364,734.81981981982,17242,7883299.98999998
1182,BTC,2011-12-16,2132760,2693258,4816,10633,2693258,5164,2039699,0,93.7538969960263,157783,7.01396544844862,1155038.33396364,707.282051282051,19871,7889199.99
1182,BTC,2011-12-17,2136972,2697791,4533,10215,2697791,4993,2044692,0,72.9901627404146,157933,8.59586385354312,1155038.33396364,577.120805369127,14532,7896699.98999999
1182,BTC,2011-12-18,2140634,2702032,4241,9874,2702032,4632,2049324,0,71.859747812405,158077,8.43893053317185,1155038.33396364,587.853146853147,13469,7903899.98999999
1182,BTC,2011-12-19,2146010,2707771,5739,12720,2707771,5844,2055168,0,83.0536170848682,158236,9.15489441886574,1155038.33396364,541.879746835443,17311,7911849.98999999
1182,BTC,2011-12-20,2152011,2713934,6163,13691,2713934,6295,2061463,0,84.5534688583431,158370,7.66907231771557,1155038.33396364,646.864661654135,24973,7918549.98999999
1182,BTC,2011-12-21,2156778,2719041,5107,11883,2719041,5577,2067040,0,103.953560952528,158519,8.5532925215814,1155038.33396364,579.993243243243,16324,7925999.98999999
1182,BTC,2011-12-22,2161596,2724426,5385,12034,2724426,5859,2072899,0,74.8385679666189,158667,8.66591276265316,1155038.33396364,572.455782312925,17318,7933399.98999999
1182,BTC,2011-12-23,2166061,2729885,5459,12106,2729885,5682,2078581,0,47.8209074749842,158809,8.18517047953971,1155038.33396364,606.078014184397,16640,7940499.99
1182,BTC,2011-12-24,2169711,2734154,4269,10250,2734154,4658,2083239,0,67.4519308034736,158954,8.3517977562142,1155038.33396364,593.986111111111,13361,7947749.98999999
1182,BTC,2011-12-25,2174052,2739207,5053,11801,2739207,5286,2088525,0,58.0078106448354,159128,10.0040492086309,1155038.33396364,495.884393063584,12890,7956449.99
1182,BTC,2011-12-26,2178608,2744751,5544,12175,2744751,5641,2094166,0,124.929332390924,159305,10.2168153761664,1156198.94897467,486.045454545455,13740,7965299.99
1182,BTC,2011-12-27,2183193,2750039,5288,11746,2750039,5211,2099377,0,129.41012159375,159450,8.35940866600482,1159929.49722438,595.958333333333,16132,7972549.99
1182,BTC,2011-12-28,2187412,2754522,4483,10806,2754522,5000,2104377,0,56.679365255606,159605,8.92889443533409,1159929.49722438,557.948051948052,14357,7980299.99
1182,BTC,2011-12-29,2191845,2759563,5041,11323,2759563,5212,2109589,0,97.664655059881,159743,7.98842105509832,1159929.49722438,623.635036496351,16804,7987199.99
1182,BTC,2011-12-30,2195867,2763986,4423,10544,2763986,5051,2114640,0,56.4955545776282,159885,8.17801191154758,1159929.49722438,609.177304964539,14956,7994299.98999999
1182,BTC,2011-12-31,2200326,2768508,4522,10887,2768508,5137,2119777,0,52.6641242549134,160036,8.68161727353349,1159929.49722438,573.84,16242,8001849.99
1182,BTC,2012-01-01,2204562,2773060,4552,11448,2773060,5001,2124778,2,69.486851844831,160189,8.76773081094813,1159929.49722438,568.203947368421,17072,8009499.98999999
1182,BTC,2012-01-02,2209289,2778147,5087,11914,2778147,5410,2130188,0,48.5453664735028,160340,8.73530209635252,1159929.49722438,570.313333333333,19120,8017049.99
1182,BTC,2012-01-03,2214881,2783460,5313,13136,2783460,5773,2135961,0,46.8981416881327,160499,9.1965622442648,1159929.49722438,541.708860759494,18211,8024999.99000001
1182,BTC,2012-01-04,2219840,2788783,5323,12470,2788783,5731,2141692,0,69.8994984949695,160648,8.54838345689583,1159929.49722438,582.783783783784,19350,8032449.98999999
1182,BTC,2012-01-05,2226178,2795743,6960,15386,2795743,6994,2148686,5,98.7285048764455,160795,8.54993418922654,1159929.49722438,582.678082191781,24677,8039799.99
1182,BTC,2012-01-06,2232475,2802205,6462,14909,2802205,6644,2155330,0,92.2506851446448,160966,9.93869638277229,1159929.49722438,501.258823529412,21752,8048349.99
1182,BTC,2012-01-07,2237864,2807802,5597,13423,2807802,5905,2161235,0,54.0727967323776,161150,10.7425852979136,1159929.49722438,463.748633879781,16700,8057549.99
1182,BTC,2012-01-08,2243662,2813945,6143,14671,2813945,6404,2167639,0,55.9403114817911,161313,9.60911159953433,1178875.26550481,526.919753086419,20421,8065699.98999999
1182,BTC,2012-01-09,2249648,2819790,5845,14840,2819790,6112,2173751,1,73.4675367328419,161477,10.3169448990937,1250757.73927466,520.693251533742,20391,8073899.99
1182,BTC,2012-01-10,2256444,2826698,6908,16090,2826698,6677,2180428,0,58.8852015833413,161618,8.96063316243698,1250757.73927466,599.507142857143,29670,8080949.98999999
1182,BTC,2012-01-11,2264334,2833548,6850,16989,2833548,7139,2187567,0,54.9665460165163,161771,9.52642498782379,1250757.73927466,563.901315789474,27516,8088599.98999999
1182,BTC,2012-01-12,2269938,2839678,6130,13881,2839678,6696,2194263,0,54.3100594775388,161926,9.65222312886801,1250757.73927466,556.551948051948,20203,8096349.99
1182,BTC,2012-01-13,2275964,2846198,6520,14497,2846198,6847,2201110,0,59.9252601210019,162066,8.74840882419007,1250757.73927466,614.05035971223,21760,8103349.99
1182,BTC,2012-01-14,2281762,2852698,6500,14566,2852698,6807,2207917,0,50.746404961569,162216,9.31406232734596,1250757.73927466,576.758389261745,19971,8110849.98999999
1182,BTC,2012-01-15,2287663,2858846,6148,13549,2858846,6312,2214229,0,43.6868773855244,162355,8.65262526448978,1250757.73927466,620.847826086957,20883,8117799.99000001
1182,BTC,2012-01-16,2293303,2865142,6296,14849,2865142,6974,2221203,0,62.6176339143949,162531,10.8403690749915,1250757.73927466,495.551724137931,19703,8126549.99
1182,BTC,2012-01-17,2299001,2871580,6438,14303,2871580,6752,2227955,0,65.4919160425592,162687,9.81077183440399,1250757.73927466,547.557692307692,19576,8134399.99
1182,BTC,2012-01-18,2304754,2878070,6490,14743,2878070,6647,2234602,0,56.81506865456,162815,8.0009308707195,1250757.73927466,671.417322834646,24815,8140799.97299999
1182,BTC,2012-01-19,2310719,2884664,6594,15094,2884664,6902,2241504,1,58.4263225758766,162965,9.3200271794454,1250757.73927466,576.389261744966,21241,8148299.87710467
1182,BTC,2012-01-20,2316300,2891020,6356,14195,2891020,6780,2248284,0,53.7612237807493,163110,9.04022199976758,1250757.73927466,594.229166666667,20875,8155549.48698482
1182,BTC,2012-01-21,2321515,2896650,5630,13526,2896650,6366,2254650,0,48.2768233466572,163274,10.1804427854667,1250757.73927466,527.674846625767,18315,8163749.04744397
1182,BTC,2012-01-22,2325530,2901193,4543,11406,2901193,5325,2259975,0,51.9700357152676,163410,8.80441396617484,1298931.4264282,633.644444444445,16622,8170548.84204106
1182,BTC,2012-01-23,2330077,2906580,5387,13221,2906580,6100,2266075,0,47.3880585620426,163580,11.2678380052825,1307728.36060407,498.467455621302,15229,8179048.6736363
1182,BTC,2012-01-24,2336359,2913428,6848,14937,2913428,7268,2273343,0,52.925927041164,163719,9.23857272684415,1307728.36060407,607.95652173913,24098,8185997.56325165
1182,BTC,2012-01-25,2343327,2921110,7682,16585,2921110,7961,2281304,0,53.1084098128351,163867,9.79880880019447,1307728.36060407,573.197278911565,25041,8193397.34414704
1182,BTC,2012-01-26,2348906,2927186,6076,14442,2927186,6598,2287902,0,63.8644031781115,164005,9.06808150391162,1307728.36060407,619.386861313869,22095,8200296.65061204
1182,BTC,2012-01-27,2354589,2933301,6115,14436,2933301,6337,2294239,0,56.9437119651365,164146,9.17079033528642,1307728.36060407,612.45,21382,8207345.24223046
1182,BTC,2012-01-28,2359393,2938679,5378,13055,2938679,5910,2300149,0,43.0986911635279,164291,9.74830872001069,1307728.36060407,576.166666666667,19138,8214592.94288382
1182,BTC,2012-01-29,2365578,2944429,5750,14393,2944429,6426,2306575,0,54.6518596234796,164458,10.8440897170293,1307728.36060407,517.94578313253,17987,8222941.75104147
1182,BTC,2012-01-30,2370427,2950134,5705,13509,2950134,6153,2312728,0,54.2167525174403,164630,11.1982002901396,1307728.36060407,501.567251461989,15792,8231541.41143302
1182,BTC,2012-01-31,2376460,2956920,6786,15633,2956920,6925,2319653,0,49.853820607135,164780,9.74567880783117,1307728.36060407,576.322147651007,21926,8239041.34443304
1182,BTC,2012-02-01,2381997,2963063,6143,14975,2963063,6502,2326155,0,66.9651822159951,164921,9.13562993875504,1307728.36060407,614.807142857143,20862,8246091.10632215
1182,BTC,2012-02-02,2388150,2969901,6838,16107,2969901,7164,2333319,0,52.6059704863652,165080,10.3576230517827,1307728.36060407,542.272151898734,21700,8254040.94315441
1182,BTC,2012-02-03,2394444,2976855,6954,16555,2976855,7050,2340369,0,54.7304146051901,165238,10.316390782466,1307728.36060407,544.43949044586,20770,8261940.78466081
1182,BTC,2012-02-04,2401567,2984145,7290,16363,2984145,7237,2347606,0,50.5833008207945,165395,10.5473646870889,1346207.35807706,548.185897435897,21104,8269790.75849937
1182,BTC,2012-02-05,2407724,2990644,6499,14859,2990644,6774,2354380,0,51.0928689084234,165537,9.9116344864157,1379647.43921429,597.836879432624,21271,8276890.75849937
1182,BTC,2012-02-06,2413381,2996559,5915,13896,2996559,6136,2360516,0,52.9399882262973,165683,10.1234007465054,1379647.43921429,585.331034482758,18749,8284190.75849937
1182,BTC,2012-02-07,2419794,3003320,6761,14709,3003320,7012,2367528,0,45.807568533986,165820,9.37781932500795,1379647.43921429,631.867647058823,22141,8291040.75599937
1182,BTC,2012-02-08,2425608,3009885,6565,14600,3009885,7024,2374552,0,44.0844568341486,165965,10.0255886608708,1379647.43921429,591.041666666667,21141,8298290.75599937
1182,BTC,2012-02-09,2431641,3016865,6980,15125,3016865,7488,2382040,0,36.93683456414,166110,9.90490499874306,1379647.43921429,598.243055555555,23220,8305540.75599938
1182,BTC,2012-02-10,2438957,3024513,7648,16357,3024513,8456,2390496,0,38.2316532816722,166248,9.47068920408634,1379647.43921429,625.671532846715,27532,8312440.75599937
1182,BTC,2012-02-11,2445927,3031574,7061,15291,3031574,7679,2398175,0,59.6563630766233,166398,10.2743480861124,1379647.43921429,576.731543624161,23164,8319940.61839413
1182,BTC,2012-02-12,2452056,3038016,6442,14187,3038016,7030,2405205,0,46.4063913191622,166556,10.8286372001045,1379647.43921429,547.210191082802,19618,8327840.58989413
1182,BTC,2012-02-13,2459255,3045588,7572,16259,3045588,7992,2413197,2,53.6671784898123,166693,9.57765567173237,1379647.43921429,618.683823529412,26395,8334690.58989414
1182,BTC,2012-02-14,2467993,3054788,9200,18412,3054788,9489,2422686,1,142.573070417459,166831,9.55496129408397,1379647.43921429,620.153284671533,31891,8341590.57589414
1182,BTC,2012-02-15,2475956,3063739,8951,17768,3063739,9337,2432023,7,144.027427046596,166965,9.58417229907851,1379647.43921429,618.263157894737,30038,8348290.56808977
1182,BTC,2012-02-16,2484149,3072981,9242,18668,3072981,9537,2441560,0,168.421734419949,167103,9.79771008142644,1379647.43921429,604.788321167883,32552,8355190.43575377
1182,BTC,2012-02-17,2490001,3079591,6610,14224,3079591,6778,2448338,1,144.591980383455,167255,10.4229324404073,1379647.43921429,568.509933774835,18808,8362790.41725378
1182,BTC,2012-02-18,2495493,3085967,6376,14506,3085967,6516,2454854,3,108.275744415881,167426,11.7473765335685,1377710.76107708,503.705882352941,16335,8371340.41725377
1182,BTC,2012-02-19,2500157,3091965,5998,13254,3091965,5958,2460812,0,66.478969900193,167584,10.8619304210774,1376302.26788638,544.210191082802,16500,8379240.41725377
1182,BTC,2012-02-20,2505441,3098369,6404,14297,3098369,6339,2467151,0,68.8547153715239,167724,9.59471576168418,1376302.26788638,616.086330935252,19114,8386240.41725377
1182,BTC,2012-02-21,2511128,3104755,6386,14722,3104755,6420,2473571,0,61.3985967976355,167853,8.87959363264613,1376302.26788638,665.703125,22962,8392690.41725377
1182,BTC,2012-02-22,2517633,3111888,7133,16296,3111888,7194,2480765,0,109.453115577349,168012,10.8488351628809,1376302.26788638,544.867088607595,19583,8400640.41725377
1182,BTC,2012-02-23,2524848,3119822,7934,17566,3119822,8014,2488779,0,86.3529434113177,168178,11.4120654172084,1376302.26788638,517.975757575758,22571,8408940.41725377
1182,BTC,2012-02-24,2531382,3126879,7057,16526,3126879,6930,2495709,0,84.067680683733,168327,10.3045187047989,1376302.26788638,573.648648648648,22268,8416390.41725377
1182,BTC,2012-02-25,2537511,3132696,5817,15163,3132696,6306,2502015,0,66.9447819808642,168492,11.5333104481251,1376302.26788638,512.530487804878,18166,8424640.41725377
1182,BTC,2012-02-26,2542240,3138134,5438,13330,3138134,5821,2507836,0,59.6334625320478,168642,10.2351435890371,1376302.26788638,577.536912751678,18015,8432140.41075376
1182,BTC,2012-02-27,2547744,3144448,6314,14918,3144448,6735,2514571,0,55.9892016974209,168796,10.5497562545183,1376302.26788638,560.313725490196,19568,8439840.41075377
1182,BTC,2012-02-28,2553965,3151029,6581,16328,3151029,6725,2521296,0,56.3327335284372,168956,10.9810207097386,1376302.26788638,538.308176100629,19341,8447840.41075376
1182,BTC,2012-02-29,2559736,3157584,6555,15449,3157584,6719,2528015,0,50.3679041540066,169135,12.2740021573276,1376302.26788638,481.601123595506,17044,8456790.41075375
1182,BTC,2012-03-01,2566525,3164611,7027,16147,3164611,6811,2534826,8,97.7004553289913,169286,10.3245922740731,1376302.26788638,572.533333333333,22687,8464340.41075375
1182,BTC,2012-03-02,2574173,3172294,7683,17620,3172294,7645,2542471,0,74.1533326504879,169420,9.60743394862564,1445646.12751114,646.270676691729,28036,8471040.41075377
1182,BTC,2012-03-03,2578960,3177631,5337,12596,3177631,5187,2547658,0,74.5611608013842,169533,8.46281701899221,1496978.59502557,759.732142857143,20243,8476690.38925377
1182,BTC,2012-03-04,2584532,3184476,6845,14967,3184476,6591,2554249,0,104.015189192625,169670,10.2246080302709,1496978.59502557,628.823529411765,21531,8483540.38015377
1182,BTC,2012-03-05,2590932,3191703,7227,16149,3191703,6979,2561228,0,54.6086827657128,169815,10.9969506433745,1496978.59502557,584.659722222222,24393,8490790.38015377
1182,BTC,2012-03-06,2596628,3198200,6497,15307,3198200,6368,2567596,0,56.8552283891913,169952,10.207301450403,1496978.59502557,629.889705882353,23387,8497640.32815377
1182,BTC,2012-03-07,2602277,3205079,6879,15217,3205079,6635,2574231,0,57.5360360820166,170106,11.504701930792,1496978.59502557,558.856209150327,19233,8505340.32815376
1182,BTC,2012-03-08,2608045,3211844,6765,15709,3211844,6637,2580868,0,79.6094072532997,170262,11.5959610291859,1496978.59502557,554.458064516129,19947,8513140.32815376
1182,BTC,2012-03-09,2614125,3218315,6471,15802,3218315,6502,2587370,0,91.9811436465734,170430,12.5417251800054,1496978.59502557,512.646706586826,18711,8521540.32815377
1182,BTC,2012-03-10,2618542,3223408,5093,12891,3223408,5370,2592740,0,73.1574795205102,170595,12.2993287583871,1496978.59502557,522.75,18333,8529790.32815377
1182,BTC,2012-03-11,2623037,3228656,5248,12650,3228656,5223,2597963,0,82.5906960332242,170729,10.2447622042127,1496978.59502557,627.586466165414,19407,8536490.32815376
1182,BTC,2012-03-12,2628419,3234637,5981,14371,3234637,6141,2604104,0,98.7190969848966,170895,12.3868949125885,1496978.59502557,519.054545454546,17901,8544790.32815375
1182,BTC,2012-03-13,2635028,3242207,7570,16827,3242207,7395,2611499,0,72.282883888334,171055,11.9333969514516,1496978.59502557,538.779874213836,24804,8552790.32815378
1182,BTC,2012-03-14,2641375,3249092,6885,16190,3249092,6895,2618394,1,88.7043655440449,171192,10.440074965659,1496978.59502557,615.845588235294,26125,8559640.32815377
1182,BTC,2012-03-15,2646813,3255652,6560,15151,3255652,6284,2624678,0,78.4316066422518,171313,9.29517725668187,1496978.59502557,691.7,25083,8565690.32815377
1182,BTC,2012-03-16,2652750,3262513,6861,16252,3262513,6935,2631613,0,73.3139186472603,171466,11.5570986559075,1497898.77250028,556.66447368421,20211,8573340.32815376
1182,BTC,2012-03-17,2658958,3269890,7377,16091,3269890,6876,2638489,0,68.0889414059453,171636,12.6429762457735,1498294.36281651,508.988165680473,18140,8581840.32815377
1182,BTC,2012-03-18,2663624,3276051,6161,13890,3276051,6039,2644528,0,62.8331915334476,171796,12.2976000673591,1498294.36281651,523.283018867924,16375,8589840.32815377
1182,BTC,2012-03-19,2669763,3282629,6578,15523,3282629,6652,2651180,0,69.0001340900631,171939,10.9652341862013,1498294.36281651,586.866197183099,21142,8596990.32815377
1182,BTC,2012-03-20,2675452,3289504,6875,15984,3289504,6834,2658014,0,73.5959063749971,172099,11.9751986236793,1498294.36281651,537.37106918239,19019,8604990.32815377
1182,BTC,2012-03-21,2681459,3296623,7119,16222,3296623,7000,2665014,0,73.6205756697071,172257,11.7344731611449,1498294.36281651,548.394904458599,19624,8612890.32815377
1182,BTC,2012-03-22,2687074,3303061,6438,15718,3303061,6587,2671601,8,115.664417646513,172415,11.7935105726622,1498294.36281651,545.649681528662,19239,8620790.32815376
1182,BTC,2012-03-23,2692420,3309069,6008,14262,3309069,6156,2677757,10,146.065925252948,172541,9.43378635356887,1498294.36281651,682.136,21414,8627090.32815378
1182,BTC,2012-03-24,2697400,3315124,6055,13810,3315124,6375,2684132,4,128.849845958607,172726,13.7419241005214,1498294.36281651,468.284153005464,14808,8636290.32815378
1182,BTC,2012-03-25,2703099,3321154,6030,14492,3321154,6212,2690344,0,68.246919714926,172882,11.6682692501909,1498294.36281651,551.50641025641,18064,8644140.32815378
1182,BTC,2012-03-26,2709398,3327800,6646,15785,3327800,6619,2696963,3,80.8638966266672,173033,11.4303333792595,1498294.36281651,562.986666666666,21100,8651690.32815376
1182,BTC,2012-03-27,2715491,3334419,6619,15525,3334419,6666,2703629,0,86.2613883816652,173189,11.6261748586959,1498294.36281651,553.503225806451,19537,8659490.32815377
1182,BTC,2012-03-28,2721973,3341742,7323,16251,3341742,7239,2710868,1,95.4690930895814,173339,11.1793870432286,1498294.36281651,575.624161073826,22284,8666990.32815377
1182,BTC,2012-03-29,2728906,3349203,7461,17033,3349203,7518,2718386,0,160.400115129759,173480,11.1439763536369,1593806.47234704,614.264285714286,23847,8674040.32815377
1182,BTC,2012-03-30,2734863,3355808,6605,15041,3355808,6828,2725214,1,144.761915543207,173634,12.5949411192958,1626553.48132894,554.666666666666,20375,8681740.32815378
1182,BTC,2012-03-31,2740085,3361785,5977,14048,3361785,6192,2731406,14,142.716672051613,173804,13.8338135928474,1626553.48132894,504.994082840237,16175,8690240.32815376
1182,BTC,2012-04-01,2744746,3366925,5140,12765,3366925,5563,2736969,0,112.062659505143,173946,11.7728806972462,1626553.48132894,593.397163120568,18527,8697340.32815376
1182,BTC,2012-04-02,2750512,3373209,6284,14894,3373209,6472,2743441,0,108.626722417486,174062,9.43421340421594,1626553.48132894,740.495652173913,26457,8703140.32815376
1182,BTC,2012-04-03,2758531,3381326,8117,18804,3381326,7739,2751180,0,106.481413354883,174195,10.8841793233365,1626553.48132894,641.848484848485,27280,8709790.32815376
1182,BTC,2012-04-04,2765064,3388787,7461,16688,3388787,7143,2758323,1,107.470130932257,174332,11.214135299982,1626553.48132894,622.963235294117,23483,8716640.32815377
1182,BTC,2012-04-05,2771658,3396054,7267,16395,3396054,7028,2765351,0,134.233281989149,174449,9.65629161447916,1626553.48132894,723.465517241379,29920,8722490.32815377
1182,BTC,2012-04-06,2778295,3402783,6729,16329,3402783,6699,2772050,1,88.3656579805434,174585,11.089531318865,1626553.48132894,629.962962962963,25429,8729290.32815377
1182,BTC,2012-04-07,2783569,3408795,6012,14275,3408795,6080,2778130,0,57.1488128713026,174714,10.7589334154748,1626553.48132894,649.3203125,21153,8735740.32815378
1182,BTC,2012-04-08,2788722,3414879,6084,13928,3414879,5915,2784045,0,213.5520673868,174864,12.1905337711585,1626553.48132894,573.067114093959,17925,8743240.32815375
1182,BTC,2012-04-09,2794771,3421583,6704,15218,3421583,6617,2790662,5,248.172199635827,175010,12.0906784484298,1626553.48132894,577.8,20195,8750540.32815378
1182,BTC,2012-04-10,2801579,3429745,8162,17427,3429745,8468,2799130,2,98.0239212377574,175157,11.8813573894275,1626553.48132894,587.979452054794,25337,8757890.32815378
1182,BTC,2012-04-11,2809261,3438306,8561,18461,3438306,7858,2806988,14,193.262406067977,175298,11.5074261230514,1626553.48132894,607.085714285714,26322,8764940.32815376
1182,BTC,2012-04-12,2817101,3446965,8659,18833,3446965,8290,2815278,3,155.096977046683,175425,10.1937721473997,1613531.75020945,679.833333333333,29487,8771290.32815377
1182,BTC,2012-04-13,2823535,3454033,7068,15785,3454033,7041,2822319,3,118.950135874342,175548,10.0213879528467,1577913.48567673,676.262295081968,26308,8777440.32815379
1182,BTC,2012-04-14,2830467,3462147,8114,17362,3462147,8027,2830346,0,124.262917315582,175687,10.9921955376231,1577913.48567673,616.536231884058,25366,8784390.32815377
1182,BTC,2012-04-15,2836882,3469689,7542,16243,3469689,7371,2837717,0,173.39284108186,175794,8.41154529221789,1577913.48567673,805.688679245283,29618,8789740.32815377
1182,BTC,2012-04-16,2844912,3478227,8538,19112,3478227,8577,2846294,1,188.850650778763,175944,11.7742815666372,1577913.48567673,575.58389261745,27426,8797240.32815378
1182,BTC,2012-04-17,2852772,3486306,8079,18550,3486306,7805,2854099,0,145.997075753951,176079,10.5490978029465,1577913.48567673,642.432835820896,29034,8803990.32815377
1182,BTC,2012-04-18,2861140,3495268,8962,19375,3495268,8580,2862679,0,121.193481965517,176209,10.5116593848665,1577913.48567673,644.720930232558,32986,8810490.32815379
1182,BTC,2012-04-19,2868826,3503167,7899,17786,3503167,7900,2870579,0,87.8581865020456,176366,12.5207317017957,1577913.48567673,541.269230769231,23639,8818340.32815377
1182,BTC,2012-04-20,2877060,3511799,8632,19347,3511799,8285,2878864,1,345.731993991037,176520,12.0869871888832,1577913.48567673,560.692810457516,28227,8826040.32815377
1182,BTC,2012-04-21,2883900,3519168,7369,16317,3519168,7201,2886065,0,170.529642721464,176674,12.0807909004489,1577913.48567673,560.980392156863,22202,8833740.32815378
1182,BTC,2012-04-22,2889592,3525662,6494,14700,3525662,6354,2892419,0,150.242093070031,176814,11.2758108704374,1577913.48567673,601.028776978417,21182,8840740.32815377
1182,BTC,2012-04-23,2896249,3533079,7417,16739,3533079,7104,2899523,0,110.439273618577,176949,10.6968400940487,1577913.48567673,633.559701492537,24876,8847490.32815377
1182,BTC,2012-04-24,2903395,3541065,7986,17336,3541065,7660,2907183,0,97.8712064378603,177087,10.8624949565382,1577913.48567673,623.897810218978,25038,8854390.32815377
1182,BTC,2012-04-25,2910351,3548944,7879,17455,3548944,7557,2914740,1,134.775071241837,177214,9.99921472316989,1577913.48567673,677.761904761904,27349,8860740.32815378
1182,BTC,2012-04-26,2918110,3558457,9513,19175,3558457,10099,2924839,0,183.961428674571,177369,12.1319047485375,1577913.48567673,558.616883116883,27404,8868490.32815379
1182,BTC,2012-04-27,2924983,3565858,7401,17204,3565858,7195,2932034,0,204.030149621477,177504,10.2540889502619,1528103.04181899,640.05223880597,25039,8875240.32815377
1182,BTC,2012-04-28,2931194,3572898,7040,15974,3572898,7427,2939461,0,119.731708174823,177656,11.5454065161541,1508589.67206029,561.205298013245,21932,8882840.32815376
1182,BTC,2012-04-29,2937296,3579787,6889,15994,3579787,7729,2947190,0,127.964237018762,177835,13.3903369079153,1508589.67206029,483.88202247191,18960,8891790.32815376
1182,BTC,2012-04-30,2945767,3589073,9286,19105,3589073,9413,2956603,0,117.35780956267,178014,13.4784394658711,1508589.67206029,480.719101123596,23396,8900740.32815376
1182,BTC,2012-05-01,2953901,3598001,8928,20034,3598001,10208,2966811,0,106.862292683083,178184,12.7205341241423,1508589.67206029,509.360946745562,28175,8909240.32815377
1182,BTC,2012-05-02,2962339,3607433,9432,20206,3607433,9978,2976789,0,108.633049170026,178334,11.4209243044891,1508589.67206029,567.322147651007,31534,8916740.32815376
1182,BTC,2012-05-03,2971522,3618317,10884,21866,3618317,14002,2990791,0,86.9088749014841,178491,11.8435690325605,1508589.67206029,547.076923076923,38952,8924590.32815376
1182,BTC,2012-05-04,2981315,3628952,10635,22682,3628952,14098,3004889,1,79.9173105436324,178652,12.0908647889386,1508589.67206029,535.8875,39096,8932640.32815378
1182,BTC,2012-05-05,2990032,3638863,9911,20023,3638863,12998,3017887,0,92.6758602725858,178819,12.6476756924386,1508589.67206029,512.295180722891,34146,8940990.32815379
1182,BTC,2012-05-06,3001438,3647700,8837,22204,3647700,11150,3029037,0,59.0959398743928,178983,12.2967731862438,1508589.67206029,526.914110429448,34706,8949190.32815377
1182,BTC,2012-05-07,3014332,3660943,13243,25662,3660943,18247,3047284,0,120.191358811759,179153,12.9238152496744,1508589.67206029,501.349112426035,47653,8957690.32815379
1182,BTC,2012-05-08,3025732,3673467,12524,23790,3673467,17719,3065003,1,220.038931076849,179329,13.2978969637133,1508589.67206029,487.245714285714,44218,8966490.32815377
1182,BTC,2012-05-09,3038285,3686627,13160,24831,3686627,17245,3082248,0,136.646538917121,179495,13.2270355652648,1606014.27813706,521.490909090909,47815,8974790.32815379
1182,BTC,2012-05-10,3047530,3696401,9774,20419,3696401,11782,3094030,0,101.907448216277,179624,11.4798726209626,1733207.51384839,648.4453125,41772,8981240.32815377
1182,BTC,2012-05-11,3061301,3710657,14256,26141,3710657,19061,3113091,0,80.7799558887267,179767,12.2900845453471,1733207.51384839,605.697183098591,59616,8988390.32815376
1182,BTC,2012-05-12,3073272,3723427,12770,22750,3723427,18326,3131417,1,174.755259136251,179895,11.112249348512,1733207.51384839,669.897637795276,61847,8994790.32815377
1182,BTC,2012-05-13,3082435,3733847,10420,20705,3733847,14737,3146154,0,102.43730735961,180035,12.1112620459212,1733207.51384839,614.640287769784,45954,9001790.32815375
1182,BTC,2012-05-14,3102075,3754483,20636,32417,3754483,28349,3174503,1,81.3758892289855,180174,11.8965802747405,1733207.51384839,625.731884057971,89571,9008740.32815376
1182,BTC,2012-05-15,3116988,3769965,15482,27164,3769965,22235,3196738,0,168.313601820397,180304,11.3453878971382,1733207.51384839,656.131782945737,77342,9015240.32815376
1182,BTC,2012-05-16,3131042,3783216,13251,25543,3783216,18078,3214816,0,190.161690256985,180425,10.4270847519462,1733207.51384839,713.916666666667,70706,9021290.32765377
1182,BTC,2012-05-17,3142391,3795490,12274,22573,3795490,16935,3231751,2,204.081262554164,180541,10.3542417904815,1733207.51384839,718.939130434782,67950,9027090.32515378
1182,BTC,2012-05-18,3157414,3811524,16034,26162,3811524,24481,3256232,3,76.6392878562689,180686,12.7708402830585,1733207.51384839,582.895833333333,75677,9034340.31365376
1182,BTC,2012-05-19,3177451,3832468,20944,31606,3832468,35404,3291636,1,34.8158407845981,180835,12.9551898401444,1733207.51384839,574.601351351351,104611,9041790.31215378
1182,BTC,2012-05-20,3195451,3851581,19113,29546,3851581,31460,3323096,1,64.1773284496672,180973,12.0872498751373,1733207.51384839,615.861313868613,99350,9048690.31062876
1182,BTC,2012-05-21,3213225,3871011,19430,30359,3871011,31604,3354700,0,120.828619699784,181099,10.8900205819469,1733207.51384839,683.568,110299,9054990.30962877
1182,BTC,2012-05-22,3227631,3887088,16077,27519,3887088,23480,3378180,0,173.013822747321,181214,9.95266499148866,1733207.51384839,747.947368421052,90723,9060740.30862876
1182,BTC,2012-05-23,3244201,3904844,17756,29621,3904844,27432,3405612,0,65.8540901325824,181344,11.2126499188687,1733207.51384839,663.899224806202,93874,9067240.30862877
1182,BTC,2012-05-24,3259648,3922032,17188,28071,3922032,26589,3432201,0,42.447954348188,181469,10.5465908892615,1699095.70136813,691.935483870968,94541,9073490.30812877
1182,BTC,2012-05-25,3276892,3940354,18322,30115,3940354,28999,3461200,0,84.0741872958909,181590,9.63114008261574,1591074.96184731,709.533333333334,104401,9079540.30762878
1182,BTC,2012-05-26,3290798,3955274,14920,25653,3955274,23279,3484479,0,207.566302362699,181732,11.2270569037813,1591074.96184731,608.673758865249,71027,9086640.30511877
1182,BTC,2012-05-27,3305031,3971469,16195,26297,3971469,26447,3510926,0,76.463781460898,181891,12.5394710923378,1591074.96184731,544.968354430379,72797,9094590.29911877
1182,BTC,2012-05-28,3321106,3989259,17790,29597,3989259,29888,3540814,0,71.5028168792904,182033,11.3264335800309,1591074.96184731,603.333333333333,93353,9101690.29711876
1182,BTC,2012-05-29,3341542,4009363,20104,34270,4009363,29816,3570630,0,106.284726766381,182159,10.0137376859821,1591074.96184731,682.424,105559,9107990.29561877
1182,BTC,2012-05-30,3357076,4026051,16688,28551,4026051,25580,3596210,0,93.4702998653729,182290,10.3261608078532,1591074.96184731,661.776923076923,88137,9114540.29511877
1182,BTC,2012-05-31,3371836,4042509,16458,28417,4042509,21013,3617223,6,228.016971837087,182428,11.1405260239273,1591074.96184731,613.401459854014,68906,9121440.29451877
1182,BTC,2012-06-01,3387446,4059581,17072,29065,4059581,27069,3644292,2,109.704782791109,182580,11.9719675362789,1591074.96184731,570.801324503311,79549,9129040.29351878
1182,BTC,2012-06-02,3396970,4069736,10155,20571,4069736,12800,3657092,0,155.562035181434,182740,12.8078927473933,1591074.96184731,533.547169811321,36229,9137040.29101877
1182,BTC,2012-06-03,3413614,4089407,19671,30396,4089407,33601,3690693,0,51.5309771714937,182893,12.35764471466,1591074.96184731,552.986842105263,95961,9144690.28751878
1182,BTC,2012-06-04,3441446,4116643,27236,41579,4116643,45938,3736631,1,101.121362492517,183048,12.2928278416903,1591074.96184731,555.902597402598,130250,9152440.28551877
1182,BTC,2012-06-05,3465604,4143763,27120,40970,4143763,44364,3780995,0,102.217010076654,183195,11.6411852200726,1591074.96184731,587.020547945206,128158,9159790.28401878
1182,BTC,2012-06-06,3476663,4156308,12545,24165,4156308,15937,3796932,0,157.467172657196,183348,12.1087112546459,1591074.96184731,564.355263157895,47840,9167440.28301877
1182,BTC,2012-06-07,3497976,4176642,20334,35387,4176642,33203,3830135,0,145.80440545949,183487,11.0277965412013,1589256.92112137,618.963768115943,104517,9174390.28251877
1182,BTC,2012-06-08,3511789,4191632,14990,28272,4191632,23897,3854032,0,228.599385959822,183628,11.1547508348076,1583177.84744401,609.578571428572,78387,9181440.28101876
1182,BTC,2012-06-09,3529012,4210039,18407,31541,4210039,33050,3887082,1,42.1870606515495,183799,13.435949779727,1583177.84744401,506.082352941176,84980,9189990.27951876
1182,BTC,2012-06-10,3547526,4231870,21831,33834,4231870,40721,3927803,0,80.8559754940846,183965,13.0532159572367,1583177.84744401,520.921212121213,102712,9198290.27651876
1182,BTC,2012-06-11,3564463,4251338,19468,32609,4251338,32531,3960334,1,93.5727138452633,184105,11.0162114516218,1583177.84744401,617.244604316547,100672,9205290.27591876
1182,BTC,2012-06-12,3575663,4263053,11715,23493,4263053,18243,3978577,2,141.95230638813,184261,12.3691795039336,1583177.84744401,549.729032258064,58884,9213090.27541877
1182,BTC,2012-06-13,3602525,4295261,32208,46734,4295261,56794,4035371,1,42.8181295406853,184411,11.8852116217964,1583177.84744401,572.114093959731,161133,9220590.27091876
1182,BTC,2012-06-14,3631305,4325960,30699,49648,4325960,61938,4097309,0,78.1111045418743,184567,12.5875199709922,1583177.84744401,540.193548387097,179401,9228390.25991877
1182,BTC,2012-06-15,3662631,4356487,30527,49092,4356487,54986,4152295,1,63.0837397606927,184726,12.5277191446482,1583177.84744401,542.772151898734,154256,9236340.25691876
1182,BTC,2012-06-16,3685833,4382020,25533,39353,4382020,43282,4195577,0,90.1148097615893,184882,12.3762966588519,1583177.84744401,549.412903225806,125339,9244140.25491876
1182,BTC,2012-06-17,3709229,4407835,25815,39362,4407835,43909,4239486,1,32.2344836379054,185046,12.9452991637198,1583177.84744401,525.263803680982,114087,9252340.25091879
1182,BTC,2012-06-18,3731417,4432429,24594,37610,4432429,39071,4278557,0,64.4434704665268,185221,13.7995671891474,1583177.84744401,492.747126436782,99843,9261090.24641877
1182,BTC,2012-06-19,3752457,4454135,21706,35548,4454135,35962,4314519,0,58.9345079152302,185368,11.7284632697083,1583177.84744401,579.760273972603,112881,9268440.24241877
1182,BTC,2012-06-20,3769692,4472397,18262,32271,4472397,32246,4346765,0,53.2070749067748,185513,12.229136500557,1624711.12946799,570.611111111111,105262,9275690.24141876
1182,BTC,2012-06-21,3785041,4489241,16844,29713,4489241,26782,4373547,0,39.0704991593384,185649,11.68893493285,1726566.55919348,634.407407407407,92688,9282490.23991876
1182,BTC,2012-06-22,3799451,4505445,16204,29231,4505445,23565,4397112,0,96.5716742691292,185787,11.9236403194271,1726566.55919348,621.919708029197,80673,9289390.23691878
1182,BTC,2012-06-23,3814904,4521332,15887,30261,4521332,22303,4419415,0,135.581438307691,185951,14.0612613212213,1726566.55919348,527.374233128835,64220,9297590.23391878
1182,BTC,2012-06-24,3829203,4537294,15962,28503,4537294,22392,4441807,5,84.8104862200759,186082,11.2929315034665,1726566.55919348,656.653846153846,78320,9304140.23141875
1182,BTC,2012-06-25,3847923,4557469,20175,33979,4557469,28713,4470520,1,63.3484185883676,186236,13.5162216367706,1726566.55919348,548.640522875817,83111,9311840.22831876
1182,BTC,2012-06-26,3867824,4579509,22040,36002,4579509,30235,4500755,0,57.0627289777324,186385,13.0723348194683,1726566.55919348,567.270270270271,88551,9319290.22631877
1182,BTC,2012-06-27,3891220,4603153,23644,39105,4603153,30875,4531630,0,64.400495839521,186548,14.025248077016,1726566.55919348,528.728395061728,82810,9327440.21981877
1182,BTC,2012-06-28,3909418,4622784,19631,32731,4622784,26522,4558152,0,131.019967004909,186685,11.7976975718268,1726566.55919348,628.558823529412,85466,9334290.21731876
1182,BTC,2012-06-29,3927067,4642327,19543,33119,4642327,22877,4581029,0,110.37857878099,186831,12.7525208603837,1726566.55919348,581.496551724138,65639,9341590.21281877
1182,BTC,2012-06-30,3943699,4661508,19181,31932,4661508,22618,4603647,0,61.7016399668755,186963,11.3205221262705,1726566.55919348,655.053435114504,72143,9348190.20931877
1182,BTC,2012-07-01,3960132,4680654,19146,31705,4680654,19276,4622923,0,69.8613636598049,187105,12.3319861978907,1726566.55919348,601.326241134751,56680,9355290.20881877
1182,BTC,2012-07-02,3979658,4702529,21875,36591,4702529,25147,4648070,1,47.374881522553,187257,13.0840675245859,1726566.55919348,566.761589403974,68607,9362890.20431877
1182,BTC,2012-07-03,3997710,4722083,19554,34704,4722083,22667,4670737,0,63.5430953393533,187417,13.7453014463793,1726566.55919348,539.496855345912,60458,9370890.20181876
1182,BTC,2012-07-04,4015177,4739623,17540,31637,4739623,23164,4693901,0,98.4081708524309,187567,12.9624649033749,1739840.14647199,576.476510067114,67597,9378390.19181877
1182,BTC,2012-07-05,4029579,4754959,15336,27931,4754959,21643,4715544,0,93.1878519028744,187711,12.5705110525373,1751454.53534068,598.419580419581,67813,9385590.18981877
1182,BTC,2012-07-06,4044041,4771534,16575,29352,4771534,23916,4739460,0,57.7629297911465,187866,13.6004103437125,1751454.53534068,553.103896103896,68159,9393340.18581876
1182,BTC,2012-07-07,4061094,4791196,19662,30943,4791196,25615,4765075,0,161.139847687487,188032,14.7187481228495,1751454.53534068,511.078787878788,64042,9401640.18231878
1182,BTC,2012-07-08,4075274,4807169,15973,27915,4807169,20799,4785874,0,39.7487905589096,188185,13.3630675200994,1751454.53534068,562.927631578947,59263,9409290.18081878
1182,BTC,2012-07-09,4092806,4825809,18640,32286,4825809,25129,4811003,0,84.870198569799,188348,14.1825460791911,1751454.53534068,530.401234567901,67203,9417440.17331877
1182,BTC,2012-07-10,4113455,4849359,23550,37035,4849359,35080,4846083,1,61.8837052742745,188498,13.1440245855495,1751454.53534068,572.308724832215,101745,9424940.16981878
1182,BTC,2012-07-11,4132890,4870492,21133,35356,4870492,31250,4877333,0,36.961250846697,188632,11.7549172068879,1751454.53534068,639.93984962406,103233,9431640.16731878
1182,BTC,2012-07-12,4152039,4891017,20525,34233,4891017,24303,4901636,5,57.3273068711694,188782,13.1871704512988,1751454.53534068,570.436241610738,71337,9439140.16581878
1182,BTC,2012-07-13,4168845,4908324,17307,31366,4908324,24556,4926192,6,100.964851073274,188945,14.2209430391572,1751454.53534068,528.969135802469,70798,9447290.16521877
1182,BTC,2012-07-14,4184738,4925893,17569,29903,4925893,22787,4948979,2,108.570167155378,189106,14.4827674863733,1751454.53534068,519.40625,61524,9455340.15307876
1182,BTC,2012-07-15,4201829,4944145,18252,30386,4944145,26345,4975324,1,51.7441551801689,189246,12.3680437298734,1751454.53534068,608.21582733813,81751,9462340.15107878
1182,BTC,2012-07-16,4224339,4967300,23155,36803,4967300,31379,5006703,1,67.2623337048772,189396,13.1097413068078,1751454.53534068,573.805369127517,94391,9469840.14697876
1182,BTC,2012-07-17,4247938,4992676,25376,40268,4992676,35201,5041904,19,71.9523657019724,189568,15.3768025532942,1794889.94248059,501.33918128655,91361,9478440.14447877
1182,BTC,2012-07-18,4267421,5013089,20413,34288,5013089,32588,5074492,0,49.0872504620535,189723,14.3769615203545,1866391.30500321,557.564935064935,97539,9486190.13847877
1182,BTC,2012-07-19,4289547,5033411,20322,36313,5033411,31035,5105527,1,39.5724898066531,189858,12.6301457854444,1866391.30500321,634.679104477612,107300,9492940.13397878
1182,BTC,2012-07-20,4310514,5056319,22908,36122,5056319,36794,5142321,0,44.7714892608431,190006,13.7495644632511,1866391.30500321,583.006802721089,111198,9500340.13095377
1182,BTC,2012-07-21,4331006,5079267,22948,35582,5079267,34593,5176914,0,68.8220142643607,190147,13.0326270315506,1866391.30500321,615.078571428571,105447,9507390.12495378
1182,BTC,2012-07-22,4352833,5104736,25469,38962,5104736,34860,5211774,0,49.2294030167639,190302,14.6450808601573,1866391.30500321,547.357142857142,91804,9515140.12195378
1182,BTC,2012-07-23,4376601,5130290,25554,42042,5130290,32698,5244472,0,66.365956395248,190443,13.1426694731685,1866391.30500321,609.928571428571,97733,9522190.11945376
1182,BTC,2012-07-24,4398114,5151001,20711,38417,5151001,28369,5272841,0,61.6954400188974,190604,15.0066615026198,1866391.30500321,534.16875,76612,9530240.11745377
1182,BTC,2012-07-25,4414494,5169094,18093,31562,5169094,27327,5300168,0,37.5030162868533,190764,14.9078114651899,1866391.30500321,537.7106918239,71684,9538240.11495377
1182,BTC,2012-07-26,4430204,5186955,17861,30845,5186955,30707,5330875,1,75.5044791816824,190933,16.061817109865,1866391.30500321,499.077380952381,79078,9546690.11045379
1182,BTC,2012-07-27,4446603,5205321,18366,32297,5205321,27155,5358030,0,80.3073773514881,191111,16.8519254364912,1866391.30500321,475.677966101695,62916,9555590.10745378
1182,BTC,2012-07-28,4465262,5229385,24064,38628,5229385,35230,5393260,0,49.4516669658342,191264,14.2839045006235,1866391.30500321,561.197368421053,94184,9563240.1029538
1182,BTC,2012-07-29,4485513,5249923,20538,35981,5249923,34483,5427743,1,32.1843424448531,191430,15.5241172151061,1866391.30500321,516.363636363637,88410,9571540.10045377
1182,BTC,2012-07-30,4507258,5271470,21547,36194,5271470,34395,5462138,1,28.4751262027542,191606,17.0454746669131,1950563.6980773,491.485714285714,89554,9580340.09742876
1182,BTC,2012-07-31,4539272,5306487,35017,58777,5306487,41507,5503645,2,71.659206967107,191736,13.157566377946,2036671.08869332,664.821705426356,137382,9586840.09642877
1182,BTC,2012-08-01,4561851,5330178,23691,40727,5330178,30538,5534183,0,74.4251478317106,191870,13.6510290475798,2036671.08869332,640.789473684211,98965,9593540.09592878
1182,BTC,2012-08-02,4585304,5354936,24758,42130,5354936,33211,5567394,5,53.9716666786655,192035,16.7853819981985,2036671.08869332,521.134146341463,87116,9601790.09492878
1182,BTC,2012-08-03,4604661,5376130,21194,36366,5376130,27780,5595174,0,51.5205249549932,192197,16.4584972443536,2036671.08869332,531.484472049689,73008,9609890.09092877
1182,BTC,2012-08-04,4623107,5396372,20242,35884,5396372,29010,5624184,3,48.7209366325629,192353,15.8355139088566,2036671.08869332,552.393548387097,81569,9617690.08892877
1182,BTC,2012-08-05,4643204,5419005,22633,37840,5419005,33283,5657467,1,59.3616990081447,192492,14.1029981794874,2036671.08869332,620.253623188406,98393,9624640.08842877
1182,BTC,2012-08-06,4666020,5445422,26417,42354,5445422,35400,5692867,0,56.365022632826,192632,14.3051350623183,2036671.08869332,611.489208633094,102267,9631640.08392876
1182,BTC,2012-08-07,4686275,5469304,23882,39177,5469304,29603,5722470,2,66.3079517572412,192796,16.6423346616794,2036671.08869332,525.613496932515,71238,9639840.08192877
1182,BTC,2012-08-08,4715703,5499952,30648,51964,5499952,40168,5762638,2,41.4232423900159,192962,16.8427998877013,2036671.08869332,519.357575757576,99368,9648140.07862877
1182,BTC,2012-08-09,4737749,5522052,22100,40383,5522052,29942,5792580,3,48.5338590441113,193132,17.3324184736114,2036671.08869332,504.686390532544,77006,9656640.07561877
1182,BTC,2012-08-10,4756899,5544264,22212,38611,5544264,28375,5820955,0,59.2418074461325,193288,15.898833681874,2036671.08869332,550.193548387097,73791,9664440.07111868
1182,BTC,2012-08-11,4776490,5566719,22455,38410,5566719,33139,5854094,1,47.5464335300531,193456,16.940010030892,2036671.08869332,516.377245508982,78008,9672840.06611867
1182,BTC,2012-08-12,4795569,5590601,23882,39069,5590601,34636,5888730,0,46.6841502847736,193615,16.7340337750363,2114253.41896227,542.645569620254,88476,9680790.06161867
1182,BTC,2012-08-13,4819070,5621222,30621,48599,5621222,48872,5937602,2,38.503518884512,193775,17.634864839112,2190865.97010286,533.584905660377,127556,9688790.06111866
1182,BTC,2012-08-14,4840862,5646173,24951,42877,5646173,34506,5972108,0,44.0199725594569,193932,17.3781249911296,2190865.97010286,541.467948717949,94921,9696640.06111868
1182,BTC,2012-08-15,4869537,5674901,28728,50408,5674901,52969,6025077,0,33.7874220053935,194099,18.2147958345384,2190865.97010286,516.596385542169,144116,9704990.05611869
1182,BTC,2012-08-16,4905772,5713647,38746,61707,5713647,46477,6071554,104,44.6610505110041,194253,16.9604022713224,2190865.97010286,554.803921568627,127898,9712690.05511868
1182,BTC,2012-08-17,4938343,5748841,35194,56766,5748841,40554,6112108,5,68.5728452675018,194391,14.9985873616872,2190865.97010286,627.372262773723,126099,9719590.05411868
1182,BTC,2012-08-18,4967218,5781476,32635,51610,5781476,37162,6149270,0,57.9822234991739,194542,16.7243871523984,2190865.97010286,562.633333333334,100679,9727140.05411866
1182,BTC,2012-08-19,5005240,5808571,27095,58130,5808571,36951,6186221,207,160.514417400897,194724,19.9535508009221,2190865.97010286,471.580110497238,100175,9736240.05061867
1182,BTC,2012-08-20,5032713,5833759,25188,47414,5833759,35837,6222058,397,267.737382855046,194898,19.1855849878186,2190865.97010286,490.456647398844,91681,9744940.04911866
1182,BTC,2012-08-21,5063413,5865911,32152,54397,5865911,42415,6264473,201,129.237268145977,195071,18.8369180975315,2190865.97010286,499.53488372093,99018,9753590.04761869
1182,BTC,2012-08-22,5091216,5895484,29573,49524,5895484,37874,6302347,284,204.787045380611,195227,16.9703893486947,2190865.97010286,554.477419354839,100371,9761390.04706868
1182,BTC,2012-08-23,5113756,5922094,26610,43751,5922094,31818,6334165,166,240.078437223109,195392,17.9683109939898,2190865.97010286,523.682926829268,77100,9769640.04456866
1182,BTC,2012-08-24,5137634,5948359,26265,45033,5948359,32275,6366440,535,342.807312818848,195540,16.0573181878055,2190865.97010286,586.006802721088,87632,9777040.04456866
1182,BTC,2012-08-25,5157260,5970422,22063,36612,5970422,33439,6399879,168,131.598954911688,195678,16.5840176119532,2420732.87499608,626.92700729927,98860,9783940.04406867
1182,BTC,2012-08-26,5175361,5989980,19558,34704,5989980,29520,6429399,160,112.859017828326,195857,21.8374780168441,2440642.60691596,480.022471910112,68306,9792890.04206869
1182,BTC,2012-08-27,5194684,6012001,22021,38448,6012001,33096,6462495,161,190.871483726348,196002,17.8831052225105,2440642.60691596,586.166666666666,95150,9800140.03951868
1182,BTC,2012-08-28,5212347,6033146,21145,39917,6033146,29838,6492333,168,227.780756506265,196153,18.8141291153856,2440642.60691596,557.16,83606,9807690.03801867
1182,BTC,2012-08-29,5232547,6056698,23552,39372,6056698,34209,6526542,532,429.779408669212,196321,20.4649776679216,2440642.60691596,512.215568862275,81827,9816090.03501868
1182,BTC,2012-08-30,5250669,6077096,20398,34110,6077096,33914,6560456,515,341.602607505758,196475,18.7585612204148,2440642.60691596,558.81045751634,91516,9823790.02851866
1182,BTC,2012-08-31,5278450,6106973,29877,49422,6106973,40624,6601080,232,221.1230920539,196615,16.9743909497085,2440642.60691596,617.546762589928,118403,9830790.02751867
1182,BTC,2012-09-01,5301837,6134727,27754,44982,6134727,40774,6641854,362,214.521394458013,196776,19.5984578801622,2440642.60691596,534.8625,104102,9838840.02501866
1182,BTC,2012-09-02,5320064,6155129,20402,34929,6155129,33588,6675442,302,177.686155408986,196940,19.8896965171502,2440642.60691596,527.030674846626,86587,9847040.01801866
1182,BTC,2012-09-03,5338212,6175028,19899,32994,6175028,38238,6713680,70,97.1290850960398,197097,19.1458583526338,2440642.60691596,547.50641025641,103753,9854890.01491868
1182,BTC,2012-09-04,5364714,6199072,24044,46041,6199072,39946,6753626,232,162.339041879157,197250,18.7751813141626,2440642.60691596,558.315789473684,116097,9862540.01341867
1182,BTC,2012-09-05,5387201,6224771,25699,41546,6224771,41135,6794761,342,225.54471354196,197430,21.9396187251433,2440642.60691596,477.787709497207,99223,9871540.00991866
1182,BTC,2012-09-06,5413716,6252865,28094,46844,6252865,42790,6837551,475,511.276402662816,197601,21.2415734956991,2491027.29560209,503.676470588236,104186,9880090.00741867
1182,BTC,2012-09-07,5437955,6277056,24191,44106,6277056,33483,6871034,576,549.885765315252,197769,22.479166031691,2694047.95295501,514.736526946108,83443,9888490.00531868
1182,BTC,2012-09-08,5455455,6296502,19446,33700,6296502,31173,6902207,404,243.29651373128,197914,19.5832550645704,2694047.95295501,590.854166666667,92160,9895740.00071867
1182,BTC,2012-09-09,5476419,6320478,23976,40194,6320478,31464,6933671,22,123.933140573555,198073,21.3828856883671,2694047.95295501,541.126582278481,81183,9903689.99611865
1182,BTC,2012-09-10,5495612,6341975,21497,37360,6341975,33632,6967303,377,561.544648914389,198223,20.0885115868454,2694047.95295501,575.993288590604,95204,9911189.99411183
1182,BTC,2012-09-11,5519081,6368531,26556,45243,6368531,38225,7005528,613,529.198272768078,198368,19.3526149652002,2694047.95295501,597.895833333333,111399,9918439.99261184
1182,BTC,2012-09-12,5534093,6387485,18954,34218,6387485,28096,7033624,293,386.08498269797,198523,20.7618969680146,2694047.95295501,557.311688311688,78132,9926189.99061185
1182,BTC,2012-09-13,5551535,6406124,18639,35078,6406124,29025,7062649,568,777.072866938632,198653,17.4763710250896,2694047.95295501,662.085271317829,100090,9932689.99011184
1182,BTC,2012-09-14,5571256,6427477,21353,38280,6427477,36118,7098767,948,499.236317043075,198815,21.6806110461379,2694047.95295501,533.695652173913,99917,9940789.99011184
1182,BTC,2012-09-15,5585689,6444318,16841,30026,6444318,27248,7126015,329,254.098924797525,198959,19.2973414210562,2694047.95295501,599.608391608391,81385,9947989.99011185
1182,BTC,2012-09-16,5600266,6461073,16755,31574,6461073,28415,7154430,387,492.992102058359,199120,21.6386228629756,2694047.95295501,534.73125,81232,9956039.98711185
1182,BTC,2012-09-17,5615721,6477943,16870,33062,6477943,24446,7178876,518,534.279684442361,199288,22.7207496002233,2694047.95295501,509.263473053892,64597,9964439.98611184
1182,BTC,2012-09-18,5634016,6500213,22270,38786,6500213,32821,7211697,330,395.614494733185,199455,22.3901422539621,2694047.95295501,516.783132530121,85415,9972789.98461183
1182,BTC,2012-09-19,5653377,6524925,24712,42887,6524925,32231,7243928,640,971.917296164569,199596,18.9633313136989,2709730.2452467,613.721428571429,99648,9979839.98411185
1182,BTC,2012-09-20,5675344,6552804,27879,47275,6552804,31282,7275210,573,508.548263746966,199748,21.7344128714048,2864140.50781097,565.986754966887,85107,9987439.98411185
1182,BTC,2012-09-21,5692530,6571762,18958,39201,6571762,30347,7305557,714,853.543490080774,199917,24.0188918022488,2864140.50781097,512.154761904762,81455,9995889.98411183
1182,BTC,2012-09-22,5704636,6585135,13373,27316,6585135,22014,7327571,660,675.663311657989,200074,22.4139693133691,2864140.50781097,548.826923076923,72497,10003739.9826118
1182,BTC,2012-09-23,5716879,6599700,14565,28639,6599700,27999,7355570,480,279.174908334763,200232,22.6279504694136,2864140.50781097,543.636942675159,80852,10011639.9826119
1182,BTC,2012-09-24,5732890,6617475,17775,33440,6617475,29190,7384760,403,278.07635584601,200385,21.7546393421052,2864140.50781097,565.460526315789,85708,10019289.9826119
1182,BTC,2012-09-25,5752216,6642403,24928,43272,6642403,24177,7408937,3,73.5169395235269,200524,20.4332185132785,2864140.50781097,602.028985507247,70968,10026239.9826118
1182,BTC,2012-09-26,5777090,6669333,26930,48271,6669333,32413,7441350,1,53.612691035786,200664,20.0015579250348,2864140.50781097,615.021582733813,103247,10033239.9826118
1182,BTC,2012-09-27,5795393,6691494,22161,42088,6691494,28347,7469697,8,48.65075307288,200825,22.8493756597072,2864140.50781097,538.36875,77714,10041289.9826118
1182,BTC,2012-09-28,5817680,6717729,26235,50031,6717729,32768,7502465,23,79.2917341146204,200983,22.5681923941588,2864140.50781097,545.076433121019,93320,10049189.9826118
1182,BTC,2012-09-29,5834717,6735985,18256,38450,6735985,23992,7526457,58,54.2937795303055,201151,24.0008890650851,2864140.50781097,512.538922155689,67540,10057589.9826118
1182,BTC,2012-09-30,5849600,6752220,16235,34674,6752220,20668,7547125,65,69.6743577948519,201310,22.9024873661359,2864140.50781097,537.120253164557,63587,10065539.9826118
1182,BTC,2012-10-01,5864239,6770428,18208,37977,6770428,24727,7571852,2,65.7207197235043,201441,18.9140233658853,2864140.50781097,650.384615384615,95109,10072089.9826118
1182,BTC,2012-10-02,5891455,6799333,28905,53176,6799333,32878,7604730,0,61.0358172968417,201587,20.9654848817386,2864140.50781097,586.744827586207,104430,10079389.9826118
1182,BTC,2012-10-03,5916613,6823563,24230,50099,6823563,26669,7631399,0,47.2322034808103,201720,20.3576532888375,3037440.72822945,640.825757575757,101981,10086039.9826118
1182,BTC,2012-10-04,5942758,6851205,27642,51020,6851205,32615,7664014,2,36.6629633862996,201852,19.8574706058022,3054627.52694864,660.684615384615,119686,10092589.9826118
1182,BTC,2012-10-05,5964963,6877139,25934,45099,6877139,36371,7700385,152,72.4619567308608,201987,20.6782786100765,3054627.52694864,634.459259259259,117130,10099389.9826118
1182,BTC,2012-10-06,5983864,6900531,23392,38962,6900531,32672,7733057,154,60.5346001858873,202142,23.5731425394909,3054627.52694864,556.545454545455,99661,10107139.9826118
1182,BTC,2012-10-07,6005857,6925110,24579,43402,6925110,34726,7767783,71,51.4627761940425,202267,18.9077306006917,3054627.52694864,693.870967741936,130167,10113389.9826118
1182,BTC,2012-10-08,6028817,6953286,28176,47643,6953286,38211,7805994,6,46.4927750630332,202445,27.3284844814518,3054627.52694864,480.067796610169,97029,10122289.9816118
1182,BTC,2012-10-09,6055267,6981765,28479,52280,6981765,35450,7841444,6,38.482763879121,202587,21.4824418939555,3054627.52694864,610.709219858156,115115,10129389.9801118
1182,BTC,2012-10-10,6078304,7007834,26069,47362,7007834,31226,7872670,1,28.1544047813521,202736,22.9481604121927,3054627.52694864,571.702702702703,95408,10136839.9801118
1182,BTC,2012-10-11,6096360,7030278,22444,41234,7030278,27684,7900354,50,45.0188556180758,202874,21.144592844686,3054627.52694864,620.467153284671,91263,10143739.9796119
1182,BTC,2012-10-12,6114822,7055519,25241,44614,7055519,28693,7929047,183,91.061012661133,203023,22.5835649677412,3054627.52694864,580.932432432432,89739,10151189.9791119
1182,BTC,2012-10-13,6134995,7076625,21106,39436,7076625,33090,7962137,133,81.9421891559755,203171,22.6182795424524,3054627.52694864,580.040816326531,102925,10158589.9786118
1182,BTC,2012-10-14,6150963,7098409,21784,38589,7098409,27414,7989551,0,50.5817345231418,203298,19.7363825297339,3054627.52694864,664.738095238095,102261,10164939.9781119
1182,BTC,2012-10-15,6173596,7121967,23558,46286,7121967,30998,8020549,0,27.8948552393845,203467,25.6172230661743,3054627.52694864,512.136904761905,86268,10173389.9766119
1182,BTC,2012-10-16,6194836,7144037,22070,43061,7144037,34533,8055082,86,79.6047389850937,203622,23.616784005523,3055426.62008093,555.662337662338,104634,10181139.9761118
1182,BTC,2012-10-17,6213769,7169459,25422,44826,7169459,31813,8086895,137,104.824039155263,203764,21.9901962204554,3072321.73202076,600.063829787234,111804,10188239.9756119
1182,BTC,2012-10-18,6240347,7193376,23917,51055,7193376,28257,8115152,153,120.250804874442,203921,24.150892619743,3072321.73202076,546.378205128205,92154,10196089.9756118
1182,BTC,2012-10-19,6264280,7213349,19973,44589,7213349,25353,8140505,131,106.213937973644,204057,20.7686328370854,3072321.73202076,635.358208955224,93911,10202839.9756118
1182,BTC,2012-10-20,6287931,7235980,22631,43929,7235980,30442,8170947,149,88.5533886580448,204214,24.2846224173958,3072321.73202076,543.369426751592,92766,10210739.9756118
1182,BTC,2012-10-21,6308355,7257960,21980,38810,7257960,40833,8211780,150,57.6671826731266,204375,24.5392496006494,3072321.73202076,537.73125,114870,10218789.9706118
1182,BTC,2012-10-22,6329457,7281505,23545,41483,7281505,43154,8254934,169,52.5479256476816,204532,24.3560624778896,3072321.73202076,541.775641025641,120052,10226639.9671118
1182,BTC,2012-10-23,6350153,7301036,19531,41455,7301036,32031,8286965,22,81.4067736213755,204662,19.736596701041,3072321.73202076,668.581395348838,121311,10233139.9661118
1182,BTC,2012-10-24,6368312,7322090,21054,41863,7322090,32194,8319159,4,59.159894435369,204824,24.9083025284071,3072321.73202076,529.763975155279,94888,10241239.9661119
1182,BTC,2012-10-25,6388001,7341491,19401,39577,7341491,26998,8346157,2,54.184099835423,204967,21.8016432804125,3072321.73202076,605.25352112676,92771,10248389.9650118
1182,BTC,2012-10-26,6406858,7359818,18327,37808,7359818,21927,8368084,10,47.3400033871647,205132,25.4760786784196,3072321.73202076,517.957317073171,65762,10256639.9640118
1182,BTC,2012-10-27,6420789,7373852,14034,29748,7373852,16313,8384397,56,103.389633726064,205307,26.889266840265,3072321.73202076,490.735632183908,46227,10265389.9625118
1182,BTC,2012-10-28,6432728,7387002,13150,27648,7387002,17965,8402362,32,52.4287247459232,205473,25.7450753777956,3072321.73202076,512.545454545454,52922,10273689.9620118
1182,BTC,2012-10-29,6452365,7400924,13922,35698,7400924,21500,8423862,33,47.2321628964935,205631,24.1853962082866,3072321.73202076,545.59872611465,72405,10281589.9615118
1182,BTC,2012-10-30,6468781,7419721,18797,34202,7419721,30747,8454609,76,135.627189772257,205775,24.0280257439376,3304356.39299034,590.647887323944,97116,10288739.9610118
1182,BTC,2012-10-31,6484102,7437281,17560,32828,7437281,27755,8482364,87,136.444515860148,205918,23.5771123613206,3304356.39299034,601.944055944056,92447,10295939.9595118
1182,BTC,2012-11-01,6499287,7452866,15585,31737,7452866,23638,8506002,75,110.648849455525,206055,22.3837219420636,3304356.39299034,634.036764705882,80971,10302789.9580118
1182,BTC,2012-11-02,6513839,7470157,17291,33143,7470157,28990,8534992,10,30.3014438860918,206198,23.9768542336859,3304356.39299034,591.908450704225,92732,10309939.9565118
1182,BTC,2012-11-03,6527397,7487596,17439,32722,7487596,23899,8558891,131,80.0335069025771,206344,23.9868387490785,3304356.39299034,591.662068965517,75027,10317239.9560118
1182,BTC,2012-11-04,6541712,7502656,15060,30666,7502656,24304,8583195,183,92.4758389537566,206501,26.1090370200201,3304356.39299034,543.570512820513,74013,10325089.9555118
1182,BTC,2012-11-05,6558583,7520828,18172,37584,7520828,32184,8615379,8,71.5493285043049,206661,26.5213708818733,3304356.39299034,535.119496855346,96567,10333089.9545118
1182,BTC,2012-11-06,6576740,7541226,20398,41150,7541226,31986,8647365,0,59.2738403672879,206796,22.2459760438167,3304356.39299034,637.962686567164,108847,10339839.9535118
1182,BTC,2012-11-07,6596614,7563766,22540,43510,7563766,36480,8683845,0,50.8311701761615,206953,26.2424200766498,3304356.39299034,540.807692307692,106407,10347689.9535118
1182,BTC,2012-11-08,6613566,7582589,18823,37674,7582589,32415,8716260,0,41.0299298527947,207107,25.2934454414776,3304356.39299034,561.098039215686,98924,10355389.9535118
1182,BTC,2012-11-09,6630190,7601016,18427,36730,7601016,25157,8741417,1,34.6587236945304,207259,25.0603117498366,3304356.39299034,566.317880794702,77291,10362989.9530118
1182,BTC,2012-11-10,6647724,7617251,16235,34731,7617251,27109,8768526,0,16.1798729798569,207403,23.8340655060218,3304356.39299034,595.454545454546,88831,10370189.9520119
1182,BTC,2012-11-11,6659037,7632042,14791,30163,7632042,23555,8792081,0,17.9788588428801,207550,24.2537572076554,3304356.39299034,585.150684931507,71341,10377539.9515118
1182,BTC,2012-11-12,6673468,7648395,16353,31557,7648395,23903,8815984,0,20.3143975571158,207682,21.7971023032423,3321435.0002933,654.465648854962,83552,10384139.9515119
1182,BTC,2012-11-13,6687453,7665829,17434,32691,7665829,27131,8843115,27,31.4902699766783,207822,23.5349487771614,3368767.14053294,614.776978417266,87442,10391139.9495118
1182,BTC,2012-11-14,6704645,7686368,20539,37767,7686368,29901,8873016,72,43.471585461929,207965,23.92697799987,3368767.14053294,604.704225352112,93267,10398289.9485118
1182,BTC,2012-11-15,6727851,7712180,25812,46302,7712180,37604,8910620,180,70.7661400280944,208101,22.9191027752166,3368767.14053294,631.296296296297,120568,10405089.9480118
1182,BTC,2012-11-16,6755101,7738727,26547,48299,7738727,39446,8950066,271,93.9132025350112,208246,24.1859566577943,3368767.14053294,598.229166666667,123772,10412339.9480118
1182,BTC,2012-11-17,6774482,7767903,29176,52914,7767903,32538,8982604,202,81.4026575029455,208386,23.5810324293685,3368767.14053294,613.575539568345,119174,10419339.9470119
1182,BTC,2012-11-18,6796487,7792346,24443,42937,7792346,34136,9016740,23,60.4640669735359,208532,24.4626755553989,3368767.14053294,591.462068965517,105937,10426639.9470118
1182,BTC,2012-11-19,6817444,7815833,23487,42226,7815833,36923,9053663,1,37.6882901898792,208679,25.2578553488011,3368767.14053294,572.841379310345,113961,10433939.9460119
1182,BTC,2012-11-20,6839738,7840609,24776,43969,7840609,36858,9090521,0,42.671627751158,208825,24.8399229284183,3368767.14053294,582.479452054794,112477,10441289.9445119
1182,BTC,2012-11-21,6864098,7864644,24035,44126,7864644,39066,9129587,0,23.721317512004,208977,25.592798729728,3368767.14053294,565.344370860928,121658,10448889.9445118
1182,BTC,2012-11-22,6883179,7887188,22544,41378,7887188,30900,9160487,18,46.6808228128411,209121,24.2411483221162,3368767.14053294,596.867132867133,99590,10456089.9440119
1182,BTC,2012-11-23,6899278,7904407,17219,35211,7904407,32347,9192834,1,35.2443399350456,209284,27.4468862729236,3368767.14053294,527.154320987654,100192,10464239.9440118
1182,BTC,2012-11-24,6916254,7922849,18442,37102,7922849,29718,9222552,2,39.673494911634,209435,25.3068062554135,3368767.14053294,571.733333333333,90450,10471789.9435118
1182,BTC,2012-11-25,6932172,7941145,18296,36276,7941145,36736,9259288,0,22.0615985066817,209581,24.8262606321695,3368767.14053294,582.8,118420,10479089.9435118
1182,BTC,2012-11-26,6949828,7962312,21167,41339,7962312,35898,9295186,0,31.610730900675,209738,26.675730170871,3402274.37920788,547.788461538462,107951,10486939.9435118
1182,BTC,2012-11-27,6967911,7981541,19229,38564,7981541,27632,9322818,4,51.7910435025698,209886,25.4467168655265,3438908.96015914,580.428571428571,89130,10494339.9435119
1182,BTC,2012-11-28,6988426,8003332,21791,43852,8003332,37256,9360074,2,50.7641410029536,210058,29.7414097754929,3438908.96015914,496.61403508772,99559,10501464.9435118
1182,BTC,2012-11-29,7008983,8024332,21000,41960,8024332,37423,9397497,2,32.3552456267758,210224,28.4821916978847,3438908.96015914,518.569696969697,104866,10505614.9430118
1182,BTC,2012-11-30,7025066,8043268,18936,37110,8043268,29758,9427255,0,26.5357951647241,210349,21.8506787111098,3438908.96015914,675.951612903226,106639,10508739.9425119
1182,BTC,2012-12-01,7040461,8061019,17751,34733,8061019,33492,9460747,9,18.7664711971283,210516,28.7458554858618,3438908.96015914,513.813253012048,91761,10512914.9420118
1182,BTC,2012-12-02,7052739,8073959,12940,27800,8073959,20606,9481353,69,49.1153127212181,210659,24.3769057338419,3438908.96015914,605.901408450704,68166,10516489.9420118
1182,BTC,2012-12-03,7066040,8088352,14393,30146,8088352,21659,9503012,107,79.9779598865654,210806,25.1331028158451,3438908.96015914,587.671232876713,70422,10520164.9410118
1182,BTC,2012-12-04,7088691,8108787,20435,42417,8108787,32356,9535368,182,76.9303528633036,210918,19.3440960022222,3438908.96015914,763.540540540541,137322,10522964.9400118
1182,BTC,2012-12-05,7110312,8131575,22788,44489,8131575,33744,9569112,259,83.6194394968756,211040,21.3801912149107,3438908.96015914,690.826446280992,134862,10526014.9380118
1182,BTC,2012-12-06,7130081,8153783,22208,41024,8153783,37163,9606275,19,87.7027486303643,211177,23.3824974265364,3438908.96015914,631.669117647059,130736,10529439.9375119
1182,BTC,2012-12-07,7150404,8175212,21429,40896,8175212,32145,9638420,12,64.8060640030076,211306,22.0009099658915,3438908.96015914,671.3359375,111617,10532664.9365118
1182,BTC,2012-12-08,7168134,8196454,21242,38318,8196454,33174,9671594,3,30.3933778835657,211444,23.8596619179708,3438908.96015914,619.036496350365,105714,10536114.9355118
1182,BTC,2012-12-09,7188760,8216902,20448,38899,8216902,32059,9703653,33,43.8785933056277,211570,21.8219985784009,3438908.96015914,676.84,116813,10539264.9355118
1182,BTC,2012-12-10,7206292,8233974,17072,35939,8233974,36221,9739874,8,28.6422615176693,211713,24.2135122149977,3422568.23659295,607.091549295774,119484,10542839.9345118
1182,BTC,2012-12-11,7225193,8254354,20380,37045,8254354,36779,9776653,45,43.8840607979208,211857,24.2272007111041,3370181.79927784,597.461538461539,118238,10546439.9330118
1182,BTC,2012-12-12,7247787,8276523,22169,42722,8276523,36736,9813389,223,97.0219911167724,211987,22.494300188194,3370181.79927784,643.488372093023,131017,10549689.9330118
1182,BTC,2012-12-13,7271987,8302333,25810,47192,8302333,42515,9855904,287,90.2979430629317,212118,21.9484297855163,3370181.79927784,659.492307692308,150893,10552964.9330119
1182,BTC,2012-12-14,7292751,8325550,23217,41676,8325550,39014,9894918,203,75.0605097379923,212224,17.9747639287403,3370181.79927784,805.285714285714,168216,10555614.9320118
1182,BTC,2012-12-15,7309450,8344842,19292,34599,8344842,32365,9927283,30,51.2085783735124,212340,19.482273004955,3370181.79927784,742.973913043478,124239,10558514.9310118
1182,BTC,2012-12-16,7326598,8364638,19796,35748,8364638,35476,9962759,0,50.2456883199622,212451,18.823803785993,3370181.79927784,768.963636363636,143237,10561289.9300118
1182,BTC,2012-12-17,7346822,8388574,23936,40997,8388574,41040,10003799,0,43.8800179758879,212585,22.6939578816691,3370181.79927784,637.827067669173,131862,10564639.9295118
1182,BTC,2012-12-18,7370917,8417693,29119,48135,8417693,49812,10053611,5,47.6385849927359,212710,21.06169626349,3370181.79927784,687.258064516129,183036,10567764.9295118
1182,BTC,2012-12-19,7393035,8442197,24504,43743,8442197,44765,10098376,2,25.4054521734286,212852,23.6305816431319,3370181.79927784,612.54609929078,136948,10571314.9295118
1182,BTC,2012-12-20,7411262,8463461,21264,39532,8463461,35922,10134298,0,26.049786515329,212958,17.9885923067184,3370181.79927784,804.666666666667,155127,10573964.9285118
1182,BTC,2012-12-21,7434672,8489624,26163,46126,8489624,44580,10178878,1,37.3465223312957,213084,21.1081987002041,3370181.79927784,685.744,153479,10577114.9275118
1182,BTC,2012-12-22,7461983,8525149,35525,55127,8525149,51258,10230136,0,27.3694638722648,213237,25.6373615707461,3370181.79927784,564.598684210527,139518,10580939.9260118
1182,BTC,2012-12-23,7481068,8545850,20701,39925,8545850,36738,10266874,0,23.6657022175832,213359,20.9471409200268,3370181.79927784,691.01652892562,134197,10583989.9255119
1182,BTC,2012-12-24,7499167,8566159,20309,40026,8566159,36111,10302985,0,29.5193068073684,213491,22.5800100008446,3370181.79927784,641.045801526717,135534,10587289.9250119
1182,BTC,2012-12-25,7512597,8582914,16755,30289,8582914,28743,10331728,8,21.0417851430762,213615,20.8107692977972,3370181.79927784,695.544715447154,101059,10590389.9250119
1182,BTC,2012-12-26,7534758,8599422,16508,38113,8599422,36586,10368314,10,17.2853385796124,213769,25.1092885769535,3182517.23114055,544.372549019608,117640,10594239.9245119
1182,BTC,2012-12-27,7552700,8618240,18818,36571,8618240,43787,10412101,15,18.6024134685021,213925,23.5088173634466,2979636.61693807,544.367741935484,131340,10598139.9245119
1182,BTC,2012-12-28,7573219,8641830,23590,42409,8641830,47105,10459206,25,22.855584581455,214094,25.0681539833709,2979636.61693807,510.505952380952,126688,10602364.9230118
1182,BTC,2012-12-29,7593962,8661798,19968,39998,8661798,38110,10497316,34,26.084798897962,214238,21.2651256221499,2979636.61693807,601.804195804196,125104,10605964.9210118
1182,BTC,2012-12-30,7612951,8689744,27946,45781,8689744,45447,10542763,18,16.824189482322,214404,24.558371530235,2979636.61693807,521.10303030303,115105,10610114.9160119
1182,BTC,2012-12-31,7628153,8708496,18752,34738,8708496,30064,10572827,36,45.5689775786915,214562,23.3935096850857,2979636.61693807,547.050955414013,88550,10614064.9145119
1182,BTC,2013-01-01,7645555,8728548,20052,37847,8728548,31896,10604723,93,46.7763652359669,214724,24.1246298107605,2979636.61693807,530.472049689441,89114,10618114.9105118
1182,BTC,2013-01-02,7665712,8752757,24209,43104,8752757,39433,10644156,30,49.3824016109515,214877,22.6601022471767,2979636.61693807,564.756578947368,114158,10621939.9095118
1182,BTC,2013-01-03,7689200,8783037,30280,51270,8783037,42309,10686465,2,41.1742786377456,215039,24.103463151084,2979636.61693807,530.937888198757,108105,10625989.9070118
1182,BTC,2013-01-04,7710275,8808771,25734,47341,8808771,48589,10735054,4,47.9231287777203,215192,22.7776482108243,2979636.61693807,561.842105263158,141893,10629814.9035118
1182,BTC,2013-01-05,7731463,8836246,27475,53413,8836246,39596,10774650,1,53.0444918135905,215333,20.8282010616117,2979636.61693807,614.428571428572,118321,10633339.9010119
1182,BTC,2013-01-06,7749299,8857028,20782,42205,8857028,33026,10807676,4,33.3444086368095,215478,21.6459931005425,2979636.61693807,591.215277777778,100689,10636964.9005118
1182,BTC,2013-01-07,7772764,8881593,24565,54060,8881593,40288,10847964,3,37.0491942667469,215646,24.9982195566899,2979636.61693807,511.934131736527,105482,10641164.8990119
1182,BTC,2013-01-08,7795594,8907318,25725,56023,8907318,38624,10886588,8,55.6117444965464,215779,20.5748119299285,3117637.2319256,650.80303030303,149385,10644489.8980118
1182,BTC,2013-01-09,7819402,8934922,27604,56162,8934922,43190,10929778,1,39.8288990145948,215909,21.4376010404515,3249549.58448721,651.038759689923,148418,10647739.8970118
1182,BTC,2013-01-10,7849534,8965520,30598,61187,8965520,52539,10982317,1,25.4118196175045,216056,23.8283288551369,3249549.58448721,585.719178082192,163764,10651414.8950118
1182,BTC,2013-01-11,7878428,8999312,33792,61057,8999312,52749,11035066,0,25.2581573614453,216173,19.1054681585096,3249549.58448721,730.508620689655,187258,10654339.8930118
1182,BTC,2013-01-12,7901364,9024287,24975,50737,9024287,45671,11080737,1,21.4692182237612,216295,19.7363650543961,3249549.58448721,707.157024793388,163180,10657389.8930119
1182,BTC,2013-01-13,7927947,9052370,28083,55504,9052370,49441,11130178,4,17.9226070187921,216428,21.7076591101191,3249549.58448721,642.939393939394,162449,10660714.8920119
1182,BTC,2013-01-14,7950963,9076079,23709,44314,9076079,44560,11174738,14,25.1278624828817,216585,25.4654685953831,3249549.58448721,548.064102564102,127191,10664639.8900119
1182,BTC,2013-01-15,7974199,9105916,29837,57628,9105916,45022,11219760,59,46.4841818512709,216706,19.6732694676716,3249549.58448721,709.425,158378,10667664.8890118
1182,BTC,2013-01-16,8002666,9138805,32889,58425,9138805,53629,11273389,58,41.6759284020232,216837,21.3385260734509,3249549.58448721,654.061538461539,180820,10670939.8865119
1182,BTC,2013-01-17,8032746,9169463,30658,58919,9169463,48100,11321489,53,38.0234290643707,216948,17.9478134082854,3249549.58448721,777.627272727272,200063,10673714.8850119
1182,BTC,2013-01-18,8061034,9200533,31070,57056,9200533,49139,11370628,23,33.6820253184119,217069,19.548580701874,3249549.58448721,713.95,185283,10676739.8835119
1182,BTC,2013-01-19,8083539,9226770,26237,49358,9226770,56170,11426798,1,27.465093999468,217223,25.4769555501545,3249549.58448721,547.816993464052,159723,10680589.8825119
1182,BTC,2013-01-20,8104768,9251775,25005,46089,9251775,41371,11468169,0,28.9969003049537,217353,20.9448055581815,3249549.58448721,666.356589147287,140661,10683839.8810118
1182,BTC,2013-01-21,8128420,9274812,23037,45939,9274812,40441,11508610,2,28.5045240606004,217485,21.2386467348027,3249549.58448721,657.137404580152,139584,10687139.8790118
1182,BTC,2013-01-22,8155970,9301984,27172,53488,9301984,43752,11552362,3,33.4544231139093,217629,23.7774689882974,3249549.58448721,586.972027972028,144866,10690739.8765118
1182,BTC,2013-01-23,8180084,9327595,25611,47351,9327595,46678,11599040,5,51.7023990470252,217755,20.1340351345644,3187155.3061734,679.88,174382,10693889.8740119
1182,BTC,2013-01-24,8214662,9356251,28656,60700,9356251,46221,11645261,9,34.9830154762467,217911,23.0147996933561,2968775.33207507,554.025806451613,150873,10697789.8725118
1182,BTC,2013-01-25,8239400,9385042,28791,49558,9385042,48511,11693772,7,32.2472805850958,218048,20.1151601644726,2968775.33207507,633.889705882353,164224,10701214.8700119
1182,BTC,2013-01-26,8269117,9416510,31468,54651,9416510,52366,11746138,11,25.6687878800875,218204,23.2922759763264,2968775.33207507,547.425806451613,152176,10705114.8675118
1182,BTC,2013-01-27,8290075,9445561,29051,49580,9445561,55413,11801551,6,26.5608176579711,218355,22.5348038747449,2968775.33207507,565.826666666667,162203,10708889.8645118
1182,BTC,2013-01-28,8315765,9472933,27372,54296,9472933,52180,11853731,6,32.3945767753312,218502,21.576946292489,2968775.33207507,590.945205479452,168422,10712564.8625118
1182,BTC,2013-01-29,8345026,9501611,28678,55617,9501611,51703,11905434,11,46.9353799321155,218660,23.4216809770347,2968775.33207507,544.40127388535,157379,10716514.8610118
1182,BTC,2013-01-30,8366637,9525038,23427,44536,9525038,41219,11946653,9,65.3114305612696,218813,22.4537806430554,2968775.33207507,567.868421052631,127450,10720339.8565118
1182,BTC,2013-01-31,8388993,9550482,25444,47849,9550482,51633,11998286,7,30.7825955165026,219006,29.1981996565528,2968775.33207507,436.697916666667,124566,10725164.8535119
1182,BTC,2013-02-01,8419078,9585651,35169,64411,9585651,59382,12057668,16,30.5425325415511,219153,22.2030624631566,2968775.33207507,574.280821917808,179126,10728839.8525119
1182,BTC,2013-02-02,8444577,9617046,31395,56581,9617046,54465,12112133,16,24.8603797483962,219306,22.5546436632837,2968775.33207507,565.328947368421,158704,10732664.8505118
1182,BTC,2013-02-03,8470291,9647186,30140,57506,9647186,61164,12173297,47,22.7120770373244,219492,27.4258423169432,2968775.33207507,464.918918918919,149299,10737314.8490118
1182,BTC,2013-02-04,8496548,9676666,29480,57373,9676666,55005,12228302,40,36.5882512276739,219656,24.1894211258102,2968775.33207507,527.122699386503,153543,10741414.8480118
1182,BTC,2013-02-05,8526203,9709543,32877,59940,9709543,53420,12281722,29,37.5572731713092,219823,26.1954982680728,3115692.34021426,510.843373493976,141707,10745589.8470119
1182,BTC,2013-02-06,8550106,9738288,28745,53660,9738288,42555,12324277,29,43.7223203620733,219969,24.0076962277507,3275464.58656562,585.979310344827,129362,10749239.8455118
1182,BTC,2013-02-07,8577787,9770011,31723,58309,9770011,61237,12385514,23,28.2299506097374,220123,25.3534445864509,3275464.58656562,554.875816993464,177804,10753089.8440119
1182,BTC,2013-02-08,8609154,9802790,32779,60205,9802790,60921,12446435,87,35.9435946003445,220274,24.6308871146782,3275464.58656562,571.153333333334,180397,10756864.8440118
1182,BTC,2013-02-09,8636291,9832572,29782,56352,9832572,57750,12504185,65,31.4508156470462,220417,23.9103016894214,3275464.58656562,588.366197183099,179376,10760439.8435119
1182,BTC,2013-02-10,8666094,9866171,33599,57585,9866171,56443,12560628,38,24.282366091361,220578,26.6093169944542,3275464.58656562,528.6875,154022,10764464.8420118
1182,BTC,2013-02-11,8694807,9894453,28282,52291,9894453,57594,12618222,5,23.0621346521455,220737,25.933334476769,3275464.58656562,542.46835443038,164919,10768439.8415118
1182,BTC,2013-02-12,8722001,9923602,29149,51859,9923602,58551,12676773,3,21.7562715979215,220876,22.669147973304,3275464.58656562,620.579710144928,192537,10771914.8400118
1182,BTC,2013-02-13,8750645,9952049,28447,53166,9952049,59090,12735863,20,20.6643228222865,221047,27.9368532269459,3275464.58656562,503.564705882353,158420,10776189.8360118
1182,BTC,2013-02-14,8777872,9978960,26911,51477,9978960,50928,12786791,52,29.4997891507375,221198,24.5483648605277,3275464.58656562,573.073333333333,157905,10779964.8360118
1182,BTC,2013-02-15,8803175,10005967,27007,50145,10005967,55647,12842438,24,23.099813823296,221377,29.2150124668834,3275464.58656562,481.533707865169,145939,10784439.8335118
1182,BTC,2013-02-16,8824017,10029699,23732,47113,10029699,51433,12893871,23,24.6574443615671,221566,31.0078844509465,3275464.58656562,453.691489361702,124961,10789164.8335118
1182,BTC,2013-02-17,8845461,10054159,24460,45578,10054159,49635,12943506,22,23.0787097240546,221754,31.0570500682422,3275464.58656562,452.973262032086,126095,10793864.8290118
1182,BTC,2013-02-18,8867064,10080066,25907,47237,10080066,50374,12993880,24,24.5527845659868,221915,29.0861249629668,3639348.67901223,537.4,144020,10797889.8285118
1182,BTC,2013-02-19,8889891,10106525,26459,49402,10106525,54519,13048399,19,26.713732084941,222074,28.8622601649611,3651011.63069321,543.303797468354,160518,10801864.8255118
1182,BTC,2013-02-20,8914931,10133624,27099,50783,10133624,59748,13108147,12,20.0982740470058,222267,35.0976580846734,3651011.63069321,446.78125,149430,10806689.8240118
1182,BTC,2013-02-21,8939978,10162453,28829,50637,10162453,55916,13164063,19,18.7805136553385,222443,32.3022226578228,3651011.63069321,485.445714285714,142290,10811089.8225118
1182,BTC,2013-02-22,8967002,10193770,31317,54319,10193770,62171,13226234,26,25.3932111825092,222613,31.3271020183839,3651011.63069321,500.556213017751,167057,10815339.8225119
1182,BTC,2013-02-23,8992056,10223562,29792,51377,10223562,57886,13284120,23,22.1760630698155,222777,30.0620885260198,3651011.63069321,521.61963190184,163172,10819439.8225119
1182,BTC,2013-02-24,9015468,10253074,29512,52050,10253074,57164,13341284,154,29.8699458176592,222933,28.3277725251123,3651011.63069321,553.554838709678,159470,10823339.8220118
1182,BTC,2013-02-25,9041018,10282067,28993,56630,10282067,67144,13408428,93,27.8477179194063,223137,37.7040287690197,3651011.63069321,415.896551724138,149805,10828439.8205118
1182,BTC,2013-02-26,9068157,10313526,31459,58809,10313526,63438,13471866,36,25.7442528672133,223303,29.9751030033318,3651011.63069321,523.133333333333,174769,10832589.8195118
1182,BTC,2013-02-27,9092677,10341105,27579,55052,10341105,60949,13532815,16,25.2206536643235,223496,34.8934600368487,3651011.63069321,449.395833333333,145835,10837414.8185118
1182,BTC,2013-02-28,9119940,10371817,30712,59805,10371817,63021,13595836,28,23.577186030229,223664,30.6767752245168,3651011.63069321,511.167664670659,173664,10841614.8180119
1182,BTC,2013-03-01,9149574,10406354,34537,63073,10406354,64535,13660371,32,25.5343245897845,223816,29.3049058295078,3844376.36211498,563.437086092715,196620,10845414.8150119
1182,BTC,2013-03-02,9171439,10430817,24463,49230,10430817,55825,13716196,98,26.8017167809116,223961,32.645205242601,4367876.0008422,574.659722222222,180438,10849039.8145118
1182,BTC,2013-03-03,9192193,10453770,22953,46060,10453770,54459,13770655,18,17.1526005400674,224122,34.8664335593355,4367876.0008422,538.05,157164,10853064.8145119
1182,BTC,2013-03-04,9217094,10480901,27131,53538,10480901,64044,13834699,16,15.2870221180818,224301,38.9763458532914,4367876.0008422,481.314606741573,164763,10857539.8120119
1182,BTC,2013-03-05,9243111,10511764,30863,57386,10511764,56868,13891567,144,34.0932850568886,224440,30.1233863718655,4367876.0008422,622.768115942029,194577,10861014.8120119
1182,BTC,2013-03-06,9274696,10547367,35603,69113,10547367,62760,13954327,261,37.0286897083934,224595,33.5347907695471,4367876.0008422,559.415584415584,194600,10864889.8120118
1182,BTC,2013-03-07,9306854,10581240,33873,66343,10581240,66770,14021097,103,24.8545303145318,224755,34.5826374771539,4367876.0008422,542.465408805031,201910,10868889.8110119
1182,BTC,2013-03-08,9334702,10611909,30669,56555,10611909,55857,14076954,53,21.6469093395367,224915,35.0396660011451,4367876.0008422,535.389937106918,161515,10872889.8110119
1182,BTC,2013-03-09,9359811,10638709,26800,54085,10638709,55546,14132500,64,18.4380005544342,225084,37.0661500784316,4367876.0008422,506.119047619048,156913,10877114.8110118
1182,BTC,2013-03-10,9384990,10669009,30300,56948,10669009,73844,14206344,172,16.8156347648688,225267,39.7732979933518,4367876.0008422,471.67032967033,185437,10881689.8110118
1182,BTC,2013-03-11,9410808,10694886,25877,53486,10694886,59289,14265633,16,16.992941761164,225431,35.874389192448,4367876.0008422,522.932515337423,170545,10885789.8110118
1182,BTC,2013-03-12,9441977,10724854,29968,59705,10724854,48484,14314117,224,30.7717882849206,225566,29.3273663407586,4367876.0008422,639.671641791045,179993,10889164.8100118
1182,BTC,2013-03-13,9472627,10757680,32826,63000,10757680,56690,14370807,121,26.5649293203247,225723,34.1347407004103,4367876.0008422,549.583333333333,167594,10893089.8095119
1182,BTC,2013-03-14,9503186,10788622,30942,61078,10788622,58069,14428876,30,20.4753657348549,225902,41.6720225187664,4665387.72031593,480.842696629213,156039,10897564.8095119
1182,BTC,2013-03-15,9534516,10823747,35125,63449,10823747,62776,14491652,837,85.1666230094328,226074,41.4205468290903,4847647.15206561,502.66081871345,172658,10901864.8085119
1182,BTC,2013-03-16,9554641,10847612,23865,50882,10847612,34187,14525839,471,67.5064652600951,226249,42.2164747085145,4847647.15206561,493.183908045977,101030,10906239.8085118
1182,BTC,2013-03-17,9574907,10873057,25445,51904,10873057,35348,14561187,42,25.4961377894495,226458,50.4886165430396,4847647.15206561,412.379807692307,80979,10911464.8085119
1182,BTC,2013-03-18,9601011,10903307,30250,58824,10903307,43485,14604672,312,86.716147278838,226648,45.7843329728033,4847647.15206561,454.751322751323,107629,10916214.8085119
1182,BTC,2013-03-19,9633622,10938112,34805,68705,10938112,46108,14650780,251,42.1772234221918,226818,41.0062247195263,4847647.15206561,507.739644970414,132534,10920464.8085118
1182,BTC,2013-03-20,9660303,10969460,31348,62803,10969460,46276,14697056,409,40.8032257648003,227029,51.3566770336938,4847647.15206561,405.409523809524,104119,10925739.8085118
1182,BTC,2013-03-21,9693600,11002710,33250,69722,11002710,55564,14752620,301,36.7483500666199,227247,53.999037371132,4847647.15206561,385.571428571429,127105,10931189.8085119
1182,BTC,2013-03-22,9729212,11041180,38470,74953,11041180,60584,14813204,159,25.0905369478031,227476,55.520646584164,4847647.15206561,375.004385964912,130729,10936914.8075119
1182,BTC,2013-03-23,9761443,11072489,31309,66964,11072489,52914,14866118,260,27.1846265611441,227693,52.2301515820934,4847647.15206561,398.62962962963,125269,10942339.8075119
1182,BTC,2013-03-24,9795909,11112343,39854,68996,11112343,51335,14917453,55,19.3949108343296,227882,52.7241855296356,5581051.56894285,454.63829787234,130020,10947064.8075119
1182,BTC,2013-03-25,9824466,11145715,33372,66156,11145715,48993,14966446,192,31.5350685037309,228026,47.9099310459719,6695826.28259625,600.258741258741,168653,10950664.8075119
1182,BTC,2013-03-26,9856569,11181514,35799,72997,11181514,49061,15015507,164,37.6850122717332,228177,50.2516598385101,6695826.28259625,572.286666666667,161460,10954439.8075119
1182,BTC,2013-03-27,9888053,11218859,37345,72740,11218859,53207,15068714,560,51.4613698616793,228308,43.8847546976589,6695826.28259625,655.315384615384,190771,10957714.8075119
1182,BTC,2013-03-28,9935912,11260282,41423,94447,11260282,60989,15129703,426,29.9513151194225,228491,60.7737839186694,6695826.28259625,473.203296703297,175340,10962289.8075118
1182,BTC,2013-03-29,9976958,11305974,45692,83259,11305974,62259,15191962,214,23.457617274645,228665,57.8686044420002,6695826.28259625,496.959537572255,177902,10966639.8065118
1182,BTC,2013-03-30,10011163,11345814,39840,78034,11345814,59196,15251158,267,30.7990515878318,228838,57.9717204030833,6695826.28259625,496.075581395349,187826,10970964.8065118
1182,BTC,2013-03-31,10036177,11375417,29603,64234,11375417,43986,15295144,366,35.0324607307943,229007,56.1197294000452,6695826.28259625,512.446428571429,147911,10975189.8065118
1182,BTC,2013-04-01,10071691,11412707,37290,75734,11412707,52770,15347914,283,27.4600407612649,229205,67.6917809637404,6695826.28259625,424.842639593909,139337,10980139.8065119
1182,BTC,2013-04-02,10116057,11460908,48201,91858,11460908,63276,15411190,633,40.9083862331412,229386,60.5694079685092,6695826.28259625,474.8,175525,10984664.8055119
1182,BTC,2013-04-03,10162688,11514870,53962,107117,11514870,63941,15475131,519,37.0861408421015,229561,57.9557076383176,6695826.28259625,496.212643678161,184291,10989039.8050119
1182,BTC,2013-04-04,10215095,11571304,56434,108872,11571304,66892,15542023,744,34.2741689807902,229715,51.6138406342311,6695826.28259625,557.183006535948,221649,10992889.8050118
1182,BTC,2013-04-05,10262457,11627357,56053,100016,11627357,61373,15603396,401,33.6052929077145,229873,55.1710526951936,7005058.44638356,545.331210191083,190149,10996839.8050118
1182,BTC,2013-04-06,10299089,11673023,45666,83049,11673023,51718,15655114,418,25.7794672527476,230036,62.4671615577034,7672999.92016414,527.561728395062,158648,11000914.8050118
1182,BTC,2013-04-07,10333624,11722738,49715,87055,11722738,63541,15718655,309,17.1478205176171,230200,62.737511927407,7672999.92016414,525.288343558282,205493,11005014.8050118
1182,BTC,2013-04-08,10376561,11784053,61315,113855,11784053,61680,15780335,499,24.7859240227685,230355,59.4951372492714,7672999.92016414,553.915584415585,195200,11008889.8050118
1182,BTC,2013-04-09,10428814,11845077,61024,112032,11845077,66979,15847314,863,31.047574166689,230531,67.6676051400975,7672999.92016414,487.017142857143,179210,11013289.8050119
1182,BTC,2013-04-10,10489104,11919220,74143,133413,11919220,63881,15911195,581,45.0900308417282,230722,75.140150804262,7672999.92016414,438.584210526316,168524,11018064.8050119
1182,BTC,2013-04-11,10544103,11980742,61522,124571,11980742,68407,15979602,812,35.0840186827847,230882,61.0930535668036,7672999.92016414,539.427672955975,216576,11022064.8050118
1182,BTC,2013-04-12,10593039,12034059,53317,102913,12034059,58690,16038292,294,30.2283694023904,231055,66.700110608391,7672999.92016414,494.081395348837,163858,11026389.8050118
1182,BTC,2013-04-13,10629588,12077189,43130,82796,12077189,53517,16091809,166,24.4091026180898,231222,64.4719876656577,7672999.92016414,511.156626506024,145270,11030564.8050119
1182,BTC,2013-04-14,10658496,12111267,34078,71358,12111267,55471,16147280,34,14.8828429743771,231375,58.6413542962031,7672999.92016414,561.980263157895,175250,11034389.8050118
1182,BTC,2013-04-15,10693228,12156807,45540,100215,12156807,54496,16201776,68,19.2644927043442,231539,64.2741399491288,7672999.92016414,512.730061349694,161968,11038489.8050119
1182,BTC,2013-04-16,10739808,12209405,52598,100319,12209405,67785,16269561,267,26.1081802765163,231716,68.0934260157967,7672999.92016414,483.971590909091,181273,11042914.8050119
1182,BTC,2013-04-17,10782486,12261258,51853,105207,12261258,56706,16326267,209,30.394586744605,231887,68.3646190275839,8038276.01692869,505.0,163884,11047189.8050118
1182,BTC,2013-04-18,10822049,12303906,42648,82077,12303906,46631,16372898,1018,125.385944782438,232034,66.8107438172943,8974296.01488785,576.917808219178,144500,11050864.8050118
1182,BTC,2013-04-19,10869332,12356517,52611,104978,12356517,59528,16432426,514,31.4787575785499,232171,60.7271217067114,8974296.01488785,634.713235294118,211673,11054289.8050119
1182,BTC,2013-04-20,10902678,12393913,37396,74465,12393913,48302,16480728,288,22.7261474135127,232325,69.0628774675099,8974296.01488785,558.104575163398,157490,11058139.8050118
1182,BTC,2013-04-21,10931729,12427426,33513,69836,12427426,44224,16524952,193,22.2326525275859,232501,78.6627701838987,8974296.01488785,489.994285714286,123134,11062539.8050118
1182,BTC,2013-04-22,10962963,12468831,41405,91677,12468831,47194,16572146,285,34.9570049282411,232654,68.7024027470725,8974296.01488785,561.032894736842,147132,11066364.8050118
1182,BTC,2013-04-23,11006153,12517552,48721,93131,12517552,61668,16633814,314,25.6242198379221,232822,76.0790872895069,8974296.01488785,506.634730538922,174533,11070564.8050118
1182,BTC,2013-04-24,11051081,12566805,49253,102493,12566805,65023,16698837,427,33.2861112532672,232984,72.2484203609048,8974296.01488785,533.496894409938,209641,11074614.8050119
1182,BTC,2013-04-25,11091893,12613411,46606,90725,12613411,62566,16761403,306,26.169826564707,233156,77.0958294219911,8974296.01488785,499.953216374269,175715,11078914.8050119
1182,BTC,2013-04-26,11127906,12656217,42806,86162,12656217,55264,16816667,294,21.3424233162576,233327,76.0719367170091,8974296.01488785,506.682352941176,157673,11083189.8050118
1182,BTC,2013-04-27,11157886,12696172,39955,78208,12696172,44369,16861036,202,18.2168328455996,233474,67.1968685278186,8974296.01488785,573.602739726028,147221,11086864.8050119
1182,BTC,2013-04-28,11188977,12775096,78924,118021,12775096,41879,16902915,180,13.8365739905965,233651,79.8150244533461,8974296.01488785,482.920454545454,122019,11091289.8050119
1182,BTC,2013-04-29,11223998,12815304,40208,86930,12815304,51776,16954691,746,36.4948968512071,233825,78.9711417219972,8974296.01488785,488.080924855491,147565,11095639.8038119
1182,BTC,2013-04-30,11254834,12847576,32272,76873,12847576,47599,17002290,216,21.0790904895212,233974,72.7628625236891,9854414.31928499,581.675675675675,181493,11099364.8038119
1182,BTC,2013-05-01,11288634,12887524,39948,83566,12887524,55327,17057617,176,24.4134309000649,234125,75.5628245824717,10076292.8834187,572.733333333333,170380,11103139.8038119
1182,BTC,2013-05-02,11323885,12925836,38312,81921,12925836,55429,17113046,80,16.3688517748271,234259,67.2731105317173,10076292.8834187,643.308270676691,196927,11106489.8038119
1182,BTC,2013-05-03,11357424,12962022,36186,82805,12962022,51412,17164458,72,15.7416168201525,234397,68.3630801125655,10076292.8834187,633.051470588235,182476,11109914.8038119
1182,BTC,2013-05-04,11383449,12992876,30854,69963,12992876,50261,17214719,24,10.0413512500865,234555,81.2333952726314,10076292.8834187,532.753164556962,157967,11113889.8038119
1182,BTC,2013-05-05,11411202,13024830,31954,72102,13024830,50332,17265051,45,12.6794649505074,234720,83.161309697806,10076292.8834187,520.40243902439,152646,11118014.8038119
1182,BTC,2013-05-06,11444687,13060898,36068,85166,13060898,53340,17318391,124,16.0931011466886,234886,83.2431335929234,10076292.8834187,519.890909090909,163183,11122164.8038119
1182,BTC,2013-05-07,11476123,13101760,40862,109070,13101760,56735,17375126,55,17.1646271088125,235054,84.8256752501885,10076292.8834187,510.191616766467,171042,11126364.8038119
1182,BTC,2013-05-08,11510368,13143192,41432,102388,13143192,50439,17425565,79,16.4970313186409,235219,83.042602347884,10076292.8834187,521.146341463415,156593,11130489.8038119
1182,BTC,2013-05-09,11549088,13186827,43635,81895,13186827,66774,17492339,59,10.41418873328,235383,82.0791188340053,10076292.8834187,527.263803680981,189125,11134589.8038118
1182,BTC,2013-05-10,11586490,13229432,42605,84296,13229432,67881,17560220,110,13.482177290018,235555,87.0669150236286,10076292.8834187,497.058479532164,190641,11138889.8038119
1182,BTC,2013-05-11,11626916,13270861,41429,80911,13270861,73402,17633622,75,9.19763429531035,235737,92.1086986613286,10076292.8834187,469.850828729282,190634,11143439.8038119
1182,BTC,2013-05-12,11656311,13305575,34714,69607,13305575,65428,17699050,56,8.59824085714144,235905,87.3076492432344,10301130.9527641,506.748502994012,182176,11147639.8038119
1182,BTC,2013-05-13,11688669,13343030,37455,82800,13343030,60998,17760048,328,18.39555338959,236079,96.4423263754504,11187257.4613608,498.21387283237,168795,11151989.8038119
1182,BTC,2013-05-14,11726001,13384833,41803,83724,13384833,66470,17826518,73,11.7997920499783,236233,85.6796164897895,11187257.4613608,560.797385620915,201917,11155839.8038119
1182,BTC,2013-05-15,11765068,13426723,41890,84716,13426723,64171,17890689,60,11.7310141200424,236374,78.1664306628869,11187257.4613608,614.7,217992,11159364.8033118
1182,BTC,2013-05-16,11798047,13466655,39932,84115,13466655,61158,17951847,54,11.8293999090165,236522,82.0109030419281,11187257.4613608,585.884353741496,201141,11163064.8033119
1182,BTC,2013-05-17,11833920,13504269,37614,78407,13504269,58731,18010578,129,14.5313505633202,236683,89.3237220834496,11187257.4613608,537.91875,174007,11167089.8033119
1182,BTC,2013-05-18,11862996,13536960,32691,68328,13536960,52215,18062793,149,14.3294265859054,236832,83.2122764063999,11187257.4613608,577.425675675676,167547,11170814.8033119
1182,BTC,2013-05-19,11891056,13567640,30680,64190,13567640,47820,18110613,47,8.8570207300435,236988,89.1050736272626,11187257.4613608,539.23870967742,141571,11174714.8033119
1182,BTC,2013-05-20,11922463,13601720,34080,71629,13601720,48821,18159434,38,11.0744137850529,237117,71.832885584333,11187257.4613608,668.8984375,180973,11177939.8033118
1182,BTC,2013-05-21,11960406,13642812,41092,82539,13642812,53942,18213376,60,12.5038550579363,237268,84.2716835927681,11187257.4613608,570.166666666667,174012,11181714.8033118
1182,BTC,2013-05-22,11992444,13678874,36062,74760,13678874,51990,18265366,100,14.1964773818815,237424,86.774328170784,11187257.4613608,553.722580645161,158898,11185614.8033119
1182,BTC,2013-05-23,12031589,13721278,42404,83225,13721278,59789,18325155,170,11.914398216673,237598,96.6610139149083,11187257.4613608,497.086705202312,162274,11189964.8033119
1182,BTC,2013-05-24,12071348,13761686,40408,84916,13761686,55401,18380556,85,13.7135012249546,237767,93.8629770695822,11187257.4613608,511.904761904762,159006,11194189.8033119
1182,BTC,2013-05-25,12103905,13793209,31523,69589,13793209,51280,18431836,145,14.3459296508496,237932,93.5817136889866,11450754.0745649,525.536585365854,149018,11198314.8033118
1182,BTC,2013-05-26,12132965,13820978,27769,69625,13820978,40722,18472558,42,9.54516060854477,238095,98.4373014549534,12153411.7097758,530.271604938272,133395,11202389.8033119
1182,BTC,2013-05-27,12162249,13853127,32149,73955,13853127,52758,18525316,101,12.6352093300464,238271,106.554900615369,12153411.7097758,489.874285714286,148587,11206789.8033118
1182,BTC,2013-05-28,12196332,13890371,37244,76191,13890371,57070,18582386,184,12.3651748956772,238429,96.0127164787624,12153411.7097758,543.662420382166,169591,11210739.8033119
1182,BTC,2013-05-29,12234464,13930899,40528,80524,13930899,55060,18637446,62,14.4145349537988,238597,101.328046046425,12153411.7097758,515.14371257485,160073,11214939.8033119
1182,BTC,2013-05-30,12270791,13969199,38300,78186,13969199,57426,18694872,59,10.9634627128356,238776,109.524996610273,12153411.7097758,476.589887640449,156321,11219414.8033119
1182,BTC,2013-05-31,12306097,14006992,37793,75447,14006992,54346,18749218,94,12.4869866827027,238951,105.625668862237,12153411.7097758,494.183908045977,147359,11223789.8033119
1182,BTC,2013-06-01,12337387,14040017,33025,67761,14040017,54311,18803529,66,8.94071927182615,239164,128.673890252461,12153411.7097758,405.665094339623,124866,11229114.8033119
1182,BTC,2013-06-02,12366717,14069411,29394,65819,14069411,49947,18853476,49,8.64667224420566,239363,119.697772355151,12153411.7097758,436.085858585859,121341,11234089.8033119
1182,BTC,2013-06-03,12403170,14104803,35392,79846,14104803,55874,18909350,109,13.9679678648067,239576,128.916730572372,12153411.7097758,404.900943396226,126487,11239414.8033119
1182,BTC,2013-06-04,12440560,14142887,38084,78629,14142887,57622,18966972,98,11.482268943125,239789,128.354500209962,12153411.7097758,406.674528301887,129793,11244739.8033119
1182,BTC,2013-06-05,12473966,14177527,34640,78653,14177527,56560,19023532,137,12.046311251093,239973,123.482951165131,13466756.6445895,468.398907103825,147819,11249339.8033119
1182,BTC,2013-06-06,12508488,14213904,36377,73257,14213904,54638,19078170,86,13.7986543903699,240154,140.283048765286,15605632.6812859,477.788888888889,143527,11253864.8033119
1182,BTC,2013-06-07,12547506,14253199,39295,73768,14253199,52188,19130358,91,12.9942375175858,240315,126.418827300741,15605632.6812859,530.1875,154855,11257889.8033119
1182,BTC,2013-06-08,12575051,14281495,28296,58258,14281495,48218,19178576,32,8.2757135457576,240496,140.129887101748,15605632.6812859,478.311111111111,122923,11262414.8033119
1182,BTC,2013-06-09,12601363,14308293,26798,56600,14308293,44471,19223047,31,15.1820519054199,240655,127.061379741354,15605632.6812859,527.506329113924,134049,11266389.8033119
1182,BTC,2013-06-10,12630426,14339546,31253,60964,14339546,45000,19268047,32,10.9010028877629,240829,134.531946327523,15605632.6812859,498.21387283237,118736,11270739.8033119
1182,BTC,2013-06-11,12658512,14372569,33023,66609,14372569,49663,19317710,46,12.0479489933252,241009,139.731162538872,15605632.6812859,479.675977653631,123198,11275239.8033119
1182,BTC,2013-06-12,12686691,14403248,30679,63764,14403248,45907,19363617,28,12.2429864736254,241212,157.970618081387,15605632.6812859,424.292079207921,106272,11280314.8033119
1182,BTC,2013-06-13,12717336,14437097,33849,66341,14437097,43193,19406810,39,14.0660976223624,241398,144.33084051017,15605632.6812859,464.389189189189,108115,11284964.8033118
1182,BTC,2013-06-14,12759186,14480587,43490,75764,14480587,50172,19456982,53,14.4001672281874,241578,139.732789950183,15605632.6812859,479.670391061453,130693,11289464.8033119
1182,BTC,2013-06-15,12786485,14508363,27776,53810,14508363,35826,19492808,24,11.5944233474393,241751,135.362491386523,15605632.6812859,495.156976744186,96622,11293789.8033119
1182,BTC,2013-06-16,12809747,14532717,24354,48785,14532717,42966,19535774,34,12.1184760475073,241936,146.452638531804,15948722.6004682,467.722826086957,106505,11298414.8033119
1182,BTC,2013-06-17,12836060,14562682,29965,56906,14562682,45943,19581717,21,12.5991982264073,242081,140.127387097332,19339258.2723867,592.756944444444,143229,11302039.8033119
1182,BTC,2013-06-18,12866192,14595723,33041,63563,14595723,46017,19627734,49,13.9779245858906,242221,135.266606971237,19339258.2723867,614.057553956834,149551,11305539.8033119
1182,BTC,2013-06-19,12900234,14632385,36662,69145,14632385,47031,19674765,24,12.3876974254664,242357,130.456989135907,19339258.2723867,636.696296296296,160322,11308939.8033119
1182,BTC,2013-06-20,12935623,14668270,35885,67644,14668270,52515,19727280,73,13.8742830574276,242511,148.154616763577,19339258.2723867,560.640522875817,158415,11312789.8033119
1182,BTC,2013-06-21,12973006,14706346,38076,69098,14706346,47027,19774307,60,15.1570699426032,242679,162.396593870812,19339258.2723867,511.473053892215,132155,11316989.8033118
1182,BTC,2013-06-22,13002117,14736493,30147,58577,14736493,44594,19818901,24,9.75527497239158,242855,169.949249579559,19339258.2723867,488.742857142857,117687,11321389.8033119
1182,BTC,2013-06-23,13027315,14761642,25149,52069,14761642,38507,19857408,29,8.83946956046771,243020,159.220186039892,19339258.2723867,521.676829268293,106843,11325514.8033119
1182,BTC,2013-06-24,13058880,14794722,33080,64862,14794722,44245,19901653,66,13.7880674041724,243170,143.526664921441,19339258.2723867,578.718120805369,135474,11329264.8033119
1182,BTC,2013-06-25,13088630,14827409,32687,61381,14827409,44629,19946282,103,16.0722505821522,243327,150.3567129135,19339258.2723867,552.429487179488,128022,11333189.8033119
1182,BTC,2013-06-26,13118373,14860305,32896,64996,14860305,45627,19991909,65,13.7454993826259,243501,167.300838887917,19339258.2723867,496.479768786127,120767,11337539.8033118
1182,BTC,2013-06-27,13147571,14892801,32496,61025,14892801,46128,20038037,50,12.2460375774996,243668,159.796560047522,19339258.2723867,519.795180722892,127479,11341714.8033119
1182,BTC,2013-06-28,13185137,14931312,38511,68612,14931312,49552,20087589,43,13.3176477183423,243837,162.727005980876,19339258.2723867,510.434523809524,135415,11345939.8033119
1182,BTC,2013-06-29,13211956,14960156,28844,60981,14960156,36545,20124134,9,14.5723208794954,244006,169.16372631191,20177844.2472585,512.303571428572,105794,11350164.8033119
1182,BTC,2013-06-30,13234822,14985222,25066,50786,14985222,30953,20155087,31,13.3851245986828,244159,162.203915228612,21335329.113983,564.934210526316,92671,11353989.8033119
1182,BTC,2013-07-01,13269239,15021487,36265,68677,15021487,39128,20194215,57,22.2077649413719,244316,165.704413732285,21335329.113983,553.0,113372,11357914.8033119
1182,BTC,2013-07-02,13302225,15055443,33956,64157,15055443,39650,20233865,28,18.5579211695264,244469,163.333765663035,21335329.113983,561.026315789474,117370,11361739.8033119
1182,BTC,2013-07-03,13333417,15090030,34587,66026,15090030,35531,20269396,26,23.0069771815249,244653,194.375011188955,21335329.113983,471.431693989071,86074,11366339.8033119
1182,BTC,2013-07-04,13362544,15121970,31940,60868,15121970,35292,20304688,29,24.2247329341363,244818,175.105329459567,21335329.113983,523.310975609756,97314,11370464.8033119
1182,BTC,2013-07-05,13392162,15154330,32360,60510,15154330,37037,20341725,83,29.0132378620982,245004,198.482496743724,21335329.113983,461.675675675676,90295,11375114.8033119
1182,BTC,2013-07-06,13421557,15181238,26908,56535,15181238,33372,20375097,69,20.9932350335407,245191,200.141199949218,21335329.113983,457.849462365591,84349,11379789.8033119
1182,BTC,2013-07-07,13443737,15204159,22921,48848,15204159,30356,20405453,48,21.2109838897967,245377,198.969378843927,21335329.113983,460.545945945946,76148,11384439.8033119
1182,BTC,2013-07-08,13475420,15239025,34866,63047,15239025,39629,20445082,27,21.137826611019,245569,204.775913088161,21335329.113983,447.486910994764,94547,11389239.8033118
1182,BTC,2013-07-09,13511364,15276324,37299,67987,15276324,40832,20485914,21,28.4312287266707,245754,195.704848365572,21335329.113983,468.228260869565,103349,11393864.8033119
1182,BTC,2013-07-10,13542549,15311371,35047,64859,15311371,39238,20525152,27,27.6560744585381,245949,208.279840121228,21335329.113983,439.958762886598,93036,11398739.8033119
1182,BTC,2013-07-11,13584158,15355847,44476,73357,15355847,43434,20568586,29,24.3697791258629,246123,227.03769016458,26107386.6415517,493.884393063584,115277,11403089.8033119
1182,BTC,2013-07-12,13631599,15405513,49666,78451,15405513,48260,20616846,56,21.1667730965667,246277,207.607718690172,26162875.6825699,541.254901960784,152026,11406939.8033119
1182,BTC,2013-07-13,13665951,15439428,33915,63117,15439428,37970,20654816,58,23.0976566833424,246434,204.449690768001,26162875.6825699,549.615384615385,115555,11410864.8033119
1182,BTC,2013-07-14,13688539,15463080,23652,48402,15463080,34933,20689749,34,16.668380819907,246606,224.855735976101,26162875.6825699,499.736842105263,97410,11415164.8033119
1182,BTC,2013-07-15,13719295,15494329,31249,62325,15494329,36754,20726503,44,19.1220173610255,246770,212.797245993867,26162875.6825699,528.055214723926,104989,11419264.8033119
1182,BTC,2013-07-16,13754041,15532100,37771,66223,15532100,39392,20765895,53,24.151598510952,246934,213.300306910796,26162875.6825699,526.80981595092,110965,11423364.8033119
1182,BTC,2013-07-17,13785945,15567417,35317,63007,15567417,40643,20806538,75,26.5958747552614,247118,241.539569659354,26162875.6825699,465.218579234973,100908,11427964.8033119
1182,BTC,2013-07-18,13818810,15601824,34407,63180,15601824,41170,20847708,34,24.4327397361771,247279,210.991307188568,26162875.6825699,532.575,117120,11431989.8033118
1182,BTC,2013-07-19,13848531,15635339,33515,58760,15635339,36759,20884467,40,22.2919707128213,247450,224.497046954575,26162875.6825699,500.535294117647,96946,11436264.8033118
1182,BTC,2013-07-20,13872535,15661560,26221,52401,15661560,33702,20918169,20,14.7149263234719,247636,243.006203139843,26162875.6825699,462.410810810811,83064,11440914.8033119
1182,BTC,2013-07-21,13898829,15689168,27608,51123,15689168,35456,20953625,29,14.0109603610754,247835,259.270068920437,26162875.6825699,433.40404040404,83059,11445889.8033119
1182,BTC,2013-07-22,13929263,15722966,33798,60318,15722966,39979,20993604,185,22.5952447396583,248000,223.35361125399,27181692.6916097,522.689024390244,109935,11450014.8033119
1182,BTC,2013-07-23,13961636,15758448,35482,64299,15758448,38432,21032036,112,26.3449564695808,248141,218.352220432615,31256960.7277689,614.821428571429,124265,11453539.8033119
1182,BTC,2013-07-24,13995367,15793610,35162,65891,15793610,42361,21074397,73,21.426445084659,248300,247.944132037027,31256960.7277689,541.443037974684,125014,11457514.8033119
1182,BTC,2013-07-25,14032654,15830791,37181,66443,15830791,42530,21116927,34,19.0915059151361,248446,225.605339339476,31256960.7277689,595.055172413793,140275,11461164.8033119
1182,BTC,2013-07-26,14065726,15865359,34568,62560,15865359,37373,21154300,56,21.0936240378535,248611,255.518662385061,31256960.7277689,525.39263803681,105695,11465264.8033118
1182,BTC,2013-07-27,14094312,15892486,27127,52441,15892486,36892,21191192,32,12.5123475297756,248791,284.366032428331,31256960.7277689,472.094444444444,94782,11469789.8033119
1182,BTC,2013-07-28,14119024,15919222,26736,49181,15919222,37302,21228494,47,16.5917061776369,248959,262.71858564248,31256960.7277689,510.994011976048,104046,11473989.8033119
1182,BTC,2013-07-29,14154013,15956001,36779,67475,15956001,41812,21270306,57,17.8860881924797,249137,276.931488804344,31256960.7277689,484.768361581921,110812,11478439.8033119
1182,BTC,2013-07-30,14193374,15996732,40731,69871,15996732,42133,21312439,200,23.9030913315351,249334,309.460927978552,31256960.7277689,433.811224489796,100043,11483364.8023119
1182,BTC,2013-07-31,14242374,16044839,48107,80901,16044839,49524,21361963,110,17.4413932574511,249524,303.756745535082,31256960.7277689,441.957671957672,125116,11488114.8023119
1182,BTC,2013-08-01,14290408,16128027,83188,114307,16128027,50904,21412867,158,22.5386104231862,249701,275.196918611992,31256960.7277689,487.823863636364,135514,11492539.8023119
1182,BTC,2013-08-02,14335082,16175825,47798,74760,16175825,51681,21464548,109,17.6750471335235,249893,301.467241229107,31256960.7277689,445.314136125654,119717,11497339.8023119
1182,BTC,2013-08-03,14369031,16211380,35555,60497,16211380,45746,21510294,94,14.7938874225806,250063,293.145506561014,34144398.5671598,500.260355029586,125401,11501589.8023118
1182,BTC,2013-08-04,14403380,16243742,32362,60256,16243742,42946,21553240,42,11.890660627152,250242,336.182303126255,37392766.1364746,477.719101123595,113389,11506064.8023119
1182,BTC,2013-08-05,14445410,16288017,44275,73178,16288017,51001,21604241,89,16.6990050759616,250431,353.195683928985,37392766.1364746,454.707446808511,121786,11510789.8023119
1182,BTC,2013-08-06,14485459,16331698,43681,71549,16331698,54369,21658610,62,13.9932890527049,250621,355.706863093205,37392766.1364746,451.497354497354,125927,11515539.8023119
1182,BTC,2013-08-07,14525930,16377384,45686,75671,16377384,57606,21716216,105,14.1206561350299,250807,348.521752955224,37392766.1364746,460.805405405405,135285,11520189.8023119
1182,BTC,2013-08-08,14567288,16421155,43771,72378,16421155,58022,21774238,83,12.5029324773869,251012,380.181771761041,37392766.1364746,422.43137254902,126478,11525314.8023119
1182,BTC,2013-08-09,14603621,16459553,38398,64634,16459553,49658,21823896,62,12.5169311738111,251207,366.065152818029,37392766.1364746,438.721649484536,112163,11530189.8023119
1182,BTC,2013-08-10,14638057,16496741,37188,59307,16496741,51695,21875591,46,10.0020281134324,251417,392.501466393759,37392766.1364746,409.172248803828,112655,11535439.8023119
1182,BTC,2013-08-11,14667357,16525912,29171,54138,16525912,38422,21914013,40,11.1799029030667,251633,402.93076781112,37392766.1364746,398.581395348837,80942,11540839.8023119
1182,BTC,2013-08-12,14738645,16596825,70913,103397,16596825,50228,21964241,93,16.8708058080453,251849,405.428771091784,37392766.1364746,396.125581395349,134153,11546239.8023119
1182,BTC,2013-08-13,14778874,16640801,43976,75003,16640801,53080,22017321,146,24.5211273274819,252032,362.931637701168,39812328.4648323,471.142857142857,138799,11550814.8023118
1182,BTC,2013-08-14,14822314,16687308,46507,78217,16687308,51660,22068981,126,25.975510129095,252200,428.967258331649,50810339.0482765,508.730538922156,145541,11555014.8023119
1182,BTC,2013-08-15,14862881,16732649,45341,75759,16732649,58129,22127110,62,14.1328519255807,252370,433.034212642803,50810339.0482765,503.952662721893,163184,11559264.8023119
1182,BTC,2013-08-16,14915265,16785920,53271,82519,16785920,71119,22198229,70,15.0955693386136,252538,427.302469642512,50810339.0482765,510.7125748503,182542,11563464.8023119
1182,BTC,2013-08-17,14950615,16822674,36754,61413,16822674,56546,22254775,51,17.7957931293216,252728,487.307656193748,50810339.0482765,447.825396825397,129777,11568214.8023119
1182,BTC,2013-08-18,14982922,16855706,33032,57552,16855706,56397,22311172,51,13.9672489792487,252922,488.683301317214,50810339.0482765,446.564766839378,130632,11573064.8023119
1182,BTC,2013-08-19,15027298,16905885,50179,78552,16905885,71314,22382486,99,15.6364952140965,253099,453.639068750982,50810339.0482765,481.0625,177959,11577489.8023119
1182,BTC,2013-08-20,15073224,16953621,47736,79845,16953621,63228,22445714,153,15.3765295913405,253289,480.411311209526,50810339.0482765,454.253968253968,151469,11582239.8023119
1182,BTC,2013-08-21,15119452,17002165,48544,82676,17002165,60531,22506245,247,21.0741487389564,253485,500.40692826492,50810339.0482765,436.102564102564,138139,11587139.8023119
1182,BTC,2013-08-22,15169441,17055017,52852,83890,17055017,66812,22573057,127,12.3262988179674,253701,546.862711631748,50810339.0482765,399.055813953488,132786,11592539.8023119
1182,BTC,2013-08-23,15215569,17098818,43801,81889,17098818,55195,22628252,102,14.9729116494905,253897,495.587422172065,50810339.0482765,440.34358974359,133104,11597439.8023119
1182,BTC,2013-08-24,15251195,17135667,36849,64392,17135667,51817,22680069,69,10.9604163453367,254080,512.340924994088,56116797.3627713,470.428571428572,131210,11602014.8023119
1182,BTC,2013-08-25,15290578,17168763,33096,68615,17168763,44447,22724516,57,12.5014972220427,254231,493.70218426267,65750060.1490848,571.993333333333,142959,11605789.8023118
1182,BTC,2013-08-26,15334718,17212977,44214,75774,17212977,56093,22780609,116,12.6163227655194,254397,545.89096347425,65750060.1490848,517.309090909091,150842,11609939.8023119
1182,BTC,2013-08-27,15393589,17264917,51940,95012,17264917,62187,22842796,99,14.6380039513744,254566,550.578546008485,65750060.1490848,512.904761904762,176087,11614164.8023119
1182,BTC,2013-08-28,15442062,17317579,52662,83876,17317579,64747,22907543,133,12.1125883861941,254744,580.754544423673,65750060.1490848,486.254237288136,159938,11618614.8023119
1182,BTC,2013-08-29,15483783,17363882,46303,74889,17363882,58992,22966535,93,44.7374499969618,254933,627.342802101767,65750060.1490848,450.143617021276,133115,11623339.8023118
1182,BTC,2013-08-30,15540255,17419947,56065,89612,17419947,62603,23029138,131,13.2844805342095,255138,683.195951735868,65750060.1490848,413.343137254902,138975,11628464.8023119
1182,BTC,2013-08-31,15581161,17480493,60546,88168,17480493,47505,23076643,110,18.4976144400674,255361,732.018723140261,65750060.1490848,385.774774774775,98136,11634039.8023119
1182,BTC,2013-09-01,15609261,17510236,29743,57002,17510236,46598,23123241,113,17.6700526945247,255582,719.759474154009,65750060.1490848,392.345454545454,95107,11639564.8023118
1182,BTC,2013-09-02,15640148,17543523,33287,62792,17543523,51266,23174507,124,15.8764214287364,255797,721.184694051928,65750060.1490848,391.570093457944,106152,11644939.8023118
1182,BTC,2013-09-03,15678713,17582229,38706,72102,17582229,52163,23226670,225,18.208019866986,255991,639.170999222681,65750060.1490848,441.81347150259,130871,11649789.8023119
1182,BTC,2013-09-04,15720648,17624582,42353,76878,17624582,52979,23279649,175,17.2176657427475,256154,662.46285043396,81734745.9620878,529.913580246913,147023,11653864.8023119
1182,BTC,2013-09-05,15758359,17665508,40926,70425,17665508,60730,23340379,74,14.6096436875037,256333,770.808556424536,86933017.7711944,484.393258426966,142603,11658339.8023119
1182,BTC,2013-09-06,15799495,17705658,40150,73273,17705658,60850,23401229,60,11.5297897352615,256518,801.466444564863,86933017.7711944,465.864130434783,147017,11662964.8023119
1182,BTC,2013-09-07,15834268,17740649,34991,62595,17740649,51967,23453196,51,12.1148022679331,256663,642.487493796434,86933017.7711944,581.138888888889,156767,11666589.8023119
1182,BTC,2013-09-08,15864405,17770104,29455,56485,17770104,46452,23499648,34,8.57155451771571,256820,681.627311825343,86933017.7711944,547.769230769231,131435,11670514.8023119
1182,BTC,2013-09-09,15904507,17808563,38459,73996,17808563,57676,23557324,74,17.8716755077524,257023,874.758090820147,86933017.7711944,426.831683168317,123577,11675589.8023119
1182,BTC,2013-09-10,15942936,17845380,36817,70671,17845380,53283,23610607,68,12.1122900448982,257214,835.525745780919,86933017.7711944,446.873684210526,125557,11680364.8023119
1182,BTC,2013-09-11,15983387,17887729,42349,74681,17887729,49210,23659817,90,16.9007426140079,257414,866.328372381871,86933017.7711944,430.984924623115,107222,11685364.8023119
1182,BTC,2013-09-12,16026309,17931166,43437,77033,17931166,52300,23712117,74,13.4441319521704,257627,927.345001267755,86933017.7711944,402.627358490566,114380,11690689.8023119
1182,BTC,2013-09-13,16060477,17969864,38698,66579,17969864,44834,23756951,74,14.592449150474,257831,892.367484827377,86933017.7711944,418.408866995074,100948,11695789.8023119
1182,BTC,2013-09-14,16086428,17998815,28951,54055,17998815,43560,23800511,53,13.1341203694658,258049,955.360780518756,87168756.5867463,391.880184331797,90067,11701239.8023119
1182,BTC,2013-09-15,16113186,18026649,27834,54802,18026649,53672,23854183,56,7.51802705610393,258230,1015.43420869308,112628548.666347,476.383333333333,139854,11705764.8023119
1182,BTC,2013-09-16,16149289,18065378,38729,69774,18065378,51885,23906068,110,13.0723902233769,258384,862.06347714771,112628548.666347,561.137254901961,161599,11709614.8023119
1182,BTC,2013-09-17,16187285,18106355,40977,73046,18106355,67931,23973999,76,9.23900995714136,258563,1002.09480471326,112628548.666347,482.724719101124,165678,11714089.8023119
1182,BTC,2013-09-18,16230321,18149340,42985,79097,18149340,60551,24034550,129,13.327513496938,258728,930.152339445849,112628548.666347,520.060975609756,164105,11718214.8023119
1182,BTC,2013-09-19,16272251,18193926,44586,79121,18193926,59815,24094365,114,13.9410479182969,258918,1067.33861821761,112628548.666347,453.216931216931,136878,11722964.8023119
1182,BTC,2013-09-20,16310312,18236229,42303,77107,18236229,58994,24153359,123,12.4471813383703,259118,1142.10486546358,112628548.666347,423.547738693467,131111,11727964.8023119
1182,BTC,2013-09-21,16341924,18271920,35691,66371,18271920,52498,24205857,43,8.61126735199493,259307,1060.67594385545,112628548.666347,456.063829787234,124464,11732689.8023119
1182,BTC,2013-09-22,16372290,18303156,31236,63588,18303156,50903,24256760,33,9.728687564009,259510,1153.00253091302,112628548.666347,419.544554455446,112764,11737764.8023119
1182,BTC,2013-09-23,16412758,18346455,43299,80541,18346455,65328,24322088,163,15.3234692832513,259720,1174.96234597357,112628548.666347,411.703349282297,138322,11743014.8023119
1182,BTC,2013-09-24,16452490,18390310,43855,78405,18390310,62592,24384680,131,15.162830159645,259932,1188.09766017388,112628548.666347,407.151658767772,132035,11748314.8023119
1182,BTC,2013-09-25,16489436,18430736,40426,78501,18430736,54548,24439228,115,15.1662038508448,260138,1310.6050882274,125804756.605211,412.273170731707,117527,11753464.8023119
1182,BTC,2013-09-26,16528442,18473917,43181,78182,18473917,57545,24496773,112,12.9559836790573,260300,1199.46556851227,148819199.805093,532.88198757764,160880,11757514.8023119
1182,BTC,2013-09-27,16568959,18514976,41059,78102,18514976,46920,24543693,94,14.7083301706402,260478,1315.24845697732,148819199.805093,485.971751412429,123470,11761964.8023119
1182,BTC,2013-09-28,16601963,18549613,34637,68931,18549613,42580,24586273,60,12.5277759324904,260655,1335.13598784241,148819199.805093,478.732954545454,113568,11766389.8023119
1182,BTC,2013-09-29,16637598,18583396,33783,71312,18583396,41181,24627454,95,13.4559145066832,260825,1264.93439686144,148819199.805093,505.301775147929,114968,11770639.8023119
1182,BTC,2013-09-30,16676204,18625931,42535,80461,18625931,47156,24674610,120,17.5327431645055,260988,1204.64100913399,148819199.805093,530.592592592593,133594,11774714.8023119
1182,BTC,2013-10-01,16723534,18674745,48814,89794,18674745,57171,24731781,158,19.0319906267533,261175,1384.94313843382,148819199.805093,461.516129032258,139612,11779389.8023119
1182,BTC,2013-10-02,16783561,18726484,51739,105736,18726484,61964,24793745,169,19.1575570404664,261366,1418.80931449448,148819199.805093,450.5,161979,11784164.8023119
1182,BTC,2013-10-03,16833285,18770065,43581,90271,18770065,59551,24853296,139,15.5670064457525,261565,1469.29635270152,148819199.805093,435.020202020202,145292,11789139.8023119
1182,BTC,2013-10-04,16870698,18810412,40347,77848,18810412,51940,24905236,146,15.4442374031698,261745,1333.94046538624,148819199.805093,479.162011173184,130150,11793639.8023119
1182,BTC,2013-10-05,16900929,18842101,31689,65744,18842101,45479,24950715,55,9.86711244959915,261964,1618.53692609116,148819199.805093,394.908256880734,96355,11799114.8023119
1182,BTC,2013-10-06,16929758,18872965,30864,61110,18872965,42857,24993572,37,9.78389216281214,262149,1509.74833198132,164129164.471665,466.91847826087,112910,11803739.8023119
1182,BTC,2013-10-07,16967338,18912968,40003,76600,18912968,44547,25038119,52,15.4577857083397,262305,1467.49936165944,189281249.281033,553.974193548387,145600,11807639.8023119
1182,BTC,2013-10-08,17004748,18955179,42211,76020,18955179,45131,25083250,89,15.9598261088731,262467,1561.22047728848,189281249.281033,520.71875,127433,11811664.8023119
1182,BTC,2013-10-09,17044426,19000117,44938,80276,19000117,50673,25133923,150,17.8533846616186,262645,1682.96414433824,189281249.281033,483.050561797753,133019,11816139.8023119
1182,BTC,2013-10-10,17085285,19046387,46270,80598,19046387,56853,25190776,126,13.2488762966959,262837,1813.66066417805,189281249.281033,448.240837696335,137713,11820939.8023119
1182,BTC,2013-10-11,17126228,19090601,44214,79797,19090601,51922,25242698,132,15.9767839570617,263022,1751.63116590844,189281249.281033,464.114130434783,127686,11825564.8023119
1182,BTC,2013-10-12,17158824,19127484,36883,66982,19127484,49474,25292172,102,14.1064812857938,263236,2021.71387229325,189281249.281033,402.112676056338,107505,11830914.8023119
1182,BTC,2013-10-13,17200792,19173257,45773,87657,19173257,51304,25343476,170,13.8905093750472,263457,2101.40395476176,189281249.281033,386.863636363637,118411,11836439.8023119
1182,BTC,2013-10-14,17238863,19216174,42917,82482,19216174,57452,25400928,160,16.0271981204499,263707,2360.87608262703,189281249.281033,344.345381526105,113406,11842689.8023119
1182,BTC,2013-10-15,17277893,19262217,46043,85590,19262217,55826,25456754,165,16.5604702693639,263967,2446.30368917158,189281249.281033,332.320463320463,100830,11849189.8023119
1182,BTC,2013-10-16,17322375,19312927,50710,93274,19312927,50826,25507580,211,20.1224636461185,264177,2308.62017740679,219914106.502527,409.129186602871,117534,11854439.8023119
1182,BTC,2013-10-17,17361800,19356207,43280,81453,19356207,46870,25554450,167,18.0791706363659,264344,2248.22028958518,267731249.482421,511.469879518072,133438,11858614.8023119
1182,BTC,2013-10-18,17405795,19404174,47967,86027,19404174,59661,25614111,208,15.7150393906847,264536,2600.00614969334,267731249.482421,442.267015706806,143193,11863414.8023119
1182,BTC,2013-10-19,17453422,19453838,49664,92555,19453838,55311,25669422,357,18.2123435125809,264759,3038.76016597445,267731249.482421,378.40990990991,130005,11868989.8023119
1182,BTC,2013-10-20,17486445,19494768,40930,73526,19494768,49418,25718840,181,14.6254352815296,264958,2648.63831513773,267731249.482421,434.146464646465,121697,11873964.8023119
1182,BTC,2013-10-21,17534290,19545422,50654,96422,19545422,60451,25779291,297,17.5215839960042,265169,2813.51495706862,267731249.482421,408.704761904762,139856,11879239.8023119
1182,BTC,2013-10-22,17588698,19606085,60663,109559,19606085,65048,25844339,506,18.5651073768353,265414,3270.94194778601,267731249.482421,351.549180327869,134544,11885364.8023119
1182,BTC,2013-10-23,17643565,19661814,55729,108034,19661814,55314,25899653,435,19.7187669302574,265635,2966.43212173695,267731249.482421,387.636363636364,134827,11890889.8023119
1182,BTC,2013-10-24,17703860,19722499,60685,112118,19722499,63634,25963287,385,16.172224012136,265850,2941.26445756672,267731249.482421,390.953271028037,158989,11896264.8023119
1182,BTC,2013-10-25,17757160,19776070,53571,101197,19776070,57471,26020758,747,49.0241770196356,266085,3134.00059157374,267731249.482421,366.910256410256,127208,11902139.8023119
1182,BTC,2013-10-26,17792226,19814349,38279,73939,19814349,47747,26068505,111,14.3834265900396,266267,3364.89271160675,373329139.330134,476.519337016574,126904,11906689.8023119
1182,BTC,2013-10-27,17822398,19848046,33697,65295,19848046,43691,26112196,109,11.668390489688,266446,3476.08332036975,390928787.638086,483.022471910112,116610,11911164.8023119
1182,BTC,2013-10-28,17865776,19892819,44773,86597,19892819,51104,26163300,139,12.635282308607,266621,3411.14104904921,390928787.638086,492.218390804598,135659,11915539.8023119
1182,BTC,2013-10-29,17907099,19939127,46308,85463,19939127,49930,26213230,359,33.7758531351718,266781,3125.83648592969,390928787.638086,537.14465408805,145675,11919539.8023119
1182,BTC,2013-10-30,17954108,19990039,50912,95949,19990039,48446,26261676,181,14.8019064544394,266976,3822.50702286336,390928787.638086,439.247422680412,124644,11924414.8023119
1182,BTC,2013-10-31,18002812,20041371,51332,96937,20041371,58181,26319857,154,11.7782137293048,267187,4102.2377044607,390928787.638086,409.295238095238,135337,11929689.8023119
1182,BTC,2013-11-01,18046163,20088286,46915,87054,20088286,45371,26365228,148,14.0364076881689,267395,4045.28156360086,390928787.638086,415.057971014493,106324,11934889.8023119
1182,BTC,2013-11-02,18082045,20128910,40624,77879,20128910,39181,26404409,159,16.5702857224183,267597,3940.77812622838,390928787.638086,426.064676616915,105669,11939939.8023119
1182,BTC,2013-11-03,18122465,20169190,40280,83335,20169190,35947,26440356,167,16.5192189472551,267789,3751.46557141448,390928787.638086,447.565445026178,104035,11944739.8023119
1182,BTC,2013-11-04,18172708,20222911,53721,100574,20222911,45523,26485879,388,21.3971556049564,267984,3796.88670396296,390928787.638086,442.211340206185,120132,11949614.8023119
1182,BTC,2013-11-05,18235350,20287862,64951,117732,20287862,51597,26537476,357,21.619888327882,268158,3623.85574280716,412308267.303144,488.664739884393,156711,11953964.8023119
1182,BTC,2013-11-06,18310481,20352723,64861,131401,20352723,55008,26592484,399,16.6637793497938,268321,4237.20301176393,510929738.016152,517.895061728395,185176,11958039.8023119
1182,BTC,2013-11-07,18380671,20430246,77523,130495,20430246,60535,26653019,581,20.0159802478688,268465,3655.75842508738,510929738.016152,600.265734265734,219445,11961639.8023119
1182,BTC,2013-11-08,18451428,20504626,74380,130740,20504626,59223,26712242,589,18.0931564886777,268599,3444.24846632347,510929738.016152,637.127819548872,229804,11964989.8023119
1182,BTC,2013-11-09,18517487,20575469,70843,129817,20575469,55204,26767446,588,16.3102764295294,268747,3777.99936468171,510929738.016152,580.843537414966,199634,11968689.8023119
1182,BTC,2013-11-10,18576056,20636226,60757,117027,20636226,57538,26824984,409,13.9257459090964,268918,4335.50086705538,510929738.016152,506.152941176471,174086,11972964.8023119
1182,BTC,2013-11-11,18635127,20690720,54494,116257,20690720,57405,26882389,471,13.0350925799819,269105,4809.6736133766,510929738.016152,456.252688172043,150729,11977639.8023119
1182,BTC,2013-11-12,18690631,20753119,62399,116409,20753119,58307,26940696,1009,19.0206482950371,269306,5104.44520378507,510929738.016152,429.905,141561,11982664.8023119
1182,BTC,2013-11-13,18752305,20819123,66004,122999,20819123,64870,27005566,942,19.53881736206,269474,4265.63492947025,510929738.016152,514.443113772455,185109,11986864.8023119
1182,BTC,2013-11-14,18820469,20894354,75231,133441,20894354,69413,27074979,979,16.6399463213289,269657,4708.57011578083,510929738.016152,466.049450549451,183650,11991439.8023119
1182,BTC,2013-11-15,18879216,20960797,66443,120013,20960797,60914,27135893,1347,42.2968341937747,269823,4215.13824249105,510929738.016152,520.60606060606,175689,11995589.8023119
1182,BTC,2013-11-16,18926698,21016228,55431,103893,21016228,47175,27183068,1086,31.6058565636986,270017,4933.93815700686,510929738.016152,444.761658031088,117453,12000439.8023119
1182,BTC,2013-11-17,18979452,21074184,57956,107733,21074184,51323,27234391,1048,22.5670541997985,270203,5067.26434002995,542721009.58783,460.005405405405,140258,12005089.8023119
1182,BTC,2013-11-18,19065926,21172686,98502,164697,21172686,79032,27313423,2693,26.8775128605453,270359,4816.8764100937,609482679.888355,543.445161290322,255220,12008989.8023119
1182,BTC,2013-11-19,19182120,21295258,122572,207757,21295258,92907,27406330,2986,24.423719115792,270520,4916.51866339348,609482679.888355,532.43125,312510,12013014.8023119
1182,BTC,2013-11-20,19267939,21389888,94630,165514,21389888,77558,27483888,1802,21.7946197662052,270684,4947.94959063749,609482679.888355,529.049079754601,233257,12017114.8023119
1182,BTC,2013-11-21,19382363,21476878,86990,188792,21476878,71822,27555710,2178,30.533413027397,270834,4555.72643184301,609482679.888355,574.597315436242,274035,12020864.8023119
1182,BTC,2013-11-22,19468358,21569422,92544,165424,21569422,76947,27632657,1907,31.1021871854348,271006,5210.79458895296,609482679.888355,502.362573099415,226997,12025164.8023119
1182,BTC,2013-11-23,19547498,21658914,89492,150900,21658914,72545,27705202,1842,21.1361695955838,271176,5188.44405106687,609482679.888355,504.526627218935,209453,12029414.8023119
1182,BTC,2013-11-24,19610949,21725780,66866,124669,21725780,60861,27766063,1940,24.9564172699326,271344,5074.49117401471,609482679.888355,515.85628742515,183450,12033614.8023119
1182,BTC,2013-11-25,19681796,21806549,80769,143016,21806549,71793,27837856,1898,20.1867981928591,271517,5231.52312868347,609482679.888355,500.372093023256,190290,12037939.8023119
1182,BTC,2013-11-26,19774188,21912300,105751,179511,21912300,83383,27921239,2762,48.3131824863118,271676,4866.08654596251,609482679.888355,537.949367088607,251388,12041914.8023119
1182,BTC,2013-11-27,19882563,22033141,120841,199267,22033141,95531,28016770,3669,34.7935854730286,271849,5274.60791868668,609482679.888355,496.28488372093,265051,12046239.8023119
1182,BTC,2013-11-28,19984268,22152181,119040,202036,22152181,98921,28115691,5178,34.5585199690202,272030,5497.78276609073,609482679.888355,476.138888888889,248631,12050764.8023119
1182,BTC,2013-11-29,20079449,22264078,111897,189633,22264078,90084,28205775,4873,28.8944704587213,272203,5540.32103784519,634388613.64083,491.790697674419,250041,12055089.8023119
1182,BTC,2013-11-30,20154522,22358096,94018,163658,22358096,75190,28280965,4053,24.8271450162135,272380,6225.7236442028,707408283.051497,488.022857142857,200325,12059489.8023119
1182,BTC,2013-12-01,20243229,22449388,91292,166648,22449388,72142,28353107,3011,20.7154967051547,272574,6872.12828906488,707408283.051497,442.118556701031,188751,12064364.8023119
1182,BTC,2013-12-02,20327756,22547529,98141,178035,22547529,75570,28428677,3542,18.849952427862,272733,5578.22258963558,707408283.051497,544.670886075949,231057,12068339.8023119
1182,BTC,2013-12-03,20416929,22650705,103176,174156,22650705,77667,28506344,2781,15.3222625084378,272933,7028.75800891076,707408283.051497,432.266331658292,185423,12073339.8023119
1182,BTC,2013-12-04,20515333,22757830,107125,184291,22757830,79624,28585968,2855,16.9397616591726,273104,6101.49935508921,707408283.051497,497.958823529412,232914,12077614.8023119
1182,BTC,2013-12-05,20615627,22869836,112006,184048,22869836,83283,28669251,2527,18.6168621010337,273274,6042.48125334787,707408283.051497,502.8224852071,238241,12081864.8023119
1182,BTC,2013-12-06,20700287,22964560,94724,169437,22964560,72099,28741350,1996,16.1390586439632,273482,7453.68646103863,707408283.051497,407.623188405797,168976,12087064.8023119
1182,BTC,2013-12-07,20775426,23049935,85375,150908,23049935,67712,28809062,2798,34.820198638358,273677,6844.67648471675,707408283.051497,443.89175257732,164792,12091939.8023119
1182,BTC,2013-12-08,20827884,23108897,58962,114541,23108897,47477,28856539,1407,25.6861968725484,273872,6855.98170915734,707408283.051497,443.159793814433,120550,12096814.8023119
1182,BTC,2013-12-09,20897053,23193952,85055,156261,23193952,63625,28920164,1847,19.1232022498931,274048,6236.8969526398,707408283.051497,487.148571428571,172596,12101214.8023119
1182,BTC,2013-12-10,20971345,23275905,81953,154548,23275905,67623,28987787,1513,12.385316500386,274240,7511.69017750784,775435718.780971,443.371727748691,191762,12106014.8023119
1182,BTC,2013-12-11,21046994,23359239,83334,152926,23359239,67305,29055092,1583,16.5479241387298,274405,7456.49316003946,908350862.437022,523.213414634146,195924,12110139.8023119
1182,BTC,2013-12-12,21111685,23430726,71487,130827,23430726,58219,29113311,1282,15.7174184581678,274568,7439.69105010577,908350862.437022,524.395061728395,170573,12114214.8023119
1182,BTC,2013-12-13,21182032,23508776,78050,144948,23508776,60115,29173426,1158,15.2126132084902,274743,7881.58142572635,908350862.437022,494.994219653179,177243,12118564.8023119
1182,BTC,2013-12-14,21259905,23581504,72728,149175,23581504,54057,29227483,758,11.473566686175,274940,8902.5198103775,908350862.437022,438.228426395939,167295,12123514.8023119
1182,BTC,2013-12-15,21336027,23648084,66580,141318,23648084,52308,29279791,718,8.84465912228034,275117,8010.5856030733,908350862.437022,487.022727272727,172007,12127939.8023119
1182,BTC,2013-12-16,21420533,23738313,90229,177672,23738313,69382,29349173,2374,30.1636315881837,275318,9084.17972933861,908350862.437022,429.465,179755,12132964.8023119
1182,BTC,2013-12-17,21501201,23823061,84748,158832,23823061,67740,29416913,1884,23.4225485402152,275521,9231.23022123699,908350862.437022,422.623762376238,168914,12138039.8023119
1182,BTC,2013-12-18,21597053,23923643,100582,181247,23923643,81510,29498423,2161,24.4978629139456,275720,8977.45104302586,908350862.437022,434.570707070707,204074,12143014.8023119
1182,BTC,2013-12-19,21675981,24008954,85311,157749,24008954,70278,29568701,1594,19.4090174031014,275946,10210.548803985,908350862.437022,382.088888888889,148427,12148664.8023119
1182,BTC,2013-12-20,21752711,24085322,76368,153562,24085322,65083,29633784,1245,14.4481094583286,276124,8066.35780719441,908350862.437022,483.655367231638,183211,12153114.8023119
1182,BTC,2013-12-21,21818371,24152996,67674,127414,24152996,56083,29689867,991,17.4319084076274,276285,8653.71288870799,1067492472.90394,529.8125,173917,12157139.8023119
1182,BTC,2013-12-22,21883131,24215100,62104,124085,24215100,52897,29742764,873,17.3999118947886,276454,9974.13646635455,1180923195.25803,508.517857142857,162082,12161364.8023119
1182,BTC,2013-12-23,21944311,24293985,78885,152467,24293985,54267,29797031,953,13.3089205924669,276625,10112.6443219011,1180923195.25803,501.55294117647,168516,12165639.8023119
1182,BTC,2013-12-24,22010363,24368601,74616,130529,24368601,55865,29852896,827,15.8690512836771,276794,10043.7352215035,1180923195.25803,504.994047619048,167303,12169864.8023119
1182,BTC,2013-12-25,22081924,24445170,76569,130234,24445170,55428,29908324,982,15.8443262206024,276956,9490.89106157703,1180923195.25803,534.409937888199,176324,12173914.8023119
1182,BTC,2013-12-26,22140492,24509846,64676,122664,24509846,51276,29959600,1222,12.0998807158296,277136,10598.4234031854,1180923195.25803,478.564245810056,166255,12178414.8023119
1182,BTC,2013-12-27,22199253,24577241,67395,126409,24577241,52674,30012274,988,11.5050678693779,277320,11019.3376626217,1180923195.25803,460.284153005465,146293,12183014.8023119
1182,BTC,2013-12-28,22259684,24635418,58177,115926,24635418,48009,30060283,1006,12.7953120316709,277470,9110.03361909249,1180923195.25803,556.751677852349,177773,12186764.8023119
1182,BTC,2013-12-29,22323083,24690916,55498,129271,24690916,51325,30111608,1040,16.3182743658178,277638,9825.40397590032,1180923195.25803,516.215568862275,174762,12190964.8023119
1182,BTC,2013-12-30,22386389,24766193,75277,152691,24766193,55613,30167221,1219,14.6486368756895,277811,10254.7084642188,1180923195.25803,494.604651162791,175158,12195289.8023119
1182,BTC,2013-12-31,22443594,24826534,60341,119180,24826534,48847,30216068,763,10.4058788486384,277995,10895.6760341592,1180923195.25803,465.508196721311,144519,12199889.8023119
1182,BTC,2014-01-01,22486312,24874553,48019,97263,24874553,43070,30259138,913,12.5141233360587,278200,12078.3681381555,1180923195.25803,419.926470588236,105176,12205014.8023119
1182,BTC,2014-01-02,22550123,24942730,68177,137760,24942730,54770,30313908,1343,12.9504928375158,278334,9373.87629604848,1406071638.54598,644.240601503759,213055,12208364.8023119
1182,BTC,2014-01-03,22621668,25019083,76353,143117,25019083,60980,30374888,1474,14.7225886746382,278495,11299.7506801367,1418481395.26264,539.15625,196643,12212389.8023119
1182,BTC,2014-01-04,22675073,25078314,59231,116604,25078314,52052,30426940,791,12.2013769994734,278636,9887.39646166704,1418481395.26264,616.171428571429,185009,12215914.8023119
1182,BTC,2014-01-05,22741063,25148468,70154,136213,25148468,58662,30485602,1630,15.9289308896195,278829,13648.6189620713,1418481395.26264,446.369791666667,166161,12220739.8023119
1182,BTC,2014-01-06,22821683,25235741,87273,178918,25235741,67358,30552960,1780,14.8140658726055,279015,13348.9822873784,1418481395.26264,456.389189189189,203092,12225389.8023119
1182,BTC,2014-01-07,22885589,25308855,73114,142546,25308855,62911,30615871,1090,14.7012117646982,279192,12710.5619040552,1418481395.26264,479.3125,176517,12229814.8023119
1182,BTC,2014-01-08,22948223,25388683,79828,147461,25388683,61439,30677310,1332,13.0055657625402,279385,13655.9486195687,1418481395.26264,446.130208333333,157901,12234639.8023119
1182,BTC,2014-01-09,23010531,25459206,70523,134121,25459206,59031,30736341,991,10.1219863728646,279592,14599.7094965603,1418481395.26264,417.291262135922,141840,12239814.8023119
1182,BTC,2014-01-10,23070500,25523655,64449,127465,25523655,54166,30790507,1034,10.5112360058858,279779,13452.8463154651,1418481395.26264,452.865591397849,146732,12244489.8023119
1182,BTC,2014-01-11,23131489,25588015,64360,130050,25588015,55856,30846363,765,7.60935981499015,279989,14979.9673100145,1418481395.26264,406.698564593301,140351,12249739.8023119
1182,BTC,2014-01-12,23182534,25645141,57126,117031,25645141,50537,30896900,760,8.34135414979876,280196,14645.7105417462,1418481395.26264,415.980582524272,126423,12254914.8023119
1182,BTC,2014-01-13,23239057,25714172,69031,152180,25714172,53461,30950361,865,9.90901137591253,280365,15072.9816044941,1730264288.2938,493.029761904762,166477,12259139.8023119
1182,BTC,2014-01-14,23299639,25779196,65024,131488,25779196,57378,31007739,1282,13.0539143912332,280527,14382.3029560467,1789546951.05324,534.409937888198,174550,12263189.8023119
1182,BTC,2014-01-15,23358457,25847327,68131,132930,25847327,61612,31069351,901,9.82989260611131,280711,16325.5762823915,1789546951.05324,470.79781420765,162223,12267789.8023119
1182,BTC,2014-01-16,23418332,25908027,60700,132450,25908027,56703,31126054,1096,10.6745118986493,280896,16504.439312566,1789546951.05324,465.695652173913,159538,12272414.8023119
1182,BTC,2014-01-17,23469604,25969952,61925,129276,25969952,59026,31185080,663,7.22022867330719,281048,13572.9158680352,1789546951.05324,566.278145695364,189940,12276214.8023119
1182,BTC,2014-01-18,23516695,26023007,53055,106540,26023007,51573,31236653,576,6.9393515998889,281222,15470.0983559594,1789546951.05324,496.832369942197,144555,12280564.8023119
1182,BTC,2014-01-19,23565441,26077192,54185,108829,26077192,48005,31284658,986,11.812754667404,281391,14974.5525425521,1789546951.05324,513.27380952381,142592,12284789.8023119
1182,BTC,2014-01-20,23642243,26157807,80615,179147,26157807,63003,31347661,1504,12.4506817545179,281586,17411.5795804369,1789546951.05324,441.432989690722,184311,12289664.8023119
1182,BTC,2014-01-21,23720791,26242446,84639,159731,26242446,72577,31420238,1232,8.57166606377213,281752,14828.0370977116,1789546951.05324,518.345454545454,219995,12293814.8023119
1182,BTC,2014-01-22,23790970,26319600,77154,152984,26319600,65835,31486073,829,7.48957084184735,281944,17184.6689597102,1789546951.05324,447.261780104712,171825,12298614.8023119
1182,BTC,2014-01-23,23859306,26389759,70159,150313,26389759,63576,31549649,964,8.06590586879404,282121,15744.2275463188,1789546951.05324,488.181818181818,185492,12303039.8023119
1182,BTC,2014-01-24,23922052,26460224,70465,142623,26460224,65600,31615249,1124,11.4005100227244,282310,18353.3286814957,1941427190.51141,454.324468085106,170937,12307764.8023119
1182,BTC,2014-01-25,23977739,26519251,59027,126974,26519251,53864,31669113,847,8.61020855619393,282475,18066.8147148066,2193847870.17428,521.536585365854,166226,12311889.8023119
1182,BTC,2014-01-26,24033231,26581770,62519,125564,26581770,53582,31722695,850,7.44882569445691,282627,16711.8671444198,2193847870.17428,563.82119205298,178053,12315689.8023119
1182,BTC,2014-01-27,24098491,26659863,78093,170533,26659863,64374,31787069,1464,14.0932694890917,282801,19123.5727343972,2193847870.17428,492.71676300578,187405,12320039.8023119
1182,BTC,2014-01-28,24174704,26741308,81445,158238,26741308,65762,31852831,1158,9.85933422064019,282955,16792.7785155804,2193847870.17428,561.104575163399,215825,12323889.8023119
1182,BTC,2014-01-29,24236810,26811866,70558,141296,26811866,59682,31912513,846,8.13519745981368,283107,16639.9419107007,2193847870.17428,566.258278145695,192529,12327689.8023119
1182,BTC,2014-01-30,24307185,26888596,76730,151799,26888596,60799,31973312,973,8.73679176642675,283283,19371.4709427599,2193847870.17428,486.411428571429,174558,12332089.8023119
1182,BTC,2014-01-31,24377914,26966944,78348,149077,26966944,60269,32033581,709,6.78940888747117,283467,20071.4522160425,2193847870.17428,469.448087431694,167553,12336689.8023119
1182,BTC,2014-02-01,24441947,27038889,71945,135007,27038889,54838,32088419,953,8.25456068126719,283656,20831.0509737057,2193847870.17428,452.329787234042,151615,12341414.8023119
1182,BTC,2014-02-02,24508091,27107544,68655,135602,27107544,52483,32140902,1052,9.38758104128708,283842,20387.3991033846,2193847870.17428,462.172972972973,158543,12346064.8023119
1182,BTC,2014-02-03,24580177,27188234,80690,172445,27188234,57600,32198502,1051,8.37541063036667,284023,20102.7732207754,2193847870.17428,468.716666666667,180838,12350589.8023119
1182,BTC,2014-02-04,24665251,27279621,91387,169022,27279621,69799,32268301,1199,11.3631218463322,284195,18749.1805644882,2193847870.17428,502.555555555555,221137,12354889.8023119
1182,BTC,2014-02-05,24738185,27358338,78717,156804,27358338,67529,32335830,901,11.8499757724287,284363,20539.8883151337,2468705673.46092,516.215568862276,220943,12359089.8023119
1182,BTC,2014-02-06,24814002,27442610,84272,163366,27442610,70160,32405990,1127,9.47292898621066,284545,23771.9591436073,2621404453.06462,473.618784530387,210022,12363639.8023119
1182,BTC,2014-02-07,24897791,27531182,88572,165386,27531182,70514,32476504,1370,12.3010843911215,284700,20151.1144998105,2621404453.06462,558.720779220779,245162,12367514.8023119
1182,BTC,2014-02-08,24967291,27606808,75626,148081,27606808,65009,32541513,953,8.75966084646295,284882,23695.3931023201,2621404453.06462,475.149171270718,186857,12372064.8023119
1182,BTC,2014-02-09,25023638,27667413,60605,129082,27667413,56579,32598092,857,8.68117149752223,285020,18312.0661528122,2621404453.06462,614.832116788321,210512,12375514.8023119
1182,BTC,2014-02-10,25084187,27741011,73598,171347,27741011,66850,32664942,910,11.9984012679829,285176,20409.5806245564,2621404453.06462,551.645161290323,210632,12379414.8023119
1182,BTC,2014-02-11,25152621,27814602,73591,154760,27814602,67229,32732171,891,10.4331544230008,285340,21413.642184158,2621404453.06462,525.779141104294,199333,12383514.8023119
1182,BTC,2014-02-12,25285802,27884658,70056,215029,27884658,62126,32794297,470,9.96767084486592,285518,23230.3527656785,2621404453.06462,484.661016949152,250903,12387964.8023119
1182,BTC,2014-02-13,25369024,27960501,75843,163940,27960501,67339,32861636,496,9.59777187873818,285696,23242.5450431972,2621404453.06462,484.406779661017,217723,12392414.8023119
1182,BTC,2014-02-14,25453120,28044549,84048,177116,28044549,74889,32936525,540,9.7360757259229,285887,25427.389070894,2621404453.06462,442.784210526316,224743,12397189.8023119
1182,BTC,2014-02-15,25528508,28121555,77006,150318,28121555,61896,32998421,656,15.5688409383183,286074,24294.030505374,2621404453.06462,463.440860215054,180134,12401864.8023119
1182,BTC,2014-02-16,25585106,28180534,58979,127416,28180534,57531,33055952,437,10.9271779466145,286269,25465.0787628654,2621404453.06462,442.128865979381,145525,12406739.8023119
1182,BTC,2014-02-17,25654181,28252286,71752,180256,28252286,60853,33116805,269,8.30725000630996,286424,24588.0353419962,3123016158.76154,545.519480519481,216751,12410614.8023119
1182,BTC,2014-02-18,25730895,28331676,79390,158094,28331676,65408,33182213,215,7.66308283773514,286587,25668.1850043257,3129573174.52229,523.66049382716,225585,12414689.8023119
1182,BTC,2014-02-19,25825713,28430330,98654,177441,28430330,70142,33252355,175,6.57292417970417,286787,31533.2736727821,3129573174.52229,426.261306532663,205789,12419689.8023119
1182,BTC,2014-02-20,25921085,28532805,102475,180978,28532805,71144,33323499,127,7.91854353786264,286964,28287.9018111197,3129573174.52229,475.164772727273,226498,12424114.8023119
1182,BTC,2014-02-21,26020042,28636978,104173,178646,28636978,69390,33392889,49,7.5201316203783,287116,24121.1920004615,3129573174.52229,557.245033112583,255513,12427914.8023119
1182,BTC,2014-02-22,26100491,28720675,83697,155207,28720675,58673,33451562,70,6.84831135108261,287297,28033.9433016856,3129573174.52229,479.469273743017,184971,12432414.8023119
1182,BTC,2014-02-23,26189200,28814313,93638,163496,28814313,60074,33511636,127,6.9137788043225,287464,26040.79130681,3129573174.52229,516.167664670658,210501,12436614.8023119
1182,BTC,2014-02-24,26292209,28927701,113388,215088,28927701,73796,33585432,230,10.518162407835,287655,29848.8632848563,3129573174.52229,450.315789473684,225952,12441389.8023119
1182,BTC,2014-02-25,26407326,29049550,121849,209148,29049550,80082,33665514,160,13.6248722000064,287816,25484.9778357342,3129573174.52229,527.425,281647,12445414.8023119
1182,BTC,2014-02-26,26512791,29160335,110785,201181,29160335,73176,33738690,783,9.53131022363453,288001,28675.7696126933,3129573174.52229,468.737704918033,233025,12450014.8023119
1182,BTC,2014-02-27,26600147,29255564,95229,185098,29255564,70859,33809549,704,8.16828492642995,288188,29478.5145407633,3129573174.52229,455.973262032086,207854,12454714.8023119
1182,BTC,2014-02-28,26703259,29347748,92184,196525,29347748,70290,33879839,632,8.43895852329378,288369,31620.2986842642,3440425943.53871,467.311111111111,236634,12459239.8023119
1182,BTC,2014-03-01,26800238,29447987,100239,181719,29447987,63402,33943241,702,13.0033496711269,288513,27215.3671016051,3815723798.81463,602.174825174825,261243,12462839.8023119
1182,BTC,2014-03-02,26877775,29528892,80905,159491,29528892,56635,33999876,601,9.80499590995939,288653,26872.2657604653,3815723798.81463,609.863309352518,239263,12466339.8023119
1182,BTC,2014-03-03,26986809,29652569,123677,237371,29652569,81264,34081140,1297,13.1514984107019,288801,28209.5563488551,3815723798.81463,580.952380952381,332402,12470039.8023119
1182,BTC,2014-03-04,27112028,29785225,132656,232480,29785225,84600,34165740,1333,12.1371398831839,288950,28401.7906663861,3815723798.81463,577.02027027027,357354,12473764.8023119
1182,BTC,2014-03-05,27224562,29900426,115201,202137,29900426,72392,34238132,881,9.50790135554426,289106,29671.8068403697,3815723798.81463,552.322580645161,283470,12477664.8023119
1182,BTC,2014-03-06,27329084,30010617,110191,195770,30010617,70527,34308659,673,8.92306956672225,289279,33163.98813302,3815723798.81463,494.162790697674,245072,12481989.8023119
1182,BTC,2014-03-07,27426761,30114843,104226,180961,30114843,72345,34381004,1294,34.1526499226101,289445,31592.7595203854,3815723798.81463,518.739393939393,249044,12486139.8023119
1182,BTC,2014-03-08,27516791,30214928,100085,171369,30214928,64590,34445594,1908,24.5523636196671,289613,31833.6275004278,3815723798.81463,514.814371257485,211094,12490339.8023119
1182,BTC,2014-03-09,27598355,30308098,93170,173511,30308098,62161,34507755,655,15.2374061545546,289792,34437.1529461218,3815723798.81463,475.893258426966,199771,12494814.8023119
1182,BTC,2014-03-10,27690584,30401248,93150,208065,30401248,70884,34578639,1172,21.4672273927119,289941,28137.2186389956,3815723798.81463,582.445945945946,278178,12498539.8023119
1182,BTC,2014-03-11,27788796,30498172,96924,190763,30498172,76204,34654843,866,12.9679419242311,290109,32243.5443823916,3815723798.81463,508.269461077844,251411,12502739.8023119
1182,BTC,2014-03-12,27896534,30606128,107956,203507,30606128,76339,34731182,821,13.8696009595565,290291,34451.4235106731,3815723798.81463,475.696132596685,239561,12507289.8023119
1182,BTC,2014-03-13,27992357,30709330,103202,193724,30709330,72805,34803987,772,10.5467895038702,290453,34282.9713628125,4218033170.16176,528.434782608696,256820,12511339.8023119
1182,BTC,2014-03-14,28096062,30791483,82153,192292,30791483,70615,34874602,517,8.90332274968449,290586,28224.3824113723,4250217919.86954,646.765151515151,305855,12514664.8023119
1182,BTC,2014-03-15,28163358,30858916,67433,146802,30858916,60308,34934910,459,9.7045726158183,290751,35103.2515189355,4250217919.86954,520.024390243903,186097,12518789.8023119
1182,BTC,2014-03-16,28220143,30921013,62097,140539,30921013,59332,34994242,415,6.56036267413723,290922,36830.1663245609,4250217919.86954,495.641176470588,167490,12523064.8023119
1182,BTC,2014-03-17,28291774,31005872,84859,189485,31005872,66396,35060638,618,8.3672240111445,291083,34524.3739840193,4250217919.86954,528.74375,211539,12527089.8023119
1182,BTC,2014-03-18,28351929,31073430,67558,142940,31073430,54142,35114780,1370,48.8647305498195,291229,31232.3367847804,4250217919.86954,584.475862068966,175493,12530739.8023119
1182,BTC,2014-03-19,28415315,31149856,76426,165215,31149856,73804,35188584,1163,15.000624118601,291389,34313.8695257766,4250217919.86954,531.987421383648,222877,12534739.8023119
1182,BTC,2014-03-20,28492358,31229472,79616,166798,31229472,71002,35259586,935,9.63895076072167,291566,37392.0563550831,4250217919.86954,488.193181818182,216654,12539164.8023119
1182,BTC,2014-03-21,28596416,31332750,103278,189841,31332750,73091,35332677,837,8.25768395178627,291752,39838.2822796021,4250217919.86954,458.216216216216,234227,12543814.8023119
1182,BTC,2014-03-22,28683807,31414888,82138,169600,31414888,66673,35399350,517,6.31327588677936,291922,36702.8153017639,4250217919.86954,497.360946745562,243031,12548064.8023119
1182,BTC,2014-03-23,28749820,31484375,69487,149508,31484375,57811,35457161,433,5.836854053787,292136,46091.8763354967,4250217919.86954,396.046948356807,144914,12553414.8023119
1182,BTC,2014-03-24,28829484,31574033,89658,192799,31574033,70983,35528144,884,9.52064875090078,292324,39811.5221207777,4270341395.11783,460.695187165775,217301,12558114.8023119
1182,BTC,2014-03-25,28913739,31663814,89781,166919,31663814,71883,35600027,595,7.62447936912024,292481,39220.3239396951,5006860589.2054,548.294871794872,246535,12562039.8023119
1182,BTC,2014-03-26,28999900,31755368,91554,169352,31755368,68315,35668342,676,7.63256497280773,292640,40098.6604136573,5006860589.2054,536.284810126582,243738,12566014.8023119
1182,BTC,2014-03-27,29101694,31862675,107307,183144,31862675,71719,35740061,946,11.0565518678041,292813,42855.1238313735,5006860589.2054,501.790697674418,238861,12570339.8023119
1182,BTC,2014-03-28,29197997,31965947,103272,182894,31965947,67079,35807140,1057,12.3392227293317,292987,43293.8942176708,5006860589.2054,496.705202312139,220066,12574689.8023119
1182,BTC,2014-03-29,29264298,32039628,73681,145204,32039628,53270,35860410,518,7.5438337543884,293163,43459.6865466941,5006860589.2054,494.810344827586,172981,12579064.8023119
1182,BTC,2014-03-30,29320038,32106735,67107,167307,32106735,56853,35917263,613,10.5815185440088,293303,34827.4187960679,5006860589.2054,617.453237410072,232450,12582564.8023119
1182,BTC,2014-03-31,29410912,32202106,95371,170345,32202106,65042,35982305,794,11.5393079226509,293482,44834.5483086839,5006860589.2054,479.63687150838,209477,12587064.8023119
1182,BTC,2014-04-01,29505940,32303993,101887,179678,32303993,64136,36046441,788,10.7130615080742,293653,42399.0561882773,5006860589.2054,507.188235294118,218021,12591339.8023119
1182,BTC,2014-04-02,29601092,32404900,100907,179053,32404900,66913,36113354,771,11.2961740999244,293851,49117.1781022307,5006860589.2054,437.816326530612,196244,12596264.8023119
1182,BTC,2014-04-03,29686406,32475911,71011,169394,32475911,67024,36180378,640,11.7720060324321,294054,50702.3787394888,5006860589.2054,424.128078817734,175201,12601364.8023119
1182,BTC,2014-04-04,29786323,32580170,104259,178171,32580170,65692,36246070,476,10.2070995153809,294249,48544.7029525482,5006860589.2054,442.979381443299,198059,12606239.8023119
1182,BTC,2014-04-05,29871014,32665150,84980,153923,32665150,55795,36301865,545,13.1132015392964,294420,47355.8992229964,5560039346.47694,504.270588235294,192057,12610514.8023119
1182,BTC,2014-04-06,29940615,32748427,83277,183722,32748427,50010,36351875,516,8.87115674144991,294571,45924.3274547758,6119726089.12815,572.333333333334,212449,12614289.8023119
1182,BTC,2014-04-07,30026129,32836516,88089,158680,32836516,65810,36417685,451,7.11127837540191,294722,46655.2690609136,6119726089.12815,563.366666666667,243702,12618064.8023119
1182,BTC,2014-04-08,30111247,32926856,90340,165195,32926856,67841,36485526,378,6.78131280784187,294856,41336.36573646,6119726089.12815,635.857142857143,292680,12621414.8023119
1182,BTC,2014-04-09,30210178,33027566,100710,178878,33027566,65153,36550679,610,9.31085103168066,295017,48974.5399572067,6119726089.12815,536.6875,243824,12625439.8023119
1182,BTC,2014-04-10,30307894,33129721,102155,182885,33129721,68027,36618706,614,12.2337938413515,295172,47488.0580692145,6119726089.12815,553.487012987013,254416,12629314.8023119
1182,BTC,2014-04-11,30400752,33226703,96982,169504,33226703,65732,36684438,802,11.9429104493084,295341,51456.224825865,6119726089.12815,510.803571428572,223737,12633539.8023119
1182,BTC,2014-04-12,30472124,33297496,70793,132126,33297496,47740,36732178,532,8.48399340872539,295502,49338.820992601,6119726089.12815,532.725,170046,12637564.8023119
1182,BTC,2014-04-13,30535396,33372983,75487,172558,33372983,51168,36783346,422,8.11828881133247,295689,56969.3917714934,6119726089.12815,461.370967741935,162342,12642239.8023119
1182,BTC,2014-04-14,30636891,33477553,104570,183167,33477553,70219,36853565,645,8.80692687107136,295882,58671.0593083731,6119726089.12815,447.989583333333,216129,12647064.8023119
1182,BTC,2014-04-15,30741913,33576958,99405,198889,33576958,72809,36926374,690,9.19651063179332,296064,55919.5100592916,6119726089.12815,470.033149171271,241621,12651614.8023119
1182,BTC,2014-04-16,30839581,33668046,91088,184731,33668046,68594,36994968,896,11.7936362726652,296223,48349.9708855164,6119726089.12815,543.620253164557,271066,12655589.8023119
1182,BTC,2014-04-17,30920180,33749405,81359,157382,33749405,65190,37060158,699,12.4875486729873,296392,53410.992335934,6328150816.81474,508.869047619047,223713,12659814.8023119
1182,BTC,2014-04-18,30997123,33829682,80277,149204,33829682,56996,37117154,624,13.7144110519607,296552,55361.5018712073,6978842649.59238,541.421383647799,205560,12663814.8023119
1182,BTC,2014-04-19,31072952,33904161,74479,140843,33904161,53515,37170669,392,8.59750661833935,296711,54898.5272197717,6978842649.59238,545.987341772152,193319,12667789.8023119
1182,BTC,2014-04-20,31132219,33972592,68431,164119,33972592,49043,37219712,466,8.54568793473646,296889,62221.5240198377,6978842649.59238,481.728813559322,169593,12672239.8023119
1182,BTC,2014-04-21,31203608,34045754,73162,141995,34045754,58110,37277822,871,12.5106394673519,297060,61232.2381300453,6978842649.59238,489.511764705882,190698,12676514.8023119
1182,BTC,2014-04-22,31298307,34149398,103644,183454,34149398,78042,37355864,719,11.3569276437753,297214,53118.7449403044,6978842649.59238,564.281045751634,288122,12680364.8023119
1182,BTC,2014-04-23,31374186,34233201,83803,155833,34233201,73954,37429818,623,9.19803049341374,297379,59141.4585866407,6978842649.59238,506.817073170732,242034,12684489.8023119
1182,BTC,2014-04-24,31457934,34317519,84318,166383,34317519,72694,37502512,275,6.08385377153947,297530,52953.679852889,6978842649.59238,566.04,279837,12688264.8023119
1182,BTC,2014-04-25,31550825,34415871,98352,181605,34415871,72650,37575162,492,7.67937213290915,297712,63277.3807512561,6978842649.59238,473.690607734807,226678,12692814.8023119
1182,BTC,2014-04-26,31617472,34486644,70773,135225,34486644,52175,37627337,240,6.49403031393234,297875,56668.7123241162,6978842649.59238,528.932098765432,180042,12696889.8023119
1182,BTC,2014-04-27,31678769,34552850,66206,171822,34552850,52629,37679966,176,5.7887229344656,298052,61816.3412951904,6978842649.59238,484.886363636364,181005,12701314.8023119
1182,BTC,2014-04-28,31762452,34643596,90746,167473,34643596,64546,37744512,349,9.02991101333313,298204,53026.9119494496,6978842649.59238,565.258278145695,238974,12705114.8023119
1182,BTC,2014-04-29,31853812,34734966,91370,169230,34734966,65057,37809569,390,8.65940501005057,298376,59865.5130175702,7026656894.56903,504.117647058824,227226,12709389.8023119
1182,BTC,2014-04-30,31941540,34824757,89791,166570,34824757,63638,37873207,347,7.67805094028002,298512,54387.1550492929,8000872135.96816,631.830882352941,270333,12712814.8023119
1182,BTC,2014-05-01,32020538,34909158,84401,154507,34909158,59658,37932865,374,7.52696295094556,298688,70475.5678445272,8000872135.96816,487.594285714286,191978,12717214.8023119
1182,BTC,2014-05-02,32091665,34985130,75972,143673,34985130,59981,37992846,451,10.9820710209351,298849,65156.3977312494,8000872135.96816,527.4,211548,12721239.8023119
1182,BTC,2014-05-03,32143471,35039878,54748,116971,35039878,54157,38047003,427,10.2921683231662,298991,57826.8181628614,8000872135.96816,594.248226950355,203527,12724789.8023119
1182,BTC,2014-05-04,32191147,35094681,54803,156437,35094681,51769,38098772,282,8.28427153384979,299142,60729.3215419859,8000872135.96816,565.846666666667,201563,12728564.8023119
1182,BTC,2014-05-05,32261716,35171759,77078,148058,35171759,67763,38166535,427,9.35015689349379,299267,51428.0615082874,8000872135.96816,668.185483870968,299039,12731689.8023119
1182,BTC,2014-05-06,32348664,35264615,92856,168302,35264615,77228,38243763,482,8.90095804748938,299461,76946.2646596895,8000872135.96816,446.59067357513,219220,12736539.8023119
1182,BTC,2014-05-07,32433553,35354946,90331,161797,35354946,69825,38313588,659,12.0311057195865,299620,63567.5373229385,8000872135.96816,540.582278481013,244229,12740514.8023119
1182,BTC,2014-05-08,32526431,35449276,94330,166681,35449276,68937,38382525,823,19.5719937382564,299787,66730.6759371397,8000872135.96816,514.957831325301,231275,12744689.8023119
1182,BTC,2014-05-09,32612556,35537437,88161,162487,35537437,66293,38448818,692,18.9325327301097,299957,67327.8244252562,8000872135.96816,510.390532544379,217087,12748939.8023119
1182,BTC,2014-05-10,32680991,35610286,72849,135415,35610286,56416,38505234,626,12.0549061610336,300136,70975.8665710843,8000872135.96816,484.157303370787,170755,12753414.8023119
1182,BTC,2014-05-11,32732805,35671492,61206,165291,35671492,52590,38557824,392,8.55720254666362,300288,62532.5215859747,8000872135.96816,549.529801324504,217980,12757214.8023119
1182,BTC,2014-05-12,32807429,35749541,78049,154710,35749541,74418,38632242,465,7.44286372494571,300452,68191.8523370561,8359564501.50484,526.515337423313,256592,12761314.8023119
1182,BTC,2014-05-13,32879070,35824152,74611,149382,35824152,69357,38701599,494,9.78039411834004,300614,72238.2415443183,8853416309.1278,526.385093167702,231819,12765364.8023119
1182,BTC,2014-05-14,32961217,35910115,85963,160753,35910115,69808,38771407,630,10.444354778653,300764,66555.5973631586,8853416309.1278,571.328859060403,263311,12769114.8023119
1182,BTC,2014-05-15,33057957,36011370,101255,177219,36011370,74893,38846300,784,11.0378488832171,300935,75333.2715210302,8853416309.1278,504.758823529412,247333,12773389.8023119
1182,BTC,2014-05-16,33133083,36084151,72781,155501,36084151,65433,38911733,555,9.9604393076197,301116,79330.1270413872,8853416309.1278,479.327777777778,210022,12777914.8023119
1182,BTC,2014-05-17,33210046,36151109,66958,148243,36151109,53511,38965244,538,9.09397927271346,301289,76326.2841550168,8853416309.1278,498.191860465116,189017,12782239.8023119
1182,BTC,2014-05-18,33276161,36220469,69360,177611,36220469,49912,39015156,243,5.4890615296566,301461,76101.0010118284,8853416309.1278,499.666666666667,185464,12786539.8023119
1182,BTC,2014-05-19,33381360,36305181,84712,185478,36305181,64094,39079250,402,8.26003660546151,301629,74666.0391241575,8853416309.1278,509.269461077844,240639,12790739.8023119
1182,BTC,2014-05-20,33484762,36408275,103094,191009,36408275,71520,39150770,1127,20.9750018961565,301806,77912.1913103081,8853416309.1278,488.051136363636,248944,12795164.8023119
1182,BTC,2014-05-21,33561272,36487698,79423,157842,36487698,68905,39219675,674,10.5115437715237,301981,77683.4043274164,8853416309.1278,489.488505747127,236798,12799539.8023119
1182,BTC,2014-05-22,33643254,36573609,85911,162939,36573609,73343,39293018,901,10.552045051451,302153,75896.6982532846,8853416309.1278,501.011695906433,244774,12803839.8023119
1182,BTC,2014-05-23,33735284,36671428,97819,176289,36671428,72810,39365828,1310,17.1337708186289,302318,72467.5424142354,8853416309.1278,524.719512195122,251024,12807964.8023119
1182,BTC,2014-05-24,33790186,36730068,58640,124971,36730068,52872,39418700,660,17.3141464145497,302472,76151.0464967842,9612949942.52432,542.176470588235,192923,12811814.8023119
1182,BTC,2014-05-25,33861491,36811782,81714,187261,36811782,57566,39476266,921,14.6112292627285,302633,85155.9231078429,10455720138.4848,527.35,219349,12815839.8023119
1182,BTC,2014-05-26,33948368,36902200,90418,170984,36902200,67007,39543273,759,11.3534201848771,302791,82293.2889790904,10455720138.4848,545.694267515924,249870,12819789.8023119
1182,BTC,2014-05-27,34043139,37000906,98706,179094,37000906,68524,39611797,1063,13.8902756617439,302927,70364.2350898853,10455720138.4848,638.207407407407,296760,12823189.8023119
1182,BTC,2014-05-28,34147807,37107326,106420,184291,37107326,72338,39684135,1106,12.0169529041854,303096,88305.4014930031,10455720138.4848,508.541666666667,249080,12827414.8023119
1182,BTC,2014-05-29,34238721,37201358,94032,171725,37201358,65362,39749497,825,10.0932352914297,303237,73136.6958322158,10455720138.4848,614.014285714286,271797,12830939.8023119
1182,BTC,2014-05-30,34311158,37278795,77437,152353,37278795,65127,39814624,984,14.2754580454581,303404,86647.6587408655,10455720138.4848,518.271084337349,220130,12835114.8023119
1182,BTC,2014-05-31,34383016,37353084,74289,146489,37353084,52172,39866796,831,11.2729080704573,303551,76459.6910021512,10455720138.4848,587.328767123288,208395,12838789.8023119
1182,BTC,2014-06-01,34458991,37438133,85049,191158,37438133,55222,39922018,1036,13.4493106901353,303726,90990.5540944425,10455720138.4848,493.534482758621,205033,12843164.8023119
1182,BTC,2014-06-02,34549876,37531876,93743,175331,37531876,64434,39986452,1001,14.7792543223208,303919,100616.612812911,10455720138.4848,446.317708333333,199626,12847989.8023119
1182,BTC,2014-06-03,34650413,37637148,105272,187099,37637148,69695,40056147,1116,13.0138326406718,304098,92406.5563901672,10455720138.4848,485.971751412429,234821,12852439.8023119
1182,BTC,2014-06-04,34736803,37731423,94275,171277,37731423,65054,40121201,1134,15.9005517495527,304278,93746.0793176662,10455720138.4848,479.027777777778,204431,12856964.8023119
1182,BTC,2014-06-05,34835948,37831585,100162,183223,37831585,66945,40188146,1114,14.2019626760203,304430,81393.1211757807,10584091695.5657,558.503311258278,262957,12860764.8023119
1182,BTC,2014-06-06,34930638,37922743,91158,174192,37922743,62342,40250488,797,16.8334946341763,304569,82053.8002821689,11756551916.904,615.376811594203,273251,12864239.8023119
1182,BTC,2014-06-07,34999421,37996862,74119,140292,37996862,51210,40301698,721,11.8442723073339,304724,91208.5592041804,11756551916.904,553.610389610389,184429,12868114.8023119
1182,BTC,2014-06-08,35063005,38068274,71412,173346,38068274,48308,40350006,693,15.9888871886257,304860,80371.28821048,11756551916.904,628.259259259259,228370,12871514.8023119
1182,BTC,2014-06-09,35150282,38154302,86028,166162,38154302,59875,40409881,388,6.50311762906655,305016,90820.7729473221,11756551916.904,555.974193548387,232621,12875414.8023119
1182,BTC,2014-06-10,35244862,38242875,88573,178913,38242875,63316,40473197,728,9.40356051394103,305183,97985.8667041552,11756551916.904,515.319277108434,239050,12879589.8023119
1182,BTC,2014-06-11,35335501,38334399,91524,173921,38334399,62827,40536024,799,8.49785777363602,305329,85214.5119825435,11756551916.904,592.551724137931,251775,12883239.8023119
1182,BTC,2014-06-12,35425241,38425410,91011,175286,38425410,64744,40600768,867,17.1668043515615,305501,100365.861042168,11756551916.904,503.099415204679,230417,12887539.8023119
1182,BTC,2014-06-13,35516639,38515997,90587,173779,38515997,64739,40665507,860,11.532948103157,305664,95150.9145329856,11756551916.904,530.672839506172,231058,12891614.8023119
1182,BTC,2014-06-14,35591685,38592765,76768,149472,38592765,53596,40719103,726,8.59458379855064,305842,103554.046154294,11756551916.904,487.610169491525,175539,12896064.8023119
1182,BTC,2014-06-15,35648372,38661511,68746,176498,38661511,53916,40773019,600,8.29097873144206,306032,113324.155812055,11756551916.904,445.571428571429,171801,12900814.8023119
1182,BTC,2014-06-16,35743137,38756567,95056,177681,38756567,68262,40841281,784,10.8590513242917,306220,111968.067749783,11756551916.904,450.967914438503,216450,12905514.8023119
1182,BTC,2014-06-17,35837124,38857783,101216,185057,38857783,70077,40911358,813,6.89864793556103,306404,107375.380241231,11756551916.904,470.256830601093,214619,12910114.8023119
1182,BTC,2014-06-18,35923108,38948101,90318,168037,38948101,63888,40975246,725,8.60395714275404,306562,103824.608636811,13171043650.3748,544.853503184714,234856,12914064.8023119
1182,BTC,2014-06-19,36001519,39027247,79146,158754,39027247,62454,41037700,922,11.5857505352551,306729,112050.322290618,13462580114.5253,516.030120481928,226365,12918239.8023119
1182,BTC,2014-06-20,36077275,39108405,81158,155275,39108405,57381,41095081,818,9.81416298744166,306915,125386.207598676,13462580114.5253,461.145945945946,178434,12922889.8023119
1182,BTC,2014-06-21,36154459,39187700,79295,153731,39187700,51173,41146254,636,9.02677284400172,307101,125264.337990026,13462580114.5253,461.594594594595,168137,12927539.8023119
1182,BTC,2014-06-22,36218644,39263419,75719,184083,39263419,50104,41196358,747,10.5389624557435,307281,122964.204949309,13462580114.5253,470.22905027933,176881,12932039.8023119
1182,BTC,2014-06-23,36295885,39342485,79066,163327,39342485,60216,41256574,775,10.3524660425477,307457,118061.940442923,13462580114.5253,489.754285714285,204360,12936439.8023119
1182,BTC,2014-06-24,36388798,39435978,93493,175687,39435978,64883,41321457,750,13.5995791661048,307645,126603.721389633,13462580114.5253,456.711229946524,202052,12941139.8023119
1182,BTC,2014-06-25,36480271,39531658,95680,175370,39531658,64397,41385854,623,7.81575306441822,307832,125459.555591497,13462580114.5253,460.876344086022,203568,12945814.8023119
1182,BTC,2014-06-26,36561317,39617278,85620,159179,39617278,61432,41447286,557,8.35600747131755,308003,114791.872275876,13462580114.5253,503.705882352941,205764,12950089.8023119
1182,BTC,2014-06-27,36649574,39709090,91812,167889,39709090,62966,41510252,577,7.7440848391065,308200,131932.280524873,13462580114.5253,438.265306122449,184046,12955014.8023119
1182,BTC,2014-06-28,36721628,39781404,72314,143713,39781404,54392,41564644,526,6.23300432345952,308382,121638.591538856,13462580114.5253,475.353591160221,178338,12959564.8023119
1182,BTC,2014-06-29,36778280,39848335,66931,173601,39848335,49094,41613738,411,7.18726448984703,308539,126114.308698986,15429083780.8342,525.455128205128,196855,12963489.8023119
1182,BTC,2014-06-30,36870186,39944222,95887,182775,39944222,70231,41683969,848,9.77180657468739,308671,111335.652866955,16818461371.1611,648.801526717557,325750,12966789.8023119
1182,BTC,2014-07-01,36970598,40045791,101569,186234,40045791,69443,41753412,1098,12.8386130540669,308804,113518.493787479,16818461371.1611,636.325757575758,329402,12970114.8023119
1182,BTC,2014-07-02,37066758,40143866,98075,182040,40143866,66728,41820140,1166,14.1470039520972,308941,115395.027215204,16818461371.1611,625.977941176471,291681,12973539.8023119
1182,BTC,2014-07-03,37145775,40227767,83901,161269,40227767,62849,41882989,899,9.62439282322821,309080,117536.573499055,16818461371.1611,614.572463768116,267267,12977014.8023119
1182,BTC,2014-07-04,37208888,40297777,70010,144728,40297777,59494,41942483,640,6.55419011164252,309246,140108.294036525,16818461371.1611,515.563636363637,197773,12981164.8023119
1182,BTC,2014-07-05,37261708,40358321,60544,128226,40358321,49954,41992437,707,8.44667933419246,309398,128554.291551671,16818461371.1611,561.900662251655,184142,12984964.8023119
1182,BTC,2014-07-06,37325585,40435597,77276,183781,40435597,52139,42044576,536,7.16747006272119,309540,118814.070432706,16818461371.1611,607.964539007092,232487,12988514.8023119
1182,BTC,2014-07-07,37412875,40529523,93926,185975,40529523,64686,42109262,666,7.27077900054061,309690,127481.125837024,16818461371.1611,566.630872483222,254280,12992264.8023119
1182,BTC,2014-07-08,37522494,40642015,112492,214025,40642015,70117,42179379,397,5.2609773270177,309840,126201.59106243,16818461371.1611,572.375838926175,285394,12996014.8023119
1182,BTC,2014-07-09,37616684,40741921,99906,184688,40741921,68518,42247897,534,6.82130344237748,310006,139725.587708223,16818461371.1611,516.975757575758,256588,13000164.8023119
1182,BTC,2014-07-10,37711157,40839899,97978,171201,40839899,64605,42312502,703,8.01246070433976,310155,127075.583337614,16818461371.1611,568.439189189189,253822,13003889.8023119
1182,BTC,2014-07-11,37803549,40934708,94809,170509,40934708,59077,42371579,535,7.17255950198961,310311,130326.911203787,16818461371.1611,554.258064516129,233474,13007789.8023119
1182,BTC,2014-07-12,37866187,41005268,70560,153835,41005268,53454,42425033,597,8.78080468271673,310468,131458.553377835,16834953587.9556,550.025641025641,193903,13011714.8023119
1182,BTC,2014-07-13,37936638,41086033,80765,188417,41086033,52417,42477450,663,9.20704745833146,310628,138396.233499359,17336316978.5078,538.012578616352,212885,13015714.8023119
1182,BTC,2014-07-14,38015921,41171105,85072,162448,41171105,62761,42540211,688,8.10583334525247,310763,116396.343176325,17336316978.5078,639.701492537314,263035,13019089.8023119
1182,BTC,2014-07-15,38111258,41271354,100249,179159,41271354,72316,42612527,832,7.8106066435515,310922,138521.688516447,17336316978.5078,537.525316455696,258661,13023064.8023119
1182,BTC,2014-07-16,38195165,41362473,91119,167301,41362473,65571,42678098,857,9.1886540769424,311066,124119.89004111,17336316978.5078,599.895104895105,259492,13026664.8023119
1182,BTC,2014-07-17,38287496,41456389,93916,175156,41456389,66233,42744331,683,7.06619432762324,311238,149045.083778413,17336316978.5078,499.573099415204,226245,13030964.8023119
1182,BTC,2014-07-18,38380853,41547013,90624,170514,41547013,64062,42808393,717,8.03011491789376,311410,147840.581168079,17336316978.5078,503.643274853801,224514,13035264.8023119
1182,BTC,2014-07-19,38458106,41630911,83898,151927,41630911,59553,42867946,285,5.17351798515323,311587,151882.999283946,17336316978.5078,490.238636363637,191394,13039689.8023119
1182,BTC,2014-07-20,38523142,41710738,79827,187545,41710738,52001,42919947,355,5.45954633874733,311742,134878.231208495,17336316978.5078,552.045454545455,214038,13043564.8023119
1182,BTC,2014-07-21,38605140,41792293,81555,164110,41792293,64190,42984137,417,6.98653352132326,311897,135376.647849994,17336316978.5078,550.012987012987,243837,13047439.8023119
1182,BTC,2014-07-22,38691546,41881436,89143,166622,41881436,66858,43050995,346,5.7600463210108,312039,122545.369995624,17336316978.5078,607.602836879433,271551,13050989.8023119
1182,BTC,2014-07-23,38786687,41981959,100523,176845,41981959,66883,43117878,369,6.19963817450085,312185,125669.785316233,17336316978.5078,592.496551724138,260616,13054639.8023119
1182,BTC,2014-07-24,38877941,42075266,93307,177647,42075266,66276,43184154,575,8.10220407835763,312328,122910.917460689,17336316978.5078,605.795774647887,270031,13058214.8023119
1182,BTC,2014-07-25,38970505,42171602,96336,176905,42171602,61498,43245652,632,8.06228982421282,312491,140741.904568069,17439393634.6896,532.191358024691,230668,13062289.8023119
1182,BTC,2014-07-26,39038453,42244006,72404,138529,42244006,56333,43301985,286,5.48942819861715,312625,127053.142807198,18736441558.3102,633.375939849624,228282,13065639.8023119
1182,BTC,2014-07-27,39099552,42313851,69845,183909,42313851,51991,43353976,210,5.03055364949607,312778,144876.823934032,18736441558.3102,555.453947368421,218658,13069464.8023119
1182,BTC,2014-07-28,39190501,42407895,94044,174474,42407895,64744,43418720,582,7.56745767747838,312928,139039.949867427,18736441558.3102,578.771812080537,254153,13073214.8023119
1182,BTC,2014-07-29,39276565,42498999,91104,166270,42498999,61607,43480327,560,8.03610306417209,313077,142173.997289972,18736441558.3102,566.013513513513,241562,13076939.8023119
1182,BTC,2014-07-30,39376768,42602601,103602,182612,42602601,66153,43546480,432,6.35931022916587,313249,161342.97551756,18736441558.3102,498.766081871345,230701,13081239.8023119
1182,BTC,2014-07-31,39474830,42696900,94299,180431,42696900,69761,43616241,424,6.12819372571637,313403,145246.764954496,18736441558.3102,554.039215686275,265432,13085089.8023119
1182,BTC,2014-08-01,39563800,42791362,94462,174628,42791362,67915,43684156,423,6.85952382682544,313560,147725.288101575,18736441558.3102,544.74358974359,243288,13089014.8023119
1182,BTC,2014-08-02,39634762,42865755,74393,142057,42865755,54989,43739145,282,7.080527448178,313723,153376.347462733,18736441558.3102,524.672839506173,190202,13093089.8023119
1182,BTC,2014-08-03,39686677,42928330,62575,171180,42928330,53621,43792766,405,7.85559906242237,313877,145722.950038025,18736441558.3102,552.228758169935,198484,13096939.8023119
1182,BTC,2014-08-04,39771883,43005814,77484,175599,43005814,67847,43860613,360,6.32049501857783,314005,119968.485068699,18736441558.3102,670.779527559055,301305,13100139.8023119
1182,BTC,2014-08-05,39877083,43117995,112181,199364,43117995,72823,43933436,393,8.50000910105763,314140,130858.964378816,18736441558.3102,614.955223880597,323926,13103514.8023119
1182,BTC,2014-08-06,39987726,43231987,113992,204290,43231987,80402,44013838,443,5.78911225677334,314304,151927.931350711,18736441558.3102,529.674846625767,287597,13107614.8023119
1182,BTC,2014-08-07,40082354,43327196,95209,179568,43327196,69913,44083751,339,6.20622253746285,314464,149894.122539343,18736441558.3102,536.861635220126,249787,13111614.8023119
1182,BTC,2014-08-08,40177175,43425241,98045,173912,43425241,68297,44152048,323,4.96125917663909,314626,152800.731568903,19534776726.3349,549.089171974522,252674,13115564.8023119
1182,BTC,2014-08-09,40253364,43506294,81053,151357,43506294,60599,44212647,291,5.98169003750144,314804,179727.803766614,19729645940.5771,471.480662983425,191162,13120114.8023119
1182,BTC,2014-08-10,40326447,43586136,79842,199447,43586136,57913,44270560,374,6.27030327195794,314981,175645.931496697,19729645940.5771,482.4375,206576,13124539.8023119
1182,BTC,2014-08-11,40430143,43694536,108400,196074,43694536,75575,44346135,559,7.39752417879987,315163,180332.165238152,19729645940.5771,469.900552486188,247431,13129089.8023119
1182,BTC,2014-08-12,40536960,43807614,113078,200288,43807614,76982,44423117,707,9.58441419268491,315337,170297.339140408,19729645940.5771,497.589595375723,256543,13133439.8023119
1182,BTC,2014-08-13,40644948,43920402,112788,197243,43920402,75738,44498855,693,9.35377525249584,315482,142673.55549198,19729645940.5771,593.930555555556,316760,13137064.8023119
1182,BTC,2014-08-14,40750328,44025845,105443,198105,44025845,79082,44577937,505,9.44919792534028,315662,178564.188000264,19729645940.5771,474.553072625698,259322,13141564.8023119
1182,BTC,2014-08-15,40852473,44126601,100756,194486,44126601,73193,44651130,501,10.5404071768923,315827,162986.714226656,19729645940.5771,519.908536585366,258699,13145689.8023119
1182,BTC,2014-08-16,40951856,44225626,99025,182932,44225626,67974,44719104,500,9.91536183524142,315985,156205.836630708,19729645940.5771,542.477707006369,310691,13149639.8023119
1182,BTC,2014-08-17,41018843,44306911,81285,200734,44306911,60223,44779327,453,8.33961039170251,316155,166799.677470625,19729645940.5771,508.023668639053,212323,13153889.8023119
1182,BTC,2014-08-18,41117401,44411400,104489,194400,44411400,72758,44852085,932,13.972717096744,316353,198821.160323221,19729645940.5771,426.203045685279,210609,13158839.8023119
1182,BTC,2014-08-19,41220452,44519156,107756,187539,44519156,74740,44926825,466,8.44796749670511,316539,189340.974270562,20349111933.8585,461.594594594595,221730,13163489.8023119
1182,BTC,2014-08-20,41320070,44627892,108736,187324,44627892,73842,45000667,448,7.63812662409333,316708,199638.313152351,23844670038.8033,512.988095238096,243004,13167714.8023119
1182,BTC,2014-08-21,41418594,44733968,106076,193876,44733968,73164,45073831,521,10.523218772259,316873,195227.078519297,23844670038.8033,524.579268292683,251583,13171839.8023119
1182,BTC,2014-08-22,41513820,44834278,100310,182565,44834278,66998,45140829,582,47.3849260935649,317030,185965.361053301,23844670038.8033,550.705128205128,247983,13175764.8023119
1182,BTC,2014-08-23,41591398,44915731,81453,150754,44915731,57593,45198422,336,12.2339687112878,317192,192591.598917127,23844670038.8033,531.757763975155,195526,13179814.8023119
1182,BTC,2014-08-24,41665378,44999674,83943,206426,44999674,56695,45255117,241,7.32997147699585,317338,173015.546145042,23844670038.8033,591.924137931034,242154,13183464.8023119
1182,BTC,2014-08-25,41760636,45098036,98362,180475,45098036,69894,45325011,309,13.6201067903372,317475,162941.103757387,23844670038.8033,628.52205882353,290531,13186889.8023119
1182,BTC,2014-08-26,41860867,45204992,106956,190296,45204992,72660,45397671,461,24.6145561475933,317648,205923.211279951,23844670038.8033,497.331395348837,244666,13191214.8023119
1182,BTC,2014-08-27,41963763,45307481,102489,188465,45307481,74581,45472252,473,19.2990587010568,317817,200298.366715127,23844670038.8033,511.297619047619,253810,13195439.8023119
1182,BTC,2014-08-28,42053907,45406004,98523,193290,45406004,68628,45540880,384,10.6850617285445,317990,207906.490600156,23844670038.8033,492.587209302326,224507,13199764.8023119
1182,BTC,2014-08-29,42140167,45495213,89209,166081,45495213,68614,45609494,328,8.65412778894351,318160,201916.086448389,23844670038.8033,507.201183431952,211672,13204014.8023119
1182,BTC,2014-08-30,42217434,45575638,80425,166245,45575638,61214,45670708,258,9.76841176417503,318342,215416.456921597,23844670038.8033,475.414364640884,186332,13208564.8023119
1182,BTC,2014-08-31,42283545,45653525,77887,191466,45653525,57755,45728463,270,8.93024323055909,318530,228595.488548295,23901860903.6457,449.080213903743,179603,13213264.8023119
1182,BTC,2014-09-01,42362622,45745424,91899,191812,45745424,70383,45798846,442,10.0602095984802,318666,185597.740834869,27428630902.2579,634.733333333333,296362,13216664.8023119
1182,BTC,2014-09-02,42462607,45843977,98553,189218,45843977,71909,45870755,367,7.98600328657567,318813,201891.499367204,27428630902.2579,583.506849315069,282462,13220339.8023119
1182,BTC,2014-09-03,42552352,45938121,94144,172519,45938121,71868,45942623,456,6.98963916328672,318982,231910.618859555,27428630902.2579,507.97619047619,238546,13224564.8023119
1182,BTC,2014-09-04,42647162,46040118,101997,179428,46040118,70810,46013433,289,6.38290906805352,319140,215830.704760924,27428630902.2579,545.821656050955,249913,13228514.8023119
1182,BTC,2014-09-05,42741431,46141771,101653,184257,46141771,68038,46081471,365,7.26143516728931,319285,198102.700727443,27428630902.2579,594.666666666667,272765,13232139.8023119
1182,BTC,2014-09-06,42815856,46224164,82393,156338,46224164,63369,46144840,178,4.99196097264577,319464,247477.965119045,27428630902.2579,476.022471910112,195681,13236614.8023119
1182,BTC,2014-09-07,42880922,46315764,91600,234710,46315764,60352,46205192,236,6.16934064089177,319619,211632.4622706,27428630902.2579,556.64935064935,252389,13240489.8023119
1182,BTC,2014-09-08,42981188,46421139,105375,193169,46421139,75766,46280958,334,6.62687660757543,319763,196238.865350261,27428630902.2579,600.314685314685,296770,13244089.8023119
1182,BTC,2014-09-09,43123676,46538507,117368,233740,46538507,81812,46362770,313,6.39497224145394,319909,198186.976927621,27428630902.2579,594.413793103448,352552,13247739.8023119
1182,BTC,2014-09-10,43268625,46644810,106303,229163,46644810,72558,46435328,290,6.51110126532994,320066,215431.403899883,27428630902.2579,546.833333333333,307048,13251664.8023119
1182,BTC,2014-09-11,43356976,46741074,96264,174041,46741074,66026,46501354,272,6.80725737035622,320236,239683.344001898,27428630902.2579,491.502958579882,216341,13255914.8023119
1182,BTC,2014-09-12,43447536,46839951,98877,168356,46839951,68384,46569738,294,6.75595409417027,320390,209296.269339576,27428630902.2579,562.862745098039,242384,13259764.8023119
1182,BTC,2014-09-13,43524221,46924257,84306,154127,46924257,61246,46630984,208,5.38354019516099,320571,254034.397272125,27800072129.9369,470.016666666667,181349,13264289.8023119
1182,BTC,2014-09-14,43603034,47022943,98686,238646,47022943,67655,46698639,203,5.4789611495208,320729,235199.346709432,29829733124.0404,544.71974522293,274821,13268239.8023119
1182,BTC,2014-09-15,43703989,47126172,103229,192914,47126172,78666,46777305,324,5.89681707076971,320887,233354.795757827,29829733124.0404,549.025477707006,289002,13272189.8023119
1182,BTC,2014-09-16,43822543,47250276,124104,220235,47250276,87234,46864539,195,4.98413185110668,321058,254454.276496845,29829733124.0404,503.5,296312,13276464.8023119
1182,BTC,2014-09-17,43926589,47358764,108488,193684,47358764,80305,46944844,310,5.94447456075612,321244,280447.9698037,29829733124.0404,456.832432432433,240645,13281114.8023119
1182,BTC,2014-09-18,44027215,47466894,108130,193289,47466894,77364,47022208,543,9.10099775471279,321423,265894.290606839,29829733124.0404,481.837078651685,236702,13285589.8023119
1182,BTC,2014-09-19,44115931,47561459,94565,170472,47561459,69437,47091645,342,10.2136782223273,321594,254382.950008146,29829733124.0404,503.641176470588,221352,13289864.8023119
1182,BTC,2014-09-20,44200057,47646967,85508,169045,47646967,63482,47155127,420,11.8840327132151,321770,264499.946179226,29829733124.0404,484.377142857143,208401,13294264.8023119
1182,BTC,2014-09-21,44252660,47715874,68907,204150,47715874,59800,47214927,423,13.4093000429686,321934,245502.623928551,29829733124.0404,521.858895705521,217996,13298364.8023119
1182,BTC,2014-09-22,44357732,47821732,105858,205313,47821732,73289,47288216,289,7.36178980338318,322102,248408.361822096,29829733124.0404,515.754491017964,260388,13302564.8023119
1182,BTC,2014-09-23,44471023,47931569,109837,199235,47931569,77283,47365499,296,10.1977296053411,322252,222268.632522653,29829733124.0404,576.409395973155,309575,13306314.8023119
1182,BTC,2014-09-24,44560655,48033644,102075,189851,48033644,74974,47440473,405,12.1745957905599,322408,230272.592981111,29829733124.0404,556.374193548387,285509,13310214.8023119
1182,BTC,2014-09-25,44665905,48143011,109367,200082,48143011,78523,47518996,408,8.6482103650114,322580,259693.003241627,30419649105.428,503.099415204678,283576,13314514.8023119
1182,BTC,2014-09-26,44758777,48242917,99906,181149,48242917,72555,47591551,341,7.77546694816139,322714,234296.198814721,34661425923.9769,635.390977443609,310114,13317864.8023119
1182,BTC,2014-09-27,44845312,48329015,86098,170653,48329015,63138,47654689,280,8.2214959950784,322849,230660.525789392,34661425923.9769,645.406015037594,292425,13321214.8023119
1182,BTC,2014-09-28,44917753,48416420,87405,235333,48416420,62440,47717129,290,7.4400444417761,322978,223718.154612956,34661425923.9769,665.434108527132,328592,13324464.8023119
1182,BTC,2014-09-29,45020238,48521254,104834,194301,48521254,77924,47795053,380,9.03942238180766,323115,237838.943983791,34661425923.9769,625.926470588235,322685,13327889.8023119
1182,BTC,2014-09-30,45128362,48633874,112620,219763,48633874,78006,47873059,294,8.54896343145463,323268,267567.612604748,34661425923.9769,556.381578947368,297150,13331714.8023119
1182,BTC,2014-10-01,45226226,48752187,118313,212052,48752187,78779,47951838,318,8.89763165464642,323423,268070.582768597,34661425923.9769,555.337662337663,300234,13335589.8023119
1182,BTC,2014-10-02,45324128,48857400,105213,184248,48857400,72086,48023924,295,8.31416210670879,323562,240098.271073523,34661425923.9769,620.036496350364,298949,13339039.8023119
1182,BTC,2014-10-03,45388768,48940818,83418,176393,48940818,75094,48099018,470,9.69040449403268,323707,253138.180014425,34661425923.9769,588.096551724138,290937,13342689.8023119
1182,BTC,2014-10-04,45450092,49012949,72131,165394,49012949,66632,48165650,346,9.80868801208263,323861,272629.003049335,34661425923.9769,546.052287581699,276822,13346539.8023119
1182,BTC,2014-10-05,45522228,49103094,90145,249316,49103094,67330,48232980,470,13.785165617608,324030,296912.268803605,34661425923.9769,501.392857142857,268188,13350764.8023119
1182,BTC,2014-10-06,45613360,49202576,99482,189674,49202576,78049,48311029,474,14.4767070692992,324191,280192.336480334,34661425923.9769,531.3125,280036,13354789.8023119
1182,BTC,2014-10-07,45721334,49314248,111672,204117,49314248,79069,48390098,413,10.9151427697692,324325,232147.977737289,34661425923.9769,641.270676691729,337277,13358139.8023119
1182,BTC,2014-10-08,45827416,49426846,112598,192185,49426846,78818,48468916,391,11.4750621941862,324469,250663.689018906,34661425923.9769,593.902097902098,308250,13361739.8023119
1182,BTC,2014-10-09,45929467,49536084,109238,188892,49536084,82789,48551705,620,11.771322327125,324617,256555.075492255,34758212115.1294,581.884353741497,300559,13365439.8023119
1182,BTC,2014-10-10,46030240,49646216,110132,199898,49646216,81058,48632763,754,12.1533302093706,324772,269692.877772294,35002482026.1332,557.428571428571,285418,13369314.8023119
1182,BTC,2014-10-11,46114392,49733721,87505,164750,49733721,65020,48697783,315,8.99975909593448,324916,250265.840839267,35002482026.1332,600.6993006993,248888,13372914.8023119
1182,BTC,2014-10-12,46198657,49818834,85113,245314,49818834,63509,48761292,228,7.46196807248122,325064,259434.784231614,35002482026.1332,579.469387755102,286207,13376614.8023119
1182,BTC,2014-10-13,46301682,49931865,113031,208781,49931865,77942,48839234,308,9.98050495165315,325219,277566.154725327,35002482026.1332,541.616883116884,296388,13380489.8023119
1182,BTC,2014-10-14,46427907,50050446,118581,215812,50050446,81364,48920598,437,10.969235912216,325351,233546.653318947,35002482026.1332,643.702290076336,368183,13383789.8023119
1182,BTC,2014-10-15,46541257,50169296,118850,210636,50169296,76257,48996855,470,15.786838390991,325502,265336.784886636,35002482026.1332,566.58,297119,13387564.8023119
1182,BTC,2014-10-16,46644365,50279589,110293,185030,50279589,75737,49072592,443,13.939292010441,325650,259224.804288716,35002482026.1332,579.938775510204,284944,13391264.8023119
1182,BTC,2014-10-17,46746114,50387598,108009,184726,50387598,70839,49143431,486,12.9216146724095,325792,246989.894163861,35002482026.1332,608.666666666666,290464,13394814.8023119
1182,BTC,2014-10-18,46832384,50476405,88807,176017,50476405,66477,49209908,338,9.04918005722235,325956,287207.29066707,35002482026.1332,523.435582822086,225046,13398914.8023119
1182,BTC,2014-10-19,46904453,50561839,85434,231498,50561839,63255,49273163,244,7.17815379077164,326089,237879.623316686,35002482026.1332,631.977272727273,312005,13402239.8023119
1182,BTC,2014-10-20,47014413,50673000,111161,201580,50673000,82700,49355863,530,10.0399961053433,326226,238386.937936076,35002482026.1332,630.632352941177,338066,13405664.8023119
1182,BTC,2014-10-21,47135303,50793563,120563,210710,50793563,81651,49437514,306,7.12439593985671,326379,268963.221887294,35002482026.1332,558.940789473684,312191,13409489.8023119
1182,BTC,2014-10-22,47246554,50907069,113506,202536,50907069,79987,49517501,491,10.8347611373357,326538,276888.190963561,35002482026.1332,542.943037974683,289547,13413464.8023119
1182,BTC,2014-10-23,47365285,51023495,116426,198727,51023495,80638,49598139,424,13.4860145644888,326689,268336.13579747,35640558234.1889,570.46,308030,13417239.8023119
1182,BTC,2014-10-24,47473807,51133923,110428,188328,51133923,77906,49676045,314,9.12770634443457,326848,286673.898785353,35985640265.0762,539.139240506329,269695,13421214.8023119
1182,BTC,2014-10-25,47555507,51228013,94090,211154,51228013,72515,49748560,325,12.6148409231334,327003,278918.636939568,35985640265.0762,554.12987012987,265844,13425089.8023119
1182,BTC,2014-10-26,47643474,51318442,90429,213766,51318442,70762,49819322,374,12.3452456567919,327128,225037.414399879,35985640265.0762,686.806451612903,333230,13428214.8023119
1182,BTC,2014-10-27,47761702,51438588,120146,223008,51438588,83977,49903299,439,12.8046806584555,327287,285220.740897142,35985640265.0762,541.886075949367,315266,13432189.8023119
1182,BTC,2014-10-28,47872187,51554500,115912,204111,51554500,87980,49991279,316,9.59279496322369,327425,246422.30363896,35985640265.0762,627.204379562043,353804,13435639.8023119
1182,BTC,2014-10-29,47984562,51674465,119965,201072,51674465,93667,50084946,422,8.53701397494849,327580,280054.133449523,35985640265.0762,551.883116883117,319597,13439514.8023119
1182,BTC,2014-10-30,48101933,51796121,121656,205538,51796121,92622,50177568,318,7.7138248333884,327750,306111.146536779,35985640265.0762,504.905325443787,298692,13443764.8023119
1182,BTC,2014-10-31,48216526,51912141,116020,203254,51912141,85703,50263271,332,15.0825898762143,327938,339857.796006574,35985640265.0762,454.770053475936,254220,13448464.8023119
1182,BTC,2014-11-01,48306619,52003440,91299,173772,52003440,69591,50332862,309,9.99890836719978,328097,285514.198458219,35985640265.0762,541.329113924051,242735,13452439.8023119
1182,BTC,2014-11-02,48388733,52107175,103735,269173,52107175,77170,50410032,205,7.15301472583335,328252,277155.076350155,35985640265.0762,557.655844155844,315692,13456314.8023119
1182,BTC,2014-11-03,48509803,52226430,119255,211299,52226430,90351,50500383,304,11.927565783914,328421,301564.415581022,35985640265.0762,512.517857142857,303758,13460539.8023119
1182,BTC,2014-11-04,48623474,52344526,118096,204276,52344526,87617,50588000,429,12.9786383998188,328583,300331.919259466,35985640265.0762,514.621118012422,303958,13464589.8023119
1182,BTC,2014-11-05,48736007,52463245,118719,202186,52463245,89460,50677460,567,10.7152511223735,328721,271088.148899208,38974444341.5763,617.489051094891,350468,13468039.8023119
1182,BTC,2014-11-06,48870985,52586490,123245,226811,52586490,94296,50771756,370,8.01514349293809,328876,305175.509011033,39603666252.4184,557.372549019608,349831,13471889.8023119
1182,BTC,2014-11-07,49007597,52694151,107661,222241,52694151,83957,50855713,456,10.2376591587619,329025,295550.840810462,39603666252.4184,575.523489932886,338618,13475639.8023119
1182,BTC,2014-11-08,49102285,52782736,88585,167389,52782736,72717,50928430,296,7.78841440272151,329178,303690.146309826,39603666252.4184,560.098684210526,265582,13479464.8023119
1182,BTC,2014-11-09,49179320,52880728,97992,249998,52880728,72212,51000642,305,7.42789489871046,329328,294647.173223814,39603666252.4184,577.288590604027,316057,13483214.8023119
1182,BTC,2014-11-10,49294296,52993677,112949,212200,52993677,88994,51089636,623,10.5341817140731,329475,293640.782495029,39603666252.4184,579.267123287671,346646,13486889.8023119
1182,BTC,2014-11-11,49407854,53109049,115372,202225,53109049,85618,51175254,325,8.16272161462298,329604,261357.01066619,39603666252.4184,650.8203125,385816,13490114.8023119
1182,BTC,2014-11-12,49535677,53244472,135423,227461,53244472,95579,51270833,855,11.6665011207943,329751,288265.605315752,39603666252.4184,590.068493150685,371572,13493789.8023119
1182,BTC,2014-11-13,49654403,53369054,124582,216425,53369054,92958,51363791,1156,17.8200692159769,329896,286793.539039885,39603666252.4184,593.097222222222,381122,13497414.8023119
1182,BTC,2014-11-14,49762915,53489340,120286,221687,53489340,86307,51450098,651,11.0574658323725,330050,305720.426866561,39603666252.4184,556.379084967321,324487,13501264.8023119
1182,BTC,2014-11-15,49854345,53585825,96485,178215,53585825,73242,51523340,630,11.0831560696925,330190,274773.167437112,39603666252.4184,619.043165467626,288056,13504764.8023119
1182,BTC,2014-11-16,49931072,53680412,94587,247987,53680412,76009,51599349,389,9.57651248590654,330340,295495.706514236,39603666252.4184,575.630872483222,316552,13508514.8023119
1182,BTC,2014-11-17,50050215,53797742,117330,213407,53797742,88354,51687703,603,9.48951928207631,330484,286118.505921265,39603666252.4184,594.496503496504,367715,13512114.8023119
1182,BTC,2014-11-18,50160993,53916063,118321,208755,53916063,87524,51775227,485,11.2411012517863,330638,303107.057027612,39671493922.1073,562.137254901961,324235,13515964.8023119
1182,BTC,2014-11-19,50269569,54031445,115382,201491,54031445,85271,51860498,481,11.0251100213968,330779,284399.08127521,40300030327.8914,608.607142857143,338609,13519489.8023119
1182,BTC,2014-11-20,50392465,54155965,124520,214345,54155965,89388,51949886,529,11.6271804623162,330917,279386.884043546,40300030327.8914,619.525547445255,360704,13522939.8023119
1182,BTC,2014-11-21,50499169,54267634,111669,199216,54267634,82179,52032065,892,16.0534967910764,331044,256007.246804738,40300030327.8914,676.103174603175,367333,13526114.8023119
1182,BTC,2014-11-22,50592010,54365629,97995,179426,54365629,74725,52106790,277,10.5800889893184,331198,309568.638858317,40300030327.8914,559.124183006536,265635,13529964.8023119
1182,BTC,2014-11-23,50664006,54458418,92789,247147,54458418,77283,52184073,309,7.76915340677859,331340,284073.36614606,40300030327.8914,609.304964539007,333664,13533514.8023119
1182,BTC,2014-11-24,50770921,54565413,106995,208935,54565413,85807,52269880,477,9.30459972516624,331487,301172.088403619,40300030327.8914,574.712328767123,346860,13537189.8023119
1182,BTC,2014-11-25,50888095,54683707,118294,211060,54683707,86134,52356014,727,11.2671306468804,331619,263647.057771,40300030327.8914,656.511450381679,378573,13540489.8023119
1182,BTC,2014-11-26,50996761,54799462,115755,199016,54799462,85111,52441125,517,12.367702081566,331756,274009.410782454,40300030327.8914,631.683823529412,342084,13543914.8023119
1182,BTC,2014-11-27,51109894,54917347,117885,212728,54917347,84682,52525807,418,11.7839460380006,331897,282706.920842959,40300030327.8914,612.25,346226,13547439.8023119
1182,BTC,2014-11-28,51213817,55030512,113165,208537,55030512,85912,52611719,699,15.697488896426,332045,298661.097813869,40300030327.8914,579.544217687075,328049,13551139.8023119
1182,BTC,2014-11-29,51311657,55129433,98921,187164,55129433,79098,52690817,574,12.3755499463615,332202,318178.955688956,40300030327.8914,543.99358974359,273658,13555064.8023119
1182,BTC,2014-11-30,51414740,55236562,107129,278481,55236562,85013,52775830,333,11.5344284217906,332362,319850.338243555,40300030327.8914,541.150943396226,361432,13559064.8023119
1182,BTC,2014-12-01,51522258,55352294,115732,216217,55352294,97623,52873453,676,13.4213005071857,332492,260752.811922307,40300030327.8914,663.798449612403,415372,13562314.8023119
1182,BTC,2014-12-02,51668868,55496587,144293,254958,55496587,99419,52972872,498,13.7754456995035,332642,302968.618452401,40294179126.759,571.221476510067,391368,13566064.8023119
1182,BTC,2014-12-03,51797953,55627042,130455,232494,55627042,99348,53072220,584,12.295867860643,332758,232731.568507217,40007470271.2713,738.321739130435,474028,13568964.8023119
1182,BTC,2014-12-04,51926286,55755152,128110,225114,55755152,98348,53170568,384,10.8544508217,332904,293451.063889834,40007470271.2713,585.551724137931,378689,13572614.8023119
1182,BTC,2014-12-05,52036352,55876650,121498,224229,55876650,90900,53261468,716,12.7548850748336,333060,310626.884650164,40007470271.2713,553.174193548387,324024,13576514.8023119
1182,BTC,2014-12-06,52133823,55975916,99266,191213,55975916,81230,53342698,364,7.59572513409836,333197,271571.342481425,40007470271.2713,632.72794117647,326682,13579939.8023119
1182,BTC,2014-12-07,52202542,56071739,95823,257477,56071739,74792,53417490,367,10.9601125192193,333323,251567.662817408,40007470271.2713,683.04,350831,13583089.8023119
1182,BTC,2014-12-08,52341322,56202802,131063,246043,56202802,90746,53508236,406,18.2301232818534,333486,322772.961881102,40007470271.2713,532.358024691358,352165,13587164.8023119
1182,BTC,2014-12-09,52463502,56329398,126596,221069,56329398,90220,53598456,636,12.7824979212833,333628,280997.187190312,40007470271.2713,611.503546099291,359033,13590714.8023119
1182,BTC,2014-12-10,52588309,56456036,126638,224571,56456036,88798,53687254,358,14.9203453553695,333771,285680.48531008,40007470271.2713,601.478873239436,348320,13594289.8023119
1182,BTC,2014-12-11,52705890,56575187,119151,217199,56575187,84005,53771259,369,9.71447579960526,333919,300578.617628226,40007470271.2713,571.666666666667,327350,13597989.8023119
1182,BTC,2014-12-12,52816930,56695720,120533,220202,56695720,81297,53852556,310,11.9685325996416,334060,280952.871829304,40007470271.2713,611.6,333217,13601514.8023119
1182,BTC,2014-12-13,52919116,56801580,105860,184726,56801580,76207,53928763,306,9.23709810310523,334206,292496.801901415,40007470271.2713,587.462068965517,284367,13605164.8023119
1182,BTC,2014-12-14,53009788,56916290,114710,280724,56916290,79703,54008466,124,7.77915106238209,334347,281633.734473376,40007470271.2713,610.121428571429,367709,13608689.8023119
1182,BTC,2014-12-15,53142476,57048010,131720,243318,57048010,94459,54102925,270,9.29438737662287,334488,283228.650954982,40007470271.2713,606.685714285715,410678,13612214.8023119
1182,BTC,2014-12-16,53287523,57198980,150970,256148,57198980,101064,54203989,364,9.80705366416241,334631,283941.79477423,40007470271.2713,605.161971830986,433898,13615789.8023119
1182,BTC,2014-12-17,53431131,57347839,148859,245011,57347839,98444,54302433,429,11.4953589187316,334759,255298.434584516,39560758612.9136,665.543307086614,461817,13618989.8023119
1182,BTC,2014-12-18,53563404,57480753,132914,240175,57480753,95207,54397640,522,12.0728591825128,334888,251823.591868833,39457671307.1387,672.96875,426957,13622214.8023119
1182,BTC,2014-12-19,53675505,57597033,116280,224312,57597033,95405,54493045,273,9.30922458545097,335025,267805.064561654,39457671307.1387,632.808823529412,398502,13625639.8023119
1182,BTC,2014-12-20,53789192,57722037,125004,253403,57722037,86901,54579946,233,8.24900102356049,335159,264621.856424153,39457671307.1387,640.421052631579,384143,13628989.8023119
1182,BTC,2014-12-21,53885254,57829936,107899,235768,57829936,78963,54658909,94,12.0758441173279,335291,262581.669687898,39457671307.1387,645.396946564886,352554,13632289.8023119
1182,BTC,2014-12-22,54035220,57968709,138773,259281,57968709,96511,54755420,355,10.4908515732699,335455,324516.734545687,39457671307.1387,522.220858895706,352497,13636389.8023119
1182,BTC,2014-12-23,54182035,58105655,136946,245356,58105655,99469,54854889,366,12.2052574397556,335605,298255.90900559,39457671307.1387,568.201342281879,391734,13640139.8023119
1182,BTC,2014-12-24,54285243,58213608,107953,190013,58213608,82347,54937236,319,10.0862478355634,335758,305205.568622663,39457671307.1387,555.263157894737,291174,13643964.8023119
1182,BTC,2014-12-25,54369829,58298361,84753,166682,58298361,67918,55005154,213,12.8291418063343,335916,309783.637189771,39457671307.1387,547.057324840765,235349,13647914.8023119
1182,BTC,2014-12-26,54458219,58396681,98320,187738,58396681,76198,55081352,234,9.33829475225163,336068,299812.315723082,39457671307.1387,565.251655629139,274921,13651714.8023119
1182,BTC,2014-12-27,54557574,58500032,103351,210168,58500032,76814,55158166,265,8.59735879022327,336220,300983.058114022,39457671307.1387,563.05298013245,290968,13655514.8023119
1182,BTC,2014-12-28,54642913,58601249,101217,266893,58601249,75715,55233881,186,9.18963498332734,336389,330625.935028804,39457671307.1387,512.571428571429,280020,13659739.8023119
1182,BTC,2014-12-29,54753399,58709245,107996,200174,58709245,83447,55317328,264,9.59116501939998,336553,322795.100004651,39457671307.1387,525.006134969325,284166,13663839.8023119
1182,BTC,2014-12-30,54859829,58822937,113692,209696,58822937,85049,55402377,262,12.8971407378352,336708,308315.337044136,39740132579.7142,553.597402597403,301214,13667714.8023119
1182,BTC,2014-12-31,54956252,58923936,100999,180017,58923936,77411,55479788,391,12.3050686449268,336860,307736.079508633,40640955016.5765,567.211920529801,269747,13671514.8023119
1182,BTC,2015-01-01,55025099,58996600,72664,141655,58996600,59344,55539132,107,7.89892052224488,337025,332336.370184731,40640955016.5765,525.225609756097,187483,13675639.8023119
1182,BTC,2015-01-02,55120321,59100320,103720,208771,59100320,79287,55618419,173,9.23514778968683,337190,332205.242118603,40640955016.5765,525.432926829268,265137,13679764.8023119
1182,BTC,2015-01-03,55214138,59206898,106578,241254,59206898,82227,55700646,309,10.2252513522482,337352,331541.729986538,40640955016.5765,526.48447204969,295148,13683814.8023119
1182,BTC,2015-01-04,55314816,59317240,110342,241042,59317240,85694,55786340,491,13.2332653465393,337524,350266.604010079,40640955016.5765,498.33918128655,282243,13688114.8023119
1182,BTC,2015-01-05,55443369,59443855,126615,241796,59443855,95585,55881925,354,11.9107107896521,337680,316268.367481033,40640955016.5765,551.909677419355,360960,13692014.8023119
1182,BTC,2015-01-06,55562736,59565033,121178,214620,59565033,87821,55969746,483,13.2976950539543,337838,319904.242221226,40640955016.5765,545.636942675159,314165,13695964.8023119
1182,BTC,2015-01-07,55675606,59684512,119479,202694,59684512,89916,56059662,488,13.8457612665915,337978,289209.690936574,40640955016.5765,603.546762589928,342805,13699464.8023119
1182,BTC,2015-01-08,55799131,59815591,131079,231521,59815591,107132,56166794,386,13.4869249308747,338125,299546.641400882,40640955016.5765,582.719178082192,390776,13703139.8023119
1182,BTC,2015-01-09,55921878,59943596,128005,239104,59943596,102275,56269069,341,12.325767206468,338265,283369.561581627,40640955016.5765,615.985611510791,406356,13706639.8023119
1182,BTC,2015-01-10,56023093,60067451,123855,272473,60067451,104874,56373943,301,9.23382878962021,338412,302382.914017286,40640955016.5765,577.253424657534,398392,13710314.8023119
1182,BTC,2015-01-11,56131142,60177174,109723,248734,60177174,90630,56464573,372,13.6698624396135,338567,318083.78032941,40640955016.5765,548.75974025974,333321,13714189.8023119
1182,BTC,2015-01-12,56252458,60300475,123301,220827,60300475,98969,56563542,332,10.4377491771259,338709,293047.448010682,41156980050.8673,603.205673758865,388420,13717739.8023119
1182,BTC,2015-01-13,56399316,60446468,145993,255091,60446468,102309,56665851,723,17.3734164814437,338836,277135.506856078,43971662056.0896,681.460317460318,473648,13720914.8023119
1182,BTC,2015-01-14,56541531,60603226,156758,252615,60603226,104765,56770616,627,22.9655645139367,338981,322480.036870468,43971662056.0896,585.638888888889,420506,13724539.8023119
1182,BTC,2015-01-15,56692886,60762984,159758,264669,60762984,120390,56891006,437,21.4129973656241,339132,332892.988933351,43971662056.0896,567.32,422705,13728314.8023119
1182,BTC,2015-01-16,56824935,60901881,138897,243200,60901881,104699,56995705,692,18.6706372320318,339271,307019.194308622,43971662056.0896,615.130434782609,394174,13731789.8023119
1182,BTC,2015-01-17,56934871,61035952,134071,278595,61035952,90499,57086204,241,12.4835162830473,339409,301807.910087587,43971662056.0896,625.751824817518,391075,13735239.8023119
1182,BTC,2015-01-18,57039628,61149213,113261,244672,61149213,83186,57169390,186,11.7245572883615,339562,339622.370843946,43971662056.0896,556.078947368421,320820,13739064.8023119
1182,BTC,2015-01-19,57175879,61279732,130519,253701,61279732,98485,57267875,269,10.2632044848698,339706,317750.045519968,43971662056.0896,594.356643356643,402776,13742664.8023119
1182,BTC,2015-01-20,57299693,61410373,130641,226426,61410373,98925,57366800,301,14.3113033227735,339824,260038.500539645,43971662056.0896,726.264957264957,450219,13745614.8023119
1182,BTC,2015-01-21,57426745,61541898,131525,226145,61541898,96959,57463759,403,14.7416359503569,339973,329123.507462902,43971662056.0896,573.817567567568,354153,13749339.8023119
1182,BTC,2015-01-22,57548377,61671186,129288,224095,61671186,93698,57557457,410,12.9176445757142,340108,301092.420756022,43971662056.0896,627.238805970149,396514,13752714.8023119
1182,BTC,2015-01-23,57658722,61787308,116122,215307,61787308,92011,57649468,294,11.2124004314831,340232,271190.826310112,43971662056.0896,696.39837398374,390417,13755814.8023119
1182,BTC,2015-01-24,57761761,61891257,103949,204729,61891257,83557,57733025,497,14.3375743513281,340358,276206.651653917,43971662056.0896,683.752,372339,13758964.8023119
1182,BTC,2015-01-25,57866846,62014473,123216,320035,62014473,86558,57819583,247,10.8515941023913,340483,278639.412930298,43971662056.0896,677.782258064516,457589,13762089.8023119
1182,BTC,2015-01-26,58003080,62154843,140370,261204,62154843,108181,57927764,971,19.5773204587327,340610,276353.41099667,43971662056.0896,683.388888888889,491455,13765264.8023119
1182,BTC,2015-01-27,58139921,62295420,140577,250956,62295420,99393,58027157,555,11.7613580234322,340759,316456.276288266,42957352411.5394,583.02027027027,384686,13768989.8023119
1182,BTC,2015-01-28,58239515,62392835,97415,200207,62392835,85232,58112389,274,10.9241456790399,340923,338016.189433026,41272873894.697,524.429447852761,273634,13773089.8023119
1182,BTC,2015-01-29,58343770,62503638,110803,214247,62503638,90879,58203268,376,10.8302858478011,341087,337207.50995033,41272873894.697,525.687116564417,282345,13777189.8023119
1182,BTC,2015-01-30,58434288,62600830,97192,194109,62600830,81199,58284467,411,10.9887234279496,341225,285371.419510733,41272873894.697,621.175182481752,312746,13780639.8023119
1182,BTC,2015-01-31,58545982,62734345,133515,276616,62734345,86312,58370779,172,9.0914393276118,341391,340704.864321746,41272873894.697,520.290909090909,314858,13784789.8023119
1182,BTC,2015-02-01,58646873,62843780,109435,251020,62843780,78994,58449773,178,9.57810736014647,341546,319113.799742911,41272873894.697,555.493506493506,300457,13788664.8023119
1182,BTC,2015-02-02,58768988,62961788,118008,226659,62961788,85987,58535760,410,11.5624443613474,341705,325757.422679821,41272873894.697,544.164556962025,308427,13792639.8023119
1182,BTC,2015-02-03,58897913,63097591,135803,240618,63097591,91793,58627553,711,14.2040138393934,341832,261671.228982938,41272873894.697,677.436507936508,404064,13795814.8023119
1182,BTC,2015-02-04,59021316,63228995,131404,231692,63228995,90814,58718367,766,13.397312201425,341991,326353.359750709,41272873894.697,543.170886075949,311072,13799789.8023119
1182,BTC,2015-02-05,59143753,63348812,119817,215030,63348812,86567,58804934,393,14.4291231383073,342150,329641.283907087,41272873894.697,537.753164556962,298086,13803764.8023119
1182,BTC,2015-02-06,59251452,63469857,121045,232938,63469857,85705,58890639,300,10.9929958719509,342327,362750.892632833,41272873894.697,488.670454545455,260908,13808189.8023119
1182,BTC,2015-02-07,59358276,63575115,105258,195072,63575115,85699,58976338,182,7.35955739224075,342486,325560.521761776,41272873894.697,544.493670886076,284945,13812164.8023119
1182,BTC,2015-02-08,59445031,63682821,107706,291521,63682821,82679,59059017,194,7.76661691638929,342618,272601.123544302,41272873894.697,650.274809160305,406654,13815464.8023119
1182,BTC,2015-02-09,59568973,63809101,126280,230993,63809101,104758,59163775,290,8.32111227571823,342779,338730.22144712,42458914416.8014,538.3625,366250,13819489.8023119
1182,BTC,2015-02-10,59688689,63932128,123027,232006,63932128,102975,59266750,237,8.13683326374858,342923,319247.491954786,44455415962.3438,598.076923076923,397552,13823089.8023119
1182,BTC,2015-02-11,59815426,64060550,128422,233224,64060550,97048,59363798,219,9.02404976146134,343081,350797.813500636,44455415962.3438,544.286624203822,347811,13827039.8023119
1182,BTC,2015-02-12,59920911,64188217,127667,230955,64188217,87427,59451225,134,8.47467532180608,343200,273844.444262154,44455415962.3438,697.237288135593,421358,13830014.8023119
1182,BTC,2015-02-13,60052274,64354500,166283,308353,64354500,113660,59564885,239,9.13814092138466,343346,327174.555244738,44455415962.3438,583.586206896552,501242,13833664.8023119
1182,BTC,2015-02-14,60177563,64477835,123335,261571,64477835,98773,59663658,154,7.14704727107145,343506,362499.339356719,44455415962.3438,526.716981132076,416030,13837664.8023119
1182,BTC,2015-02-15,60286503,64601460,123625,346945,64601460,85267,59748925,169,8.63690853660983,343646,308384.791237374,44455415962.3438,619.143884892086,468847,13841164.8023119
1182,BTC,2015-02-16,60407620,64734547,133087,265780,64734547,104632,59853557,210,7.0260726130851,343803,358808.752838489,44455415962.3438,532.134615384615,414953,13845089.8023119
1182,BTC,2015-02-17,60537251,64878501,143954,271246,64878501,102988,59956545,212,7.79011764596798,343952,336556.751639112,44455415962.3438,567.317567567567,445682,13848814.8023119
1182,BTC,2015-02-18,60668881,65011538,133037,249907,65011538,105719,60062264,225,8.13706116744095,344119,372161.528518346,44455415962.3438,513.042168674698,361059,13852989.8023119
1182,BTC,2015-02-19,60780635,65127992,116454,214089,65127992,94552,60156816,153,7.52665440055652,344285,368474.508691056,44455415962.3438,518.175757575757,315926,13857139.8023119
1182,BTC,2015-02-20,60908877,65253042,125050,247984,65253042,98714,60255530,163,8.03931135686691,344443,348903.30850786,44455415962.3438,547.242038216561,382549,13861089.8023119
1182,BTC,2015-02-21,61015382,65370792,117750,271658,65370792,87827,60343357,165,7.01805787925934,344585,314341.440061374,44455415962.3438,607.41134751773,401512,13864639.8023119
1182,BTC,2015-02-22,61115565,65481104,110312,272262,65481104,84942,60428299,102,5.58622313253314,344736,337826.257171216,44470177289.1949,565.373333333333,356274,13868414.8023119
1182,BTC,2015-02-23,61241399,65611991,130887,250127,65611991,101515,60529814,144,8.19784689101916,344878,331791.355392331,46684376316.8603,604.31914893617,404722,13871964.8023119
1182,BTC,2015-02-24,61368359,65744198,132207,236207,65744198,105125,60634939,136,6.97989681808124,345007,301593.542714625,46684376316.8603,664.828125,435635,13875189.8023119
1182,BTC,2015-02-25,61494067,65876879,132681,230557,65876879,105394,60740333,192,7.879202158947,345166,368911.131101966,46684376316.8603,543.512658227848,355795,13879164.8023119
1182,BTC,2015-02-26,61618335,66007571,130692,226935,66007571,100817,60841150,258,11.453219653916,345316,347820.25004943,46684376316.8603,576.469798657718,364037,13882914.8023119
1182,BTC,2015-02-27,61743442,66138494,130923,241354,66138494,101474,60942624,448,14.8629189307264,345468,356460.533063045,46684376316.8603,562.496688741722,375608,13886714.8023119
1182,BTC,2015-02-28,61838536,66248478,109984,282023,66248478,89632,61032256,158,7.01543674833597,345610,334888.35244341,46684376316.8603,598.730496453901,442106,13890264.8023119
1182,BTC,2015-03-01,61949768,66361913,113435,274855,66361913,88728,61120984,288,14.327199546233,345750,323809.341852598,46684376316.8603,619.21582733813,394733,13893764.8023119
1182,BTC,2015-03-02,62103162,66505005,143092,281612,66505005,104937,61225921,581,18.2853661625808,345908,367414.833434871,46684376316.8603,545.726114649681,408546,13897714.8023119
1182,BTC,2015-03-03,62255148,66653481,148476,267335,66653481,110981,61336902,404,10.0852692589293,346066,373762.057297994,46684376316.8603,536.458598726115,406338,13901664.8023119
1182,BTC,2015-03-04,62383110,66785072,131591,241125,66785072,98529,61435431,322,9.14390681708857,346206,334067.625528539,46684376316.8603,600.201438848921,401708,13905164.8023119
1182,BTC,2015-03-05,62524864,66929501,144429,257192,66929501,101115,61536546,459,10.8064907842522,346338,308379.483733381,46684376316.8603,650.198473282442,476900,13908464.8023119
1182,BTC,2015-03-06,62650780,67055162,125661,236843,67055162,93869,61630415,330,8.81322801503606,346486,342557.289014976,46684376316.8603,585.326530612245,391679,13912164.8023119
1182,BTC,2015-03-07,62743731,67164897,109735,254628,67164897,91505,61721920,204,12.4796047642617,346626,326139.696014265,46684376316.8603,614.791366906475,387500,13915664.8023119
1182,BTC,2015-03-08,62844307,67265501,100604,268987,67265501,87527,61809447,302,25.991459400937,346782,362291.967314036,46832059250.4977,555.193548387097,351908,13919564.8023119
1182,BTC,2015-03-09,62968055,67394966,129465,259158,67394966,105536,61914983,327,10.6796545362643,346926,345409.46537786,47427554950.6483,589.734265734266,446213,13923164.8023119
1182,BTC,2015-03-10,63106060,67535328,140362,249384,67535328,105541,62020524,306,10.7030501706664,347078,356866.371358771,47427554950.6483,570.801324503312,400507,13926964.8023119
1182,BTC,2015-03-11,63237557,67675228,139900,251570,67675228,100765,62121289,367,8.83170550358964,347232,368166.954220437,47427554950.6483,553.281045751634,407319,13930814.8023119
1182,BTC,2015-03-12,63378398,67807980,132752,246925,67807980,97095,62218384,274,10.9465081361274,347363,307214.562774761,47427554950.6483,663.053846153846,461840,13934089.8023119
1182,BTC,2015-03-13,63507272,67935767,127787,241681,67935767,96036,62314420,360,9.78767506047513,347509,344830.665216627,47427554950.6483,590.724137931035,373348,13937739.8023119
1182,BTC,2015-03-14,63603589,68054345,118578,258541,68054345,89511,62403931,292,8.97195531982505,347640,308618.071994593,47427554950.6483,660.038461538462,394160,13941014.8023119
1182,BTC,2015-03-15,63691360,68155499,101154,255201,68155499,84934,62488865,151,6.83207564619822,347783,340206.429281528,47427554950.6483,598.75352112676,350267,13944589.8023119
1182,BTC,2015-03-16,63819091,68284957,129458,261887,68284957,105218,62594083,235,8.95636852490429,347922,327804.790995572,47427554950.6483,621.40579710145,430460,13948064.8023119
1182,BTC,2015-03-17,63932366,68409340,124383,226199,68409340,99561,62693644,250,7.94874165566547,348050,307974.693752015,47427554950.6483,661.417322834645,411491,13951264.8023119
1182,BTC,2015-03-18,64067291,68529982,120642,250808,68529982,99607,62793251,551,15.3391522102348,348203,363373.969712071,47427554950.6483,560.578947368421,377621,13955089.8023119
1182,BTC,2015-03-19,64221839,68658340,128358,266786,68658340,106297,62899548,534,10.3392185635017,348340,323265.098977219,47427554950.6483,630.132352941176,457138,13958514.8023119
1182,BTC,2015-03-20,64340304,68788132,129792,236907,68788132,103532,63003080,260,8.00645906410347,348476,318671.896710171,47427554950.6483,639.214814814814,408021,13961914.8023119
1182,BTC,2015-03-21,64431332,68899612,111480,244354,68899612,92836,63095916,228,6.98831432680038,348627,357276.134986805,47427554950.6483,570.146666666667,345467,13965689.8023119
1182,BTC,2015-03-22,64535602,69011086,111474,273409,69011086,90586,63186502,154,5.46027084385523,348769,337291.104705613,47417554875.9167,603.801418439716,390491,13969239.8023119
1182,BTC,2015-03-23,64655560,69142230,131144,260606,69142230,106019,63292521,258,8.45026445168809,348914,336956.117199628,46717549644.7064,595.479166666667,416135,13972864.8023119
1182,BTC,2015-03-24,64771878,69263070,120840,221810,69263070,92927,63385448,408,10.3622543795075,349087,403128.838152115,46717549644.7064,497.732558139535,292805,13977189.8023119
1182,BTC,2015-03-25,64887659,69387932,124862,224388,69387932,97138,63482586,394,11.0582658233149,349249,378177.823132174,46717549644.7064,530.571428571428,312553,13981239.8023119
1182,BTC,2015-03-26,65006647,69510379,122447,230461,69510379,101181,63583767,346,9.78927186049871,349397,343503.338155179,46717549644.7064,584.12925170068,368037,13984939.8023119
1182,BTC,2015-03-27,65124675,69636770,126391,233010,69636770,99491,63683258,335,10.14820047552,349568,401206.294265537,46717549644.7064,500.117647058823,301105,13989214.8023119
1182,BTC,2015-03-28,65213092,69743124,106354,235645,69743124,87374,63770632,155,7.28688493853778,349716,349225.682422103,46717549644.7064,574.557823129251,341894,13992914.8023119
1182,BTC,2015-03-29,65319159,69851705,108581,278336,69851705,90516,63861148,140,6.18970707376298,349869,363961.154656337,46717549644.7064,551.296052631579,352724,13996739.8023119
1182,BTC,2015-03-30,65458181,69989526,137821,259917,69989526,106355,63967503,254,8.13190838150534,350011,330325.273796599,46717549644.7064,607.432624113475,415471,14000289.8023119
1182,BTC,2015-03-31,65594257,70136442,146916,268361,70136442,115111,64082614,274,7.41272914542016,350161,348416.25294981,46717549644.7064,575.892617449664,400420,14004039.8023119
1182,BTC,2015-04-01,65747340,70295966,159524,267879,70295966,119343,64201957,281,9.06054153871178,350293,308052.498873726,46717549644.7064,651.351145038168,469369,14007339.8023119
1182,BTC,2015-04-02,65884062,70442073,146107,256770,70442073,112070,64314027,162,7.02659601274105,350459,386181.119784085,46717549644.7064,519.575757575758,367188,14011489.8023119
1182,BTC,2015-04-03,66007989,70570849,128776,236921,70570849,104546,64418573,205,7.0948596653233,350605,340180.768907984,46717549644.7064,589.834482758621,409840,14015139.8023119
1182,BTC,2015-04-04,66100144,70682684,111835,249280,70682684,89651,64508224,118,5.19988499949683,350758,354637.824148106,46717549644.7064,565.789473684211,340018,14018964.8023119
1182,BTC,2015-04-05,66202295,70786153,103469,268193,70786153,95023,64603247,159,4.80499690816823,350906,361817.724391571,48985437809.2659,581.482993197279,377984,14022664.8023119
1182,BTC,2015-04-06,66329569,70914495,128342,248586,70914495,107449,64710696,309,6.93011344101667,351032,316095.459311573,49446390688.2414,671.856,468922,14025814.8023119
1182,BTC,2015-04-07,66467276,71057113,142618,262298,71057113,108714,64819410,286,7.34414169679094,351184,372657.988978718,49446390688.2414,569.880794701987,394001,14029614.8023119
1182,BTC,2015-04-08,66604638,71202587,145474,255354,71202587,110751,64930161,282,8.31989451652608,351309,310655.525404255,49446390688.2414,683.620967741935,462382,14032739.8023119
1182,BTC,2015-04-09,66740825,71344580,141993,247278,71344580,116620,65046781,211,7.62553824858052,351442,329523.848083168,49446390688.2414,644.477272727273,439197,14036064.8023119
1182,BTC,2015-04-10,66873128,71486114,141534,258042,71486114,112826,65159607,202,9.02686420035657,351594,372061.321123061,49446390688.2414,570.794701986755,375338,14039864.8023119
1182,BTC,2015-04-11,66975776,71609298,123184,270762,71609298,99429,65259036,130,6.32686289398837,351734,343513.832669977,49446390688.2414,618.230215827338,392244,14043364.8023119
1182,BTC,2015-04-12,67070058,71717383,108085,254220,71717383,86999,65346035,91,5.55095660345165,351862,314469.086312066,49446390688.2414,675.330708661417,371312,14046564.8023119
1182,BTC,2015-04-13,67219547,71861343,143960,275907,71861343,115407,65461442,292,8.08003268310423,352018,385915.656954425,49446390688.2414,550.303225806451,414068,14050464.8023119
1182,BTC,2015-04-14,67354967,71999102,137759,258022,71999102,110150,65571592,323,9.01971041815306,352167,365879.2081353,49446390688.2414,580.439189189189,396371,14054189.8023119
1182,BTC,2015-04-15,67473795,72123187,124085,226628,72123187,107606,65679198,222,7.59608409144815,352289,297989.729576032,49446390688.2414,712.677685950413,448382,14057239.8023119
1182,BTC,2015-04-16,67585916,72246171,122984,226044,72246171,99046,65778244,650,11.5318720437218,352427,340261.925162142,49446390688.2414,624.138686131387,365163,14060689.8023119
1182,BTC,2015-04-17,67699023,72366984,120813,231109,72366984,102755,65880999,703,11.2430560441029,352553,312508.286015875,49446390688.2414,679.568,422755,14063839.8023119
1182,BTC,2015-04-18,67785069,72473680,106696,251121,72473680,97709,65978708,154,7.96881447285204,352699,357368.64592574,49446390688.2414,594.262068965518,368046,14067489.8023119
1182,BTC,2015-04-19,67889910,72578316,104636,270083,72578316,91134,66069842,615,11.0978988463276,352844,354338.845636406,48876651530.5542,592.4375,367780,14071114.8023119
1182,BTC,2015-04-20,68012201,72707657,129341,249930,72707657,116746,66186588,800,11.248278391862,352998,364867.926364852,47610564513.4713,560.437908496732,392346,14074964.8023119
1182,BTC,2015-04-21,68144737,72842897,135240,246101,72842897,112502,66299090,541,11.269444186084,353151,363292.396377548,47610564513.4713,562.868421052631,381146,14078789.8023119
1182,BTC,2015-04-22,68276473,72981873,138976,263018,72981873,111878,66410968,839,11.7384203049168,353303,359452.840443627,47610564513.4713,568.880794701987,393256,14082589.8023119
1182,BTC,2015-04-23,68408260,73118930,137057,263019,73118930,109838,66520806,420,10.3993101094482,353433,306718.026828134,47610564513.4713,666.68992248062,457809,14085839.8023119
1182,BTC,2015-04-24,68549982,73252396,133466,258950,73252396,108776,66629582,829,11.5327706328362,353557,294330.933088249,47610564513.4713,694.747967479675,493347,14088939.8023119
1182,BTC,2015-04-25,68643167,73371372,118976,264408,73371372,98465,66728047,229,9.5669465096154,353720,385404.842643911,47610564513.4713,530.574074074074,328686,14093014.8023119
1182,BTC,2015-04-26,68756046,73484717,113345,275341,73484717,92999,66821046,594,11.881495746738,353864,345741.958791056,47610564513.4713,591.44055944056,378717,14096614.8023119
1182,BTC,2015-04-27,68885136,73622187,137470,255519,73622187,113775,66934821,574,11.7773367800726,354001,326612.460615244,47610564513.4713,626.080882352941,436451,14100039.8023119
1182,BTC,2015-04-28,69023737,73760732,138545,254152,73760732,113193,67048014,577,11.6159440120553,354154,371015.747710862,47610564513.4713,551.151315789474,386087,14103864.8023119
1182,BTC,2015-04-29,69162938,73905690,144958,261016,73905690,117260,67165274,594,10.9441712545276,354281,304315.935661442,47610564513.4713,671.952380952381,495053,14107039.8023119
1182,BTC,2015-04-30,69296371,74044945,139255,246152,74044945,112958,67278232,286,10.6494045708068,354415,320310.619046931,47610564513.4713,638.398496240602,438464,14110389.8023119
1182,BTC,2015-05-01,69411476,74168079,123134,222372,74168079,99560,67377792,654,12.2810895857556,354563,349837.241944395,47610564513.4713,584.517006802721,338625,14114089.8023119
1182,BTC,2015-05-02,69502906,74286866,118787,266512,74286866,95102,67472894,496,8.84459808294431,354710,355090.326240241,47610564513.4713,575.869863013698,371399,14117764.8023119
1182,BTC,2015-05-03,69590146,74385544,98678,247792,74385544,84602,67557496,210,9.62953715280797,354851,336432.005535326,47618947535.8539,607.914285714285,345818,14121289.8023119
1182,BTC,2015-05-04,69720318,74513663,128119,257420,74513663,104000,67661496,619,12.0116771171687,354979,302448.771208401,47643398017.8034,676.566929133858,437794,14124489.8023119
1182,BTC,2015-05-05,69862035,74659343,145680,263347,74659343,115348,67776844,705,10.4832905662032,355133,365025.89470073,47643398017.8034,560.581699346405,385758,14128339.8023119
1182,BTC,2015-05-06,70007373,74807622,148279,272014,74807622,111733,67888577,314,10.5936795495438,355294,380413.569012773,47643398017.8034,537.90625,363293,14132364.8023119
1182,BTC,2015-05-07,70141568,74950558,142936,261689,74950558,111125,67999702,663,11.7521642488836,355435,334756.094906971,47643398017.8034,611.271428571429,420890,14135889.8023119
1182,BTC,2015-05-08,70256111,75092108,141550,296401,75092108,109145,68108847,299,10.0287072614393,355585,354276.601679736,47643398017.8034,577.590604026846,399740,14139639.8023119
1182,BTC,2015-05-09,70370286,75207783,115675,234043,75207783,94716,68203563,343,9.40881878480436,355714,305480.86742244,47643398017.8034,669.8515625,381327,14142864.8023119
1182,BTC,2015-05-10,70486600,75315028,107245,270435,75315028,89409,68292972,629,10.7917547779019,355843,308652.310318966,47643398017.8034,662.96875,422314,14146089.8023119
1182,BTC,2015-05-11,70625768,75457721,142693,266285,75457721,111374,68404346,499,10.6471132127576,356001,375260.343974653,47643398017.8034,545.292993630573,393459,14150039.8023119
1182,BTC,2015-05-12,70777489,75604908,147187,274528,75604908,110101,68514447,221,9.56788683376582,356151,356001.571822425,47643398017.8034,574.791946308725,402724,14153789.8023119
1182,BTC,2015-05-13,70903228,75741566,136658,248437,75741566,108858,68623305,413,10.2591285191227,356313,384965.010732085,47643398017.8034,531.546583850932,355236,14157839.8023119
1182,BTC,2015-05-14,71030433,75875227,133661,238107,75875227,101584,68724889,297,10.2926623302564,356467,371039.073259779,47643398017.8034,551.496732026144,339278,14161689.8023119
1182,BTC,2015-05-15,71155973,76008741,133514,246651,76008741,105160,68830049,228,8.99613622778262,356614,351385.736728017,47643398017.8034,582.342465753425,370002,14165364.8023119
1182,BTC,2015-05-16,71260950,76133950,125209,262533,76133950,90686,68920735,151,8.45596820496703,356746,313301.95842377,47643398017.8034,653.129770992366,389019,14168664.8023119
1182,BTC,2015-05-17,71367750,76239498,105548,259252,76239498,87162,69007897,196,7.16972208983054,356917,413353.805715074,48228846400.9116,501.123529411765,311851,14172939.8023119
1182,BTC,2015-05-18,71482246,76363586,124088,245891,76363586,98578,69106475,287,9.56640651838585,357061,364727.619228433,48807487244.6814,574.748251748252,375255,14176539.8023119
1182,BTC,2015-05-19,71618623,76504836,141250,255804,76504836,107346,69213821,429,11.1557197597856,357191,313564.777777642,48807487244.6814,668.527131782946,450350,14179789.8023119
1182,BTC,2015-05-20,71752141,76644700,139864,257346,76644700,106888,69320709,300,10.2704683172352,357336,360243.273483561,48807487244.6814,581.902777777778,390349,14183414.8023119
1182,BTC,2015-05-21,71874198,76774048,129348,238139,76774048,98302,69419011,317,9.68265208778825,357491,378746.881837742,48807487244.6814,553.474025974026,334343,14187289.8023119
1182,BTC,2015-05-22,71999986,76905027,130979,247257,76905027,102770,69521781,374,12.7096243878684,357629,333792.497822713,48807487244.6814,628.014598540146,412173,14190739.8023119
1182,BTC,2015-05-23,72099619,77011124,106097,221693,77011124,86279,69608060,280,11.0406992713602,357741,278142.275341677,48807487244.6814,753.666666666667,433590,14193539.8023119
1182,BTC,2015-05-24,72202358,77127638,116514,288097,77127638,94044,69702104,140,7.72332265718089,357887,352481.056425509,48807487244.6814,594.71724137931,398880,14197189.8023119
1182,BTC,2015-05-25,72326281,77256557,128919,260373,77256557,106086,69808190,270,8.90436240323794,358028,343288.321584023,48807487244.6814,610.642857142857,425769,14200714.8023119
1182,BTC,2015-05-26,72463336,77397058,140501,271126,77397058,108384,69916574,267,9.34456968084662,358172,350026.252574884,48807487244.6814,598.888111888112,419110,14204314.8023119
1182,BTC,2015-05-27,72603640,77539143,142085,260806,77539143,108089,70024663,284,10.689014435295,358310,341091.000007965,48807487244.6814,614.576642335766,437907,14207764.8023119
1182,BTC,2015-05-28,72737016,77678924,139781,256520,77678924,110980,70135643,318,9.12849856110128,358442,325703.978728969,48807487244.6814,643.610687022901,452907,14211064.8023119
1182,BTC,2015-05-29,72878444,77838206,159282,293376,77838206,124052,70259695,311,8.73056839558209,358596,377656.594116338,48807487244.6814,555.071895424837,422254,14214914.8023119
1182,BTC,2015-05-30,73017683,77999199,160993,308685,77999199,127801,70387496,295,7.12574827376359,358732,339234.084589663,48807487244.6814,617.940740740741,480064,14218314.8023119
1182,BTC,2015-05-31,73144247,78136166,136967,295146,78136166,98784,70486280,413,9.5104635794323,358880,357723.330809188,48535929332.4864,582.741496598639,379709,14222014.8023119
1182,BTC,2015-06-01,73310029,78306424,170258,310430,78306424,128696,70614976,558,11.7458112573047,359012,313350.984554275,47589591153.625,652.290076335878,531085,14225314.8023119
1182,BTC,2015-06-02,73479871,78475886,169462,306507,78475886,128207,70743183,397,11.1352293506085,359162,360345.554777672,47589591153.625,567.221476510067,468841,14229064.8023119
1182,BTC,2015-06-03,73641072,78644061,168175,292371,78644061,127600,70870783,364,10.7515108772524,359304,335254.280937498,47589591153.625,609.673758865248,471853,14232614.8023119
1182,BTC,2015-06-04,73794340,78800318,156257,277364,78800318,118346,70989129,243,10.4934704102586,359445,338335.519927123,47589591153.625,604.121428571429,432630,14236139.8023119
1182,BTC,2015-06-05,73937544,78948201,147883,264846,78948201,110201,71099330,589,13.1391012033428,359583,331826.990282644,47589591153.625,615.970802919708,421890,14239589.8023119
1182,BTC,2015-06-06,74046377,79073339,125138,267905,79073339,92696,71192026,364,11.5207005743629,359761,422828.423381466,47589591153.625,483.401129943503,287492,14244039.8023119
1182,BTC,2015-06-07,74147408,79179922,106583,259916,79179922,83627,71275653,154,11.7895916724327,359910,357778.963820119,47589591153.625,571.290540540541,356153,14247764.8023119
1182,BTC,2015-06-08,74255101,79295576,115654,248397,79295576,108173,71383826,392,10.4429929713019,360067,374092.040488456,47589591153.625,546.378205128205,372258,14251689.8023119
1182,BTC,2015-06-09,74403790,79451159,155583,283440,79451159,121638,71505464,411,10.5233589494339,360218,356628.598874311,47589591153.625,573.133333333333,419617,14255464.8023119
1182,BTC,2015-06-10,74613131,79643338,192179,361160,79643338,131279,71636743,407,10.0235768618448,360387,402287.822144983,47589591153.625,508.083333333333,490486,14259689.8023119
1182,BTC,2015-06-11,74772459,79804713,161375,283778,79804713,120624,71757367,253,10.5363326055929,360522,322527.423964523,47589591153.625,633.731343283582,459191,14263064.8023119
1182,BTC,2015-06-12,74930244,79971773,167060,300700,79971773,126945,71884312,428,10.7650890726593,360664,336499.065998541,47589591153.625,607.418439716312,479207,14266614.8023119
1182,BTC,2015-06-13,75053731,80100626,128853,282551,80100626,105843,71990155,350,10.0057728363833,360823,376472.063443417,47589591153.625,542.924050632912,375147,14270589.8023119
1182,BTC,2015-06-14,75184493,80240249,139623,289554,80240249,103036,72093191,419,12.7569120260659,360971,371045.8209245,49124063327.5239,568.625850340136,407006,14274289.8023119
1182,BTC,2015-06-15,75350541,80414836,174587,321261,80414836,129389,72222580,330,11.5023802484457,361115,357064.474037889,49692386354.8938,597.727272727273,512932,14277889.8023119
1182,BTC,2015-06-16,75499795,80571674,156838,280586,80571674,121541,72344121,816,15.4872181241365,361233,296226.192957905,49692386354.8938,720.487179487179,573775,14280839.8023119
1182,BTC,2015-06-17,75691775,80754598,182924,323549,80754598,133122,72477243,567,14.2475473118418,361391,388616.468244933,49692386354.8938,549.197452229299,511237,14284789.8023119
1182,BTC,2015-06-18,75855039,80916707,162109,282743,80916707,124929,72602172,545,11.7725189285733,361547,391915.696305396,49692386354.8938,544.574193548387,484417,14288689.8023119
1182,BTC,2015-06-19,75999104,81084441,167734,294565,81084441,125222,72727394,601,14.8754903728154,361694,363170.212948007,49692386354.8938,587.678082191781,515908,14292364.8023119
1182,BTC,2015-06-20,76111017,81211196,126755,263279,81211196,102012,72829406,350,10.8504810882179,361828,334584.497410907,49692386354.8938,637.887218045112,440191,14295714.8023119
1182,BTC,2015-06-21,76224407,81329705,118509,280154,81329705,96654,72926060,215,10.160245541483,361952,307064.31517919,49692386354.8938,695.056910569106,459852,14298814.8023119
1182,BTC,2015-06-22,76359481,81473319,143614,265970,81473319,119345,73045405,357,9.35491062205807,362105,377606.509994864,49692386354.8938,565.210526315789,589237,14302639.8023119
1182,BTC,2015-06-23,76521278,81642081,168762,301923,81642081,125560,73170965,312,9.23206327220086,362245,346638.669144231,49692386354.8938,615.705035971223,521622,14306139.8023119
1182,BTC,2015-06-24,76663763,81792455,150374,268291,81792455,113093,73284058,312,10.1844877295897,362401,388258.908143305,49692386354.8938,549.703225806452,385564,14310039.8023119
1182,BTC,2015-06-25,76778925,81909950,117495,232327,81909950,111468,73395526,400,8.56591374487261,362553,374229.28472223,49692386354.8938,570.311258278146,358829,14313839.8023119
1182,BTC,2015-06-26,76941888,82079801,169851,291464,82079801,116432,73511958,518,13.0832029900623,362707,380267.813267809,49692386354.8938,561.254901960784,416877,14317689.8023119
1182,BTC,2015-06-27,77077778,82228265,148464,294816,82228265,106004,73617962,512,11.9698688171921,362836,316866.882846043,49692386354.8938,673.5546875,485407,14320914.8023119
1182,BTC,2015-06-28,77190570,82352029,123764,272208,82352029,99145,73717107,233,8.33091885965303,362977,347568.318876786,49490567918.5867,611.564285714286,412737,14324439.8023119
1182,BTC,2015-06-29,77341155,82505261,153232,290479,82505261,124180,73841287,492,10.7464736469133,363117,345715.922512853,49402014931.2275,613.741007194245,487113,14327939.8023119
1182,BTC,2015-06-30,77525285,82692225,186964,314219,82692225,155869,73997156,718,10.7157202523962,363262,363058.634956119,49402014931.2275,584.423611111111,598433,14331564.8023119
1182,BTC,2015-07-01,77689543,82863305,171080,309213,82863305,144112,74141268,426,9.07195421058232,363397,330130.104931736,49402014931.2275,642.716417910448,634471,14334939.8023119
1182,BTC,2015-07-02,77866195,83049925,186620,316505,83049925,142153,74283421,539,9.47342293579214,363551,379384.425298615,49402014931.2275,559.274509803922,476935,14338789.8023119
1182,BTC,2015-07-03,78032364,83220065,170140,301521,83220065,129719,74413140,366,9.68907676181115,363712,399430.613789137,49402014931.2275,531.20625,430264,14342814.8023119
1182,BTC,2015-07-04,78154173,83354241,134176,276011,83354241,104582,74517722,300,8.90978861115804,363864,379939.827236887,49402014931.2275,558.456953642384,388086,14346614.8023119
1182,BTC,2015-07-05,78294696,83507340,153099,308093,83507340,115084,74632806,524,9.97635416872111,364006,349400.121769854,49402014931.2275,607.269503546099,442218,14350164.8023119
1182,BTC,2015-07-06,78494608,83715372,208032,342304,83715372,174070,74806876,686,8.70467815011817,364187,443685.024715411,49402014931.2275,478.222222222222,507758,14354689.8023119
1182,BTC,2015-07-07,78686380,83923863,208491,325265,83923863,190747,74997623,556,6.56376222892224,364321,327685.471483119,49402014931.2275,647.511278195489,769014,14358039.8023119
1182,BTC,2015-07-08,78880961,84135722,211859,323720,84135722,201747,75199370,536,6.33814541432695,364482,394707.663734218,49402014931.2275,537.5625,737150,14362064.8023119
1182,BTC,2015-07-09,79066873,84324537,188815,327838,84324537,191163,75390533,667,6.94462499523255,364615,326556.427065988,49402014931.2275,649.75,744732,14365389.8023119
1182,BTC,2015-07-10,79258169,84513984,189447,322540,84513984,193020,75583553,1079,9.56507889204616,364769,393979.852769781,49402014931.2275,538.555555555556,644446,14369239.8023119
1182,BTC,2015-07-11,79414851,84684593,170609,319652,84684593,186200,75769753,692,6.88577986929296,364917,367817.390693486,49650905000.0761,579.768707482993,746482,14372939.8023119
1182,BTC,2015-07-12,79571336,84847908,163315,319924,84847908,208685,75978438,656,6.06200801856961,365052,350654.975663468,51076366303.4819,625.60447761194,776860,14376314.8023119
1182,BTC,2015-07-13,79727539,85010347,162439,295292,85010347,159695,76138133,813,8.62890658252989,365200,377672.711391694,51076366303.4819,580.850340136054,717927,14380014.8023119
1182,BTC,2015-07-14,79886125,85167440,157093,285663,85167440,122618,76260751,706,10.6109556440774,365344,371234.990540956,51076366303.4819,590.923076923077,716006,14383614.8023119
1182,BTC,2015-07-15,80027886,85318593,151153,275378,85318593,115570,76376321,585,11.0653863123541,365497,389660.770062282,51076366303.4819,562.980263157895,662799,14387439.8023119
1182,BTC,2015-07-16,80173553,85466059,147466,275546,85466059,114387,76490708,674,12.3386421363602,365631,342675.09885689,51076366303.4819,640.172932330827,699365,14390789.8023119
1182,BTC,2015-07-17,80312844,85606796,140737,253536,85606796,116906,76607614,487,10.2321371009504,365778,383920.851784952,51076366303.4819,571.397260273972,676601,14394464.8023119
1182,BTC,2015-07-18,80428263,85733334,126538,256550,85733334,130695,76738309,409,6.98322646116332,365927,377575.426629899,51076366303.4819,581.0,654657,14398189.8023119
1182,BTC,2015-07-19,80530772,85849345,116011,290272,85849345,120887,76859196,305,6.13521155500004,366079,386257.649385693,51076366303.4819,567.940397350993,639913,14401989.8023119
1182,BTC,2015-07-20,80685186,86012046,162701,284492,86012046,125258,76984454,376,8.15145860023184,366235,400973.526475891,51076366303.4819,547.096774193548,439029,14405889.8023119
1182,BTC,2015-07-21,80852866,86196006,183960,306641,86196006,133785,77118239,390,8.0135483877561,366362,324723.472255593,51076366303.4819,675.563492063492,535469,14409064.8023119
1182,BTC,2015-07-22,81013350,86370106,174100,295409,86370106,131259,77249498,391,8.12730456422485,366516,396089.268090014,51076366303.4819,553.843137254902,463088,14412914.8023119
1182,BTC,2015-07-23,81156712,86515900,145794,256817,86515900,109620,77359118,553,10.4700154587632,366656,356313.700708173,51076366303.4819,615.669064748201,401367,14416414.8023119
1182,BTC,2015-07-24,81298736,86661554,145654,272446,86661554,109918,77469036,628,11.2581717273185,366825,432995.150590274,51076366303.4819,506.636904761905,376293,14420639.8023119
1182,BTC,2015-07-25,81417792,86785219,123665,243110,86785219,100544,77569580,331,7.70961041488363,366979,393819.310267782,51607092412.9849,562.823529411765,354706,14424489.8023119
1182,BTC,2015-07-26,81526735,86911050,125831,299176,86911050,92776,77662356,260,6.52864058760337,367123,376473.626380401,52278304845.5917,596.412587412588,433771,14428089.8023119
1182,BTC,2015-07-27,81665473,87060339,149289,284086,87060339,115226,77777582,432,8.88156565986722,367272,387533.227068408,52278304845.5917,579.391891891891,532104,14431814.8023119
1182,BTC,2015-07-28,81818277,87215122,154783,298664,87215122,118350,77895932,626,10.3566776505871,367408,352982.710672475,52278304845.5917,636.103703703704,574467,14435214.8023119
1182,BTC,2015-07-29,81999906,87401741,186619,321636,87401741,143200,78039132,522,7.8551876484676,367560,398713.177514227,52278304845.5917,563.145695364238,840224,14439014.8023119
1182,BTC,2015-07-30,82152313,87562740,160999,275824,87562740,123577,78162709,471,8.4625082457904,367694,350089.331626638,52278304845.5917,641.360902255639,777652,14442364.8023119
1182,BTC,2015-07-31,82320912,87733974,171234,303744,87733974,147503,78310212,478,7.02720085930469,367845,398693.610496712,52278304845.5917,563.173333333333,756096,14446139.8023119
1182,BTC,2015-08-01,82466081,87883348,149374,298966,87883348,147481,78457693,279,5.39139309990141,368000,403394.571487071,52278304845.5917,556.61038961039,729843,14450014.8023119
1182,BTC,2015-08-02,82573926,88007637,124289,296891,88007637,103600,78561293,207,6.30281324570724,368151,394324.467760036,52278304845.5917,569.413333333334,428181,14453789.8023119
1182,BTC,2015-08-03,82720046,88155733,148096,297285,88155733,119844,78681137,357,8.67158981980416,368308,416713.180474125,52278304845.5917,538.820512820513,454972,14457714.8023119
1182,BTC,2015-08-04,82869731,88324972,169239,292475,88324972,132547,78813684,388,8.98047901126868,368444,352551.63814755,52278304845.5917,636.881481481482,797579,14461114.8023119
1182,BTC,2015-08-05,83044947,88500269,175297,316599,88500269,133758,78947442,441,9.35930525272373,368577,346847.157639838,52278304845.5917,647.356060606061,800967,14464439.8023119
1182,BTC,2015-08-06,83205705,88665041,164772,296112,88665041,134838,79082280,274,8.63838161084353,368720,370384.077733154,52278304845.5917,606.218309859155,785166,14468014.8023119
1182,BTC,2015-08-07,83351640,88811670,146629,273159,88811670,111345,79193625,336,10.195769600197,368857,369795.11130085,52278304845.5917,607.183823529412,498200,14471439.8023119
1182,BTC,2015-08-08,83471085,88946890,135220,272971,88946890,101512,79295137,374,12.4186701267499,369018,428754.322226649,52516565207.7143,526.075,350408,14475464.8023119
1182,BTC,2015-08-09,83573643,89054883,107993,267959,89054883,90534,79385671,392,13.7397145804253,369160,370405.61334017,52699842409.347,611.070921985816,368554,14479014.8023119
1182,BTC,2015-08-10,83720011,89200067,145184,293020,89200067,116841,79502512,452,10.7217248571513,369327,442458.349042204,52699842409.347,511.560240963855,450405,14483189.8023119
1182,BTC,2015-08-11,83865061,89348933,148866,269591,89348933,114741,79617253,460,10.3708265063903,369489,434074.23341972,52699842409.347,521.44099378882,410415,14487239.8023119
1182,BTC,2015-08-12,84010414,89505293,156360,278110,89505293,117898,79735151,472,11.597628253586,369615,330676.505143259,52699842409.347,684.488,503203,14490389.8023119
1182,BTC,2015-08-13,84157121,89658423,153130,276482,89658423,117507,79852658,499,12.569440223562,369762,389328.917875411,52699842409.347,581.369863013698,444049,14494064.8023119
1182,BTC,2015-08-14,84297554,89807950,149527,272838,89807950,111255,79963913,552,12.5543459714067,369904,374526.399152739,52699842409.347,604.347517730497,433368,14497614.8023119
1182,BTC,2015-08-15,84419083,89941195,133245,268405,89941195,94944,80058857,292,11.0760145811379,370041,363253.139561727,52699842409.347,623.102941176471,391478,14501039.8023119
1182,BTC,2015-08-16,84527957,90061497,120302,278647,90061497,89498,80148355,372,12.324209978331,370179,363155.732098098,52699842409.347,623.270072992701,378582,14504489.8023119
1182,BTC,2015-08-17,84673970,90213946,152449,284058,90213946,115049,80263404,489,13.3395198087208,370326,386266.274113881,52699842409.347,585.979452054795,425367,14508164.8023119
1182,BTC,2015-08-18,84833041,90376237,162291,302557,90376237,119798,80383202,555,15.3425444524546,370467,377321.020591911,52699842409.347,599.871428571429,479367,14511689.8023119
1182,BTC,2015-08-19,84986285,90536664,160427,288647,90536664,120151,80503353,556,13.9158242036302,370623,412711.134919917,52699842409.347,548.432258064516,414436,14515589.8023119
1182,BTC,2015-08-20,85132348,90687725,151061,277551,90687725,118230,80621583,529,13.6517331434886,370773,393449.034009851,52699842409.347,575.281879194631,407439,14519339.8023119
1182,BTC,2015-08-21,85288169,90851621,163896,282808,90851621,113792,80735375,395,12.6815827173712,370938,444678.562274757,52699842409.347,509.006097560975,366044,14523464.8023119
1182,BTC,2015-08-22,85432378,91012523,160902,297720,91012523,105665,80841040,414,12.2890293740376,371096,427925.740766985,54207364887.4297,544.063694267516,378241,14527414.8023119
1182,BTC,2015-08-23,85548564,91143915,131392,287131,91143915,94529,80935569,334,11.1529465860906,371230,365755.811852871,54256630327.89,637.12030075188,408776,14530764.8023119
1182,BTC,2015-08-24,85711393,91306128,162213,308366,91306128,125368,81060937,599,16.3100835878456,371385,418611.069181774,54256630327.89,556.675324675325,464596,14534639.8023119
1182,BTC,2015-08-25,85857070,91462295,156167,288603,91462295,121973,81182910,788,17.1405343520667,371520,366589.348225243,54256630327.89,635.671641791045,486048,14538014.8023119
1182,BTC,2015-08-26,86002801,91618118,155823,285843,91618118,122852,81305762,689,13.0454944350383,371681,438996.755709413,54256630327.89,530.825,384749,14542039.8023119
1182,BTC,2015-08-27,86143693,91775734,157616,278338,91775734,120079,81425841,390,12.6696949652805,371819,372305.596394966,54256630327.89,625.911764705882,438590,14545464.8023119
1182,BTC,2015-08-28,86298884,91937079,161345,298358,91937079,120385,81546226,494,14.0943282764981,371973,415773.866495373,54256630327.89,560.474025974026,413004,14549339.8023119
1182,BTC,2015-08-29,86427498,92079953,142874,287856,92079953,107489,81653715,307,9.0297910265362,372133,431673.622069162,54256630327.89,539.830188679245,351047,14553339.8023119
1182,BTC,2015-08-30,86539892,92207739,127786,285108,92207739,98339,81752054,200,8.09824147015121,372283,410653.05935481,54256630327.89,567.463087248322,372106,14557089.8023119
1182,BTC,2015-08-31,86697769,92365885,158146,303949,92365885,127260,81879314,416,10.1304653961522,372440,424770.9874099,54256630327.89,548.602564102564,454286,14561014.8023119
1182,BTC,2015-09-01,86860277,92532671,166786,308740,92532671,130410,82009724,439,11.1202312655191,372594,420622.661577624,54256630327.89,554.013071895425,451843,14564864.8023119
1182,BTC,2015-09-02,87029627,92710080,177409,291180,92710080,150066,82159790,530,9.46757029399904,372754,441245.692001553,54256630327.89,528.119496855346,755693,14568864.8023119
1182,BTC,2015-09-03,87189857,92876023,165943,303789,92876023,128682,82288472,324,9.67057130890723,372900,393609.594771624,54256630327.89,592.034482758621,494697,14572514.8023119
1182,BTC,2015-09-04,87321232,93016619,140596,266109,93016619,103973,82392445,404,10.8317316639922,373056,436729.994510794,55936109547.9582,550.096774193548,355466,14576414.8023119
1182,BTC,2015-09-05,87458380,93175941,159322,317186,93175941,124218,82516663,250,7.46809196180223,373203,419814.761580406,56957648455.01,582.712328767123,448417,14580089.8023119
1182,BTC,2015-09-06,87582709,93313871,137930,294550,93313871,106293,82622956,348,9.16890314560197,373347,409551.687553861,56957648455.01,597.314685314685,411318,14583689.8023119
1182,BTC,2015-09-07,87732667,93486799,172928,318282,93486799,125467,82748423,259,8.26870362901576,373499,435286.899237247,56957648455.01,562.0,477577,14587489.8023119
1182,BTC,2015-09-08,87895941,93671109,184310,335125,93671109,125379,82873802,370,11.2120508637477,373635,385061.878193339,56957648455.01,635.303703703704,692282,14590889.8023119
1182,BTC,2015-09-09,88052227,93853875,182766,307412,93853875,126457,83000259,525,10.4594248616086,373784,426744.417568832,56957648455.01,573.25,728354,14594614.8023119
1182,BTC,2015-09-10,88198297,94020491,166616,290566,94020491,124951,83125210,423,11.1125946379864,373955,483225.004684141,56957648455.01,506.24705882353,698637,14598889.8023119
1182,BTC,2015-09-11,88337873,94223020,202529,333537,94223020,180002,83305212,463,6.82862571898546,374113,445041.764395125,56957648455.01,549.681528662421,698082,14602839.8023119
1182,BTC,2015-09-12,88467284,94380115,157095,282829,94380115,137740,83442952,250,5.75137724291281,374248,386704.87805399,56957648455.01,632.60447761194,662130,14606214.8023119
1182,BTC,2015-09-13,88586309,94517552,137437,323188,94517552,146048,83589000,261,5.86988309992352,374399,430299.912118155,56957648455.01,568.513333333333,623393,14609989.8023119
1182,BTC,2015-09-14,88749608,94682374,164822,307431,94682374,166715,83755715,457,7.64659667416585,374551,431413.118320462,56957648455.01,567.046357615894,742593,14613789.8023119
1182,BTC,2015-09-15,88917399,94856160,173786,327001,94856160,162999,83918714,470,8.1522478472252,374711,456176.749724883,56957648455.01,536.264150943397,697780,14617789.8023119
1182,BTC,2015-09-16,89078565,95023330,167170,299594,95023330,167269,84085983,445,8.65494115082209,374853,413738.973351701,56957648455.01,591.2695035461,675848,14621339.8023119
1182,BTC,2015-09-17,89233530,95196567,173237,317168,95196567,259279,84345262,454,5.06616467464839,374997,410898.518639291,57320908601.7798,599.153846153846,705267,14624939.8023119
1182,BTC,2015-09-18,89398474,95367228,170661,315123,95367228,161504,84506766,317,8.01335841688094,375144,442294.442479881,59335351233.8666,576.184931506849,556745,14628614.8023119
1182,BTC,2015-09-19,89538212,95510986,143758,270845,95510986,114851,84621617,435,9.61107618119224,375269,371125.343375301,59335351233.8666,686.677419354839,469263,14631739.8023119
1182,BTC,2015-09-20,89649527,95673834,162848,341240,95673834,109158,84730775,400,8.44042517415361,375397,379320.13169634,59335351233.8666,671.842519685039,479238,14634939.8023119
1182,BTC,2015-09-21,89818012,95880145,206311,351215,95880145,131679,84862454,694,12.3508447473081,375529,394979.821691903,59335351233.8666,645.206106870229,602381,14638239.8023119
1182,BTC,2015-09-22,89982546,96087138,206993,356587,96087138,136784,84999238,545,11.0341966096262,375686,461169.400218039,59335351233.8666,552.602564102564,486307,14642164.8023119
1182,BTC,2015-09-23,90136861,96251184,164046,296839,96251184,131400,85130638,489,9.70404403820046,375844,470572.334116348,59335351233.8666,541.56050955414,459780,14646114.8023119
1182,BTC,2015-09-24,90291559,96413016,161832,296349,96413016,125367,85256005,408,9.72217077702944,375984,415434.062408079,59335351233.8666,613.438848920864,487708,14649614.8023119
1182,BTC,2015-09-25,90452346,96577243,164227,295739,96577243,128166,85384171,509,10.7486652902256,376148,482220.903467754,59335351233.8666,528.478527607362,428839,14653714.8023119
1182,BTC,2015-09-26,90604408,96718653,141410,310840,96718653,115622,85499793,304,8.9232400683005,376295,442147.275549132,59335351233.8666,576.376712328767,437717,14657389.8023119
1182,BTC,2015-09-27,90747970,96851324,132671,326483,96851324,108749,85608542,201,7.00979295095109,376444,437083.648204089,59335351233.8666,583.054054054054,442061,14661114.8023119
1182,BTC,2015-09-28,90915558,97016215,164891,304080,97016215,138570,85747112,510,10.8172210857966,376587,420450.589789012,59335351233.8666,606.119718309859,514718,14664689.8023119
1182,BTC,2015-09-29,91122405,97195896,179681,354682,97195896,140664,85887776,615,12.1440614048211,376761,512703.73640242,59335351233.8666,497.057803468208,464740,14669039.8023119
1182,BTC,2015-09-30,91288661,97360640,164744,330801,97360640,139848,86027624,606,10.21076680904,376909,434911.580131432,59335351233.8666,585.965986394558,514060,14672739.8023119
1182,BTC,2015-10-01,91439076,97519534,158894,298721,97519534,134327,86161951,566,11.8686006313632,377058,442573.858075861,59999898065.9031,582.27027027027,457235,14676464.8023119
1182,BTC,2015-10-02,91607803,97684769,165235,312824,97684769,139746,86301697,486,12.4292371391643,377196,420310.574413335,60813224039.4403,621.423357664234,528039,14679914.8023119
1182,BTC,2015-10-03,91738825,97823302,138533,260197,97823302,119567,86421264,287,8.4859003425441,377341,438413.293059509,60813224039.4403,595.763888888889,392751,14683539.8023119
1182,BTC,2015-10-04,91830803,97941406,118104,306802,97941406,103531,86524795,474,8.46047755216196,377494,463834.693010936,60813224039.4403,563.111842105263,372704,14687364.8023119
1182,BTC,2015-10-05,91964033,98076865,135459,290837,98076865,125548,86650343,626,10.9603216362561,377647,463255.576183022,60813224039.4403,563.815789473684,423255,14691189.8023119
1182,BTC,2015-10-06,92127409,98228274,151409,326169,98228274,144510,86794853,844,12.0883937825761,377789,431154.266555067,60813224039.4403,605.794326241135,542647,14694739.8023119
1182,BTC,2015-10-07,92280285,98389112,160838,310230,98389112,134931,86929784,657,10.8743574951045,377922,405485.160132789,60813224039.4403,644.143939393939,686499,14698064.8023119
1182,BTC,2015-10-08,92451467,98569642,180530,315785,98569642,140348,87070132,773,14.4248086144695,378062,425302.497182732,60813224039.4403,614.129496402878,658225,14701564.8023119
1182,BTC,2015-10-09,92574395,98699995,130353,266420,98699995,114644,87184776,734,11.2136360172091,378188,386157.57973831,60813224039.4403,676.384,595055,14704714.8023119
1182,BTC,2015-10-10,92693865,98844776,144781,323864,98844776,127005,87311781,714,9.46703545260557,378348,487926.058436697,60813224039.4403,535.308176100629,632631,14708714.8023119
1182,BTC,2015-10-11,92794085,98959632,114856,294966,98959632,104550,87416331,566,9.41515324268532,378494,442592.815472584,60813224039.4403,590.137931034483,541174,14712364.8023119
1182,BTC,2015-10-12,92942474,99101238,141606,310831,99101238,134410,87550741,734,10.5691325141667,378636,428610.213518157,60813224039.4403,609.390070921986,575099,14715914.8023119
1182,BTC,2015-10-13,93088910,99247503,146265,307231,99247503,134878,87685619,1019,12.5063620013572,378773,415369.098612771,60813224039.4403,628.816176470588,555196,14719339.8023119
1182,BTC,2015-10-14,93251991,99414429,166926,311033,99414429,141985,87827604,952,12.060282903217,378925,461521.860027047,60813224039.4403,565.933774834437,526125,14723139.8023119
1182,BTC,2015-10-15,93446154,99614787,200358,366270,99614787,153495,87981099,988,12.9543157657997,379091,503741.706948831,60848950069.6528,518.806060606061,538090,14727289.8023119
1182,BTC,2015-10-16,93621183,99792590,177803,336304,99792590,143286,88124385,924,12.9142360535426,379235,438013.466151413,60883825480.0983,597.0,577965,14730889.8023119
1182,BTC,2015-10-17,93784289,99963831,171241,370783,99963831,135911,88260296,608,11.2474429329584,379371,412195.921493562,60883825480.0983,634.392592592593,599779,14734289.8023119
1182,BTC,2015-10-18,93927459,100114591,150760,335438,100114591,119706,88380002,398,9.00999091507067,379516,456132.928641051,60883825480.0983,573.284722222222,532674,14737914.8023119
1182,BTC,2015-10-19,94114575,100297876,183285,349881,100297876,143969,88523971,613,10.3218126035099,379681,500923.029995241,60883825480.0983,522.024390243902,510530,14742039.8023119
1182,BTC,2015-10-20,94323455,100490061,192185,403162,100490061,146349,88670320,621,10.7351413977023,379809,388995.853374415,60883825480.0983,672.228346456693,689353,14745239.8023119
1182,BTC,2015-10-21,94508366,100680448,190387,358001,100680448,150199,88820519,466,9.42103903269349,379953,436933.556341431,60883825480.0983,598.475524475524,565292,14748839.8023119
1182,BTC,2015-10-22,94681375,100865973,185525,345101,100865973,147402,88967921,645,10.7114629455419,380101,445366.976897021,60883825480.0983,587.142857142857,546734,14752539.8023119
1182,BTC,2015-10-23,94885676,101049251,183278,371262,101049251,143468,89111389,608,10.1592868649368,380250,462633.201224977,60883825480.0983,565.22972972973,555677,14756264.8023119
1182,BTC,2015-10-24,95047188,101235714,186463,378012,101235714,140128,89251517,748,9.75319116094485,380395,443481.670256097,60883825480.0983,589.638888888889,525396,14759889.8023119
1182,BTC,2015-10-25,95226570,101404303,168589,373325,101404303,131488,89383005,798,10.8003864915947,380550,474838.246993546,60883825480.0983,550.701298701299,527245,14763764.8023119
1182,BTC,2015-10-26,95440959,101569074,164771,376435,101569074,116400,89499405,828,13.3810620570232,380714,494920.327032119,60883825480.0983,528.355828220859,477430,14767864.8023119
1182,BTC,2015-10-27,95594667,101746203,177129,355912,101746203,153740,89653145,1204,11.9802985637993,380861,445054.728054387,60883825480.0983,587.554794520548,546607,14771539.8023119
1182,BTC,2015-10-28,95763573,101927546,181343,353838,101927546,160175,89813320,1282,12.6005981419993,381000,423318.131318189,60883825480.0983,617.724637681159,592792,14775014.8023119
1182,BTC,2015-10-29,95968155,102113560,186014,386836,102113560,161062,89974382,1621,14.5908341333854,381151,469291.458058825,62045283043.7857,567.84,591662,14778789.8023119
1182,BTC,2015-10-30,96152615,102304594,191034,380417,102304594,166695,90141077,1923,15.4195536502658,381322,538884.861391027,62253982449.7608,496.170588235294,517576,14783064.8023119
1182,BTC,2015-10-31,96310287,102486464,181870,368270,102486464,155400,90296477,1386,11.9674096266476,381469,460731.361463633,62253982449.7608,580.335616438356,540260,14786739.8023119
1182,BTC,2015-11-01,96469793,102657348,170884,393798,102657348,152488,90448965,1177,11.3384209589684,381622,474585.226276999,62253982449.7608,563.394736842105,541943,14790564.8023119
1182,BTC,2015-11-02,96690684,102862195,204847,399359,102862195,172108,90621073,2182,14.9750970162847,381775,473066.085105016,62253982449.7608,565.203947368421,625830,14794389.8023119
1182,BTC,2015-11-03,96902504,103100359,238164,449531,103100359,186362,90807435,2993,19.6620447409082,381930,478822.467292192,62253982449.7608,558.409090909091,683601,14798264.8023119
1182,BTC,2015-11-04,97161114,103365877,265518,497717,103365877,204198,91011633,3163,54.153208815509,382085,483983.380836315,62253982449.7608,552.454545454545,784127,14802139.8023119
1182,BTC,2015-11-05,97387372,103594589,228712,445970,103594589,182809,91194442,2871,20.4004599883197,382231,450315.682754918,62253982449.7608,593.758620689655,729976,14805789.8023119
1182,BTC,2015-11-06,97580367,103806509,211920,431877,103806509,166893,91361335,2207,16.7842446809363,382376,448079.204544703,62253982449.7608,596.722222222222,658056,14809414.8023119
1182,BTC,2015-11-07,97755048,103999588,193079,366631,103999588,151497,91512832,1590,14.9854940077008,382528,483089.459991499,62253982449.7608,553.476821192053,536131,14813214.8023119
1182,BTC,2015-11-08,97905095,104182680,183092,378068,104182680,132550,91645382,1166,14.7262283755974,382667,438122.952969191,62253982449.7608,610.282608695652,548014,14816689.8023119
1182,BTC,2015-11-09,98118312,104380158,197478,419120,104380158,159836,91805218,2265,19.2541798755039,382816,463726.081476383,62253982449.7608,576.587837837838,623500,14820414.8023119
1182,BTC,2015-11-10,98319870,104579268,199110,395405,104579268,161962,91967180,1913,18.2112084565143,382962,451385.229031967,62253982449.7608,592.351724137931,606811,14824064.8023119
1182,BTC,2015-11-11,98507886,104774816,195548,375671,104774816,158929,92126109,2067,21.4347861624916,383130,539679.50781408,64200880178.4793,510.934131736527,524536,14828264.8023119
1182,BTC,2015-11-12,98679454,104965587,190771,370971,104965587,157847,92283956,1956,19.0648549453718,383291,533263.132828293,65848255179.7026,530.35,524626,14832289.8023119
1182,BTC,2015-11-13,98847004,105154471,188884,358654,105154471,154827,92438783,1863,18.471039630664,383451,537782.51189091,65848255179.7026,525.893081761006,493297,14836289.8023119
1182,BTC,2015-11-14,98990870,105334585,180114,387249,105334585,150474,92589257,1708,20.6135409213727,383593,471560.83501092,65848255179.7026,599.744680851064,541817,14839839.8023119
1182,BTC,2015-11-15,99158298,105510589,176004,418646,105510589,143369,92732626,1179,15.1643379724062,383753,523221.636144259,65848255179.7026,540.528301886792,498394,14843839.8023119
1182,BTC,2015-11-16,99368298,105705392,194803,402885,105705392,158316,92890942,1725,16.9148221006903,383926,570146.973466912,65848255179.7026,496.040697674419,521451,14848164.8023119
1182,BTC,2015-11-17,99561819,105905655,200263,378292,105905655,156688,93047630,1206,12.3929656538378,384075,488057.45166078,65848255179.7026,579.472972972973,557605,14851889.8023119
1182,BTC,2015-11-18,99765590,106120839,215184,408636,106120839,165269,93212899,961,11.002639639033,384228,498712.819082969,65848255179.7026,567.092105263158,598407,14855714.8023119
1182,BTC,2015-11-19,99944754,106312553,191714,358077,106312553,154483,93367382,1203,13.2322647186963,384364,442848.388759386,65848255179.7026,638.62962962963,609870,14859114.8023119
1182,BTC,2015-11-20,100119053,106499889,187336,358944,106499889,155774,93523156,912,14.3475149403095,384531,549916.51846332,65848255179.7026,514.289156626506,505331,14863289.8023119
1182,BTC,2015-11-21,100290402,106682402,182513,374913,106682402,151035,93674191,604,9.83882871871679,384705,568326.00455011,65848255179.7026,497.630057803468,468868,14867639.8023119
1182,BTC,2015-11-22,100428994,106844785,162383,376880,106844785,129659,93803850,595,8.82029147172028,384877,561834.075219313,65848255179.7026,503.380116959064,437165,14871939.8023119
1182,BTC,2015-11-23,100601649,107022293,177508,342630,107022293,145272,93949122,739,9.26851262678431,385040,541000.007135233,65848255179.7026,522.765432098766,515721,14876014.8023119
1182,BTC,2015-11-24,100777833,107218273,195980,384812,107218273,152324,94101446,797,9.47837156932282,385196,555898.811066043,72061768578.8121,556.761290322581,523031,14879914.8023119
1182,BTC,2015-11-25,100964887,107407259,188986,364776,107407259,151861,94253307,1043,12.4242598671531,385344,539939.187949651,72722780642.5472,578.47619047619,558613,14883614.8023119
1182,BTC,2015-11-26,101160066,107601731,194472,387683,107601731,164671,94417978,1617,12.8809059653997,385520,636252.823259918,72722780642.5472,490.908571428572,536883,14888014.8023119
1182,BTC,2015-11-27,101332033,107783130,181399,360741,107783130,160235,94578213,1281,13.5980031774218,385653,483524.174584577,72722780642.5472,645.969696969697,649564,14891339.8023119
1182,BTC,2015-11-28,101487647,107976471,193341,414842,107976471,165676,94743889,973,11.8519648672098,385807,555329.450969044,72722780642.5472,562.444444444444,551229,14895189.8023119
1182,BTC,2015-11-29,101641807,108122875,146404,322110,108122875,129850,94873739,1013,10.6684066604907,385956,546827.5143255,72722780642.5472,571.189189189189,453507,14898914.8023119
1182,BTC,2015-11-30,101871300,108355007,232132,491474,108355007,182648,95056387,1912,13.4511845583468,386118,588366.03084114,72722780642.5472,530.863354037267,672511,14902964.8023119
1182,BTC,2015-12-01,102075423,108576061,221054,414207,108576061,178112,95234499,1691,13.9606702027774,386285,609841.991444731,72722780642.5472,512.168674698795,567073,14907139.8023119
1182,BTC,2015-12-02,102280969,108801581,225520,428537,108801581,183523,95418022,2083,14.9956806096506,386446,593220.97177721,72722780642.5472,526.51875,655984,14911164.8023119
1182,BTC,2015-12-03,102474436,108991641,190060,361836,108991641,164774,95582796,1442,12.6372618047816,386588,516068.070487743,72722780642.5472,605.234042553191,643185,14914714.8023119
1182,BTC,2015-12-04,102686110,109210622,218981,435394,109210622,173586,95756382,1510,15.4348008343128,386741,554172.739688994,72722780642.5472,563.618421052632,588731,14918539.8023119
1182,BTC,2015-12-05,102879584,109435718,225096,456956,109435718,186194,95942576,3433,26.3784125786534,386916,635145.579825195,72722780642.5472,491.764367816092,574138,14922914.8023119
1182,BTC,2015-12-06,103050554,109636011,200293,430509,109636011,179712,96122288,3217,30.5385229238818,387075,588600.725730323,72883273730.7907,531.822784810127,594406,14926889.8023119
1182,BTC,2015-12-07,103286272,109857622,221611,436334,109857622,192830,96315118,2706,16.5862036803296,387222,575466.701018876,79102380900.226,590.376712328767,688184,14930564.8023119
1182,BTC,2015-12-08,103499200,110087766,230144,456220,110087766,195221,96510339,2482,15.4131783745285,387397,689469.701264098,79102380900.226,492.758620689655,617037,14934939.8023119
1182,BTC,2015-12-09,103761694,110358228,270462,489496,110358228,220323,96730662,3678,17.9188279041627,387565,657514.627574091,79102380900.226,516.706586826347,687723,14939139.8023119
1182,BTC,2015-12-10,104008686,110639054,280826,481149,110639054,212036,96942698,2613,15.3082635865097,387781,855162.497488459,79102380900.226,397.283720930232,532227,14944539.8023119
1182,BTC,2015-12-11,104225028,110901344,262290,458240,110901344,210259,97152957,3220,17.9594299398168,387941,625654.390796279,79102380900.226,543.018867924528,637256,14948539.8023119
1182,BTC,2015-12-12,104465780,111179454,278110,532460,111179454,204141,97357098,3128,16.4731849629399,388103,640422.484244879,79102380900.226,530.496894409938,689175,14952589.8023119
1182,BTC,2015-12-13,104654268,111403355,223901,478309,111403355,189914,97547012,4596,27.4228160573979,388245,566451.158822616,79102380900.226,599.77304964539,688830,14956139.8023119
1182,BTC,2015-12-14,104942769,111671576,268221,529504,111671576,231477,97778489,3378,20.9514544058944,388440,765780.65234205,79102380900.226,443.654639175258,629963,14961014.8023119
1182,BTC,2015-12-15,105168975,111934018,262442,495422,111934018,223998,98002487,3544,19.4576054277121,388623,717762.305111048,79102380900.226,473.335164835165,621391,14965589.8023119
1182,BTC,2015-12-16,105411089,112188841,254823,483830,112188841,220420,98222907,3994,20.1029471020725,388786,644392.718951392,79102380900.226,527.228395061729,676312,14969664.8023119
1182,BTC,2015-12-17,105634796,112434817,245976,457925,112434817,216297,98439204,3963,19.3178978709804,388941,613662.949440407,79102380900.226,553.62987012987,676607,14973539.8023119
1182,BTC,2015-12-18,105859932,112680196,245379,452694,112680196,213847,98653051,3670,18.9928485737344,389110,679976.759763275,81054834554.7245,511.970238095238,611859,14977764.8023119
1182,BTC,2015-12-19,106056576,112933591,253395,505494,112933591,213876,98866927,3439,18.1368232047737,389267,726525.895199366,93448670796.3238,552.435897435898,653255,14981689.8023119
1182,BTC,2015-12-20,106244487,113159239,225648,474678,113159239,193847,99060774,3653,20.3515689378759,389432,775435.866497974,93448670796.3238,517.591463414634,600066,14985814.8023119
1182,BTC,2015-12-21,106489339,113414634,255395,502798,113414634,229444,99290218,5176,23.178758688742,389581,708657.98679204,93448670796.3238,566.364864864865,766527,14989539.8023119
1182,BTC,2015-12-22,106706490,113663619,248985,486901,113663619,222717,99512935,5365,21.532137018901,389731,695741.827163135,93448670796.3238,576.879194630872,749793,14993289.8023119
1182,BTC,2015-12-23,106944548,113918292,254673,473394,113918292,221075,99734010,4948,20.3042281703513,389888,737514.154356877,93448670796.3238,544.205128205129,686930,14997214.8023119
1182,BTC,2015-12-24,107151055,114155882,237590,449027,114155882,210228,99944238,5351,22.28498468485,390026,645430.738848364,93448670796.3238,621.846715328467,729631,15000664.8023119
1182,BTC,2015-12-25,107308264,114351370,195488,377893,114351370,180383,100124621,4135,21.6942443382145,390188,759274.276465888,93448670796.3238,528.608695652174,528243,15004714.8023119
1182,BTC,2015-12-26,107468558,114538696,187326,420281,114538696,179363,100303984,2963,15.0513509389515,390359,792591.448519269,93448670796.3238,506.388235294118,542835,15008989.8023119
1182,BTC,2015-12-27,107624431,114711155,172459,406940,114711155,160271,100464255,1008,9.03108495300479,390564,955761.645962573,93448670796.3238,419.936274509804,447306,15014114.8023119
1182,BTC,2015-12-28,107811953,114913590,202435,412195,114913590,173129,100637384,1616,12.4318229520789,390715,701979.265402704,93448670796.3238,571.753333333333,656115,15017889.8023119
1182,BTC,2015-12-29,108025892,115125774,212184,415822,115125774,184618,100822002,1324,11.6881429294928,390874,735371.016618904,93448670796.3238,545.791139240506,621074,15021864.8023119
1182,BTC,2015-12-30,108200262,115333057,207283,406413,115333057,176447,100998449,2474,12.9975846488994,391039,787166.629127966,93448670796.3238,509.878048780488,554078,15025989.8023119
1182,BTC,2015-12-31,108387304,115516124,183067,356182,115516124,155362,101153811,687,7.48315306312477,391181,709471.084071815,99178743060.3541,600.404255319149,554895,15029539.8023119
1182,BTC,2016-01-01,108515963,115662053,145929,317140,115662053,124092,101277903,823,7.71589899918012,391316,696536.26589962,103880340815.456,640.544776119403,493407,15032914.8023119
1182,BTC,2016-01-02,108713109,115844205,182152,420430,115844205,149038,101426941,747,6.9641286586119,391461,745753.664797382,103880340815.456,598.270833333333,579743,15036539.8023119
1182,BTC,2016-01-03,108866747,116017807,173602,394843,116017807,142608,101569549,468,6.30082435106551,391606,750361.168577693,103880340815.456,594.597222222223,554655,15040164.8023119
1182,BTC,2016-01-04,109072896,116233645,215838,419331,116233645,181354,101750903,729,5.88389771617279,391787,945927.914840389,103880340815.456,471.666666666667,556970,15044689.8023119
1182,BTC,2016-01-05,109287268,116456117,222472,436708,116456117,182371,101933274,1020,7.63607809128776,391944,808425.297333827,103880340815.456,551.891025641026,641778,15048614.8023119
1182,BTC,2016-01-06,109483261,116662294,206177,380457,116662294,172090,102105364,1051,7.77207803361764,392085,725577.303308983,103880340815.456,614.907142857142,662380,15052139.8023119
1182,BTC,2016-01-07,109686840,116889948,227654,431308,116889948,190234,102295598,1414,8.44525092082577,392232,765107.816826314,103880340815.456,583.13698630137,704715,15055814.8023119
1182,BTC,2016-01-08,109905967,117107191,217243,414855,117107191,181407,102477005,922,6.59043879218668,392405,891672.131321838,103880340815.456,500.366279069767,583649,15060139.8023119
1182,BTC,2016-01-09,110105865,117330379,223188,452714,117330379,179968,102656973,577,4.72046227266659,392556,793591.917265982,103880340815.456,562.206666666667,638665,15063914.8023119
1182,BTC,2016-01-10,110287708,117535942,205563,434918,117535942,161317,102818290,1159,7.19614133584786,392731,911209.361491024,103880340815.456,489.637931034483,522421,15068289.8023119
1182,BTC,2016-01-11,110512278,117768798,232856,449865,117768798,191196,103009486,2368,9.54073710637226,392901,880416.270313419,103880340815.456,506.763313609468,656381,15072539.8023119
1182,BTC,2016-01-12,110729747,118007700,238902,458913,118007700,194874,103204360,884,6.57037863892377,393071,884329.73633013,103880340815.456,504.520710059172,606917,15076789.8023119
1182,BTC,2016-01-13,110951982,118232321,224621,427269,118232321,188131,103392491,1213,7.49233188939617,393219,813376.317426201,110281664454.655,582.333333333333,676355,15080489.8023119
1182,BTC,2016-01-14,111168395,118457547,225226,428984,118457547,183182,103575673,902,6.70657567067086,393352,764726.990659899,113354299801.471,636.636363636364,718566,15083814.8023119
1182,BTC,2016-01-15,111379752,118681245,223698,418527,118681245,183642,103759315,1243,9.41131532863098,393474,693245.319519676,113354299801.471,702.280991735538,785503,15086864.8023119
1182,BTC,2016-01-16,111631976,118936943,255698,503116,118936943,191300,103950615,1027,7.70473005332389,393616,796952.197474575,113354299801.471,610.893617021276,745876,15090414.8023119
1182,BTC,2016-01-17,111855673,119187124,250181,539865,119187124,204128,104154743,9338,50.7435564329364,393767,852801.508486736,113354299801.471,570.886666666667,754065,15094189.8023119
1182,BTC,2016-01-18,112111864,119443659,256535,476544,119443659,213905,104368648,6709,44.235306671215,393940,975032.518745586,113354299801.471,499.319767441861,665508,15098514.8023119
1182,BTC,2016-01-19,112319724,119655174,211515,420013,119655174,186858,104555506,5804,47.1193586097214,394073,744363.20596624,113354299801.471,654.05303030303,773838,15101839.8023119
1182,BTC,2016-01-20,112673113,119925429,270255,626659,119925429,209071,104764577,4454,18.9748987957386,394225,864656.26057671,113354299801.471,563.059602649006,862095,15105639.8023119
1182,BTC,2016-01-21,112945080,120199471,274042,518672,120199471,222743,104987320,7506,23.646022433627,394362,771728.725120092,113354299801.471,630.860294117647,840199,15109064.8023119
1182,BTC,2016-01-22,113225649,120459908,260437,502349,120459908,213683,105201003,8342,36.1174254508676,394538,988138.48946849,113354299801.471,492.697142857143,661855,15113464.8023119
1182,BTC,2016-01-23,113447841,120696877,236969,473699,120696877,190400,105391403,7887,156.345301833345,394717,1017408.87646286,113354299801.471,478.522471910112,571501,15117939.8023119
1182,BTC,2016-01-24,113649171,120933635,236758,488296,120933635,201425,105592828,14058,334.388995265828,394888,963784.707847577,113354299801.471,505.147058823529,619085,15122214.8023119
1182,BTC,2016-01-25,113921054,121209292,275657,518510,121209292,222150,105814978,6246,78.1790062164046,395050,930686.345351349,113354299801.471,523.111801242236,719355,15126264.8023119
1182,BTC,2016-01-26,114197283,121498472,289180,535543,121498472,230523,106045501,10595,45.0901411599839,395210,928752.500138677,116485100199.799,538.679245283019,742775,15130264.8023119
1182,BTC,2016-01-27,114471217,121778625,280153,530065,121778625,229677,106275178,13870,60.502769433361,395365,924841.84249648,120033340651.237,557.435064935065,744016,15134139.8023119
1182,BTC,2016-01-28,114764697,122073139,294514,523389,122073139,225025,106500203,7433,27.0386376866466,395511,870894.093509292,120033340651.237,591.965517241379,797069,15137789.8023119
1182,BTC,2016-01-29,115088961,122367390,294251,532761,122367390,224394,106724597,6813,31.9771393912349,395680,1014389.42381865,120033340651.237,508.226190476191,686997,15142014.8023119
1182,BTC,2016-01-30,115332696,122617665,250275,498022,122617665,194794,106919391,4746,17.5696543210243,395867,1113010.47763266,120033340651.237,463.193548387097,567548,15146689.8023119
1182,BTC,2016-01-31,115539688,122841805,224140,480576,122841805,176045,107095436,1674,9.68202413785754,396048,1080228.96286368,120033340651.237,477.25,554537,15151214.8023119
1182,BTC,2016-02-01,115909956,123123018,281213,601242,123123018,222398,107317834,7085,24.0720214113843,396209,993678.953443163,120033340651.237,518.81875,776969,15155239.8023119
1182,BTC,2016-02-02,116327797,123446102,323084,689099,123446102,241722,107559556,3509,15.7974968990271,396389,1070104.47820258,120033340651.237,481.765363128492,803890,15159739.8023119
1182,BTC,2016-02-03,116664030,123694333,248231,543826,123694333,191224,107750780,950,8.24868294746078,396568,1067096.03364983,120033340651.237,483.123595505618,645763,15164214.8023119
1182,BTC,2016-02-04,116882665,123944672,250339,466039,123944672,200661,107951441,1924,12.3849302587879,396736,1012632.86143373,120033340651.237,509.107784431138,657826,15168414.8023119
1182,BTC,2016-02-05,117142443,124218637,273965,506917,124218637,225488,108176929,2584,15.4674447376737,396924,1118838.56698107,120033340651.237,460.780748663102,646794,15173114.8023119
1182,BTC,2016-02-06,117371416,124485617,266980,486174,124485617,224156,108401085,2220,13.9986964513466,397124,1189090.0951901,120033340651.237,433.557788944724,603149,15178114.8023119
1182,BTC,2016-02-07,117586831,124763364,277747,530583,124763364,212190,108613275,2251,14.33488038706,397300,1232685.81414049,140421880266.127,489.262857142857,700184,15182514.8023119
1182,BTC,2016-02-08,117830725,125027010,263646,476131,125027010,224755,108838030,1792,11.6978784823573,397448,1068063.38999481,144116447847.349,579.530612244898,819055,15186214.8023119
1182,BTC,2016-02-09,118099317,125305149,278139,508703,125305149,231240,109069270,1317,9.62563672079506,397624,1328126.8812272,144116447847.349,466.051428571429,696156,15190614.8023119
1182,BTC,2016-02-10,118363207,125583212,278063,500501,125583212,235527,109304797,1624,11.2345849594361,397788,1178794.19490792,144116447847.349,525.092024539877,738433,15194714.8023119
1182,BTC,2016-02-11,118616293,125867205,283993,502599,125867205,220934,109525731,1573,12.0293354620675,397980,1375564.97325216,144116447847.349,449.979057591623,639298,15199514.8023119
1182,BTC,2016-02-12,118849510,126137916,270711,475955,126137916,202527,109728258,1840,13.1597695188723,398151,1220066.12659612,144116447847.349,507.329411764706,615090,15203789.8023119
1182,BTC,2016-02-13,119056340,126377050,239134,446315,126377050,184675,109912933,1968,14.0694099863926,398307,1117869.98776124,144116447847.349,553.709677419355,630542,15207689.8023119
1182,BTC,2016-02-14,119253000,126604335,227285,495579,126604335,186088,110099021,2137,14.9334657298426,398473,1207036.10559617,144116447847.349,512.806060606061,624711,15211839.8023119
1182,BTC,2016-02-15,119491189,126866288,261953,499551,126866288,220349,110319370,3453,17.6105716986867,398625,1098402.78731641,144116447847.349,563.523178807947,762567,15215639.8023119
1182,BTC,2016-02-16,119722729,127125956,259668,481035,127125956,215940,110535310,3879,18.3697887488952,398763,1014738.10494265,144116447847.349,609.985401459854,760435,15219089.8023119
1182,BTC,2016-02-17,119984640,127417877,291921,540958,127417877,227235,110762545,3932,17.5364395349752,398918,1106956.24615951,144116447847.349,559.168831168831,773961,15222964.8023119
1182,BTC,2016-02-18,120216947,127688052,270175,497219,127688052,212979,110975524,4208,18.0883957976905,399087,1233530.70893309,144116447847.349,501.791666666667,650894,15227189.8023119
1182,BTC,2016-02-19,120480890,127955271,267219,511150,127955271,217436,111192960,4808,21.9933897173039,399232,1100382.96915363,152801885495.657,596.409722222222,767116,15230814.8023119
1182,BTC,2016-02-20,120711349,128213044,257773,501273,128213044,215728,111408688,4336,19.1524956334826,399382,1230277.68704575,163491654908.959,570.758389261745,737769,15234564.8023119
1182,BTC,2016-02-21,120924636,128451712,238668,523756,128451712,206617,111615305,4469,20.322362263292,399510,1037596.38495082,163491654908.959,676.748031496063,845762,15237764.8023119
1182,BTC,2016-02-22,121151210,128734375,282663,539776,128734375,237696,111853001,4962,18.7703625879111,399637,1046385.80299412,163491654908.959,671.063492063492,898240,15240939.8023119
1182,BTC,2016-02-23,121420634,129016824,282449,547210,129016824,244748,112097749,3456,16.1912393694782,399773,1104614.73100505,163491654908.959,635.688888888889,883189,15244339.8023119
1182,BTC,2016-02-24,121651606,129263620,246796,469952,129263620,224927,112322676,3479,16.3137076029527,399891,983779.183428998,163491654908.959,713.769230769231,918164,15247289.8023119
1182,BTC,2016-02-25,121919168,129529694,266074,527076,129529694,216290,112538966,3444,14.3133803249752,400046,1276364.88196176,163491654908.959,550.14935064935,799025,15251164.8023119
1182,BTC,2016-02-26,122148666,129773981,244287,475872,129773981,203635,112742601,3182,16.1370840569809,400186,1165372.30734535,163491654908.959,602.546762589928,765234,15254664.8023119
1182,BTC,2016-02-27,122371976,130008798,234817,477064,130008798,182177,112924778,2551,13.8904829892595,400333,1192993.90709749,163491654908.959,588.595890410959,673899,15258339.8023119
1182,BTC,2016-02-28,122573519,130279458,270660,490258,130279458,233436,113158214,8156,36.3538311958379,400467,1094884.33918011,163491654908.959,641.338345864662,776566,15261689.8023119
1182,BTC,2016-02-29,122815305,130559928,280470,564015,130559928,265320,113423534,11873,37.406552638621,400600,1099960.28116183,163491654908.959,638.378787878788,913299,15265014.8023119
1182,BTC,2016-03-01,123064785,130848857,288929,566452,130848857,277094,113700628,9545,39.7107659453784,400741,1156686.47535481,163491654908.959,607.071428571429,905035,15268539.8023119
1182,BTC,2016-03-02,123355852,131149967,301110,559817,131149967,270206,113970834,7096,21.1550044297926,400898,1286638.68679617,163491654908.959,545.756410256411,900280,15272464.8023119
1182,BTC,2016-03-03,123587741,131388460,238493,568825,131388460,221652,114192486,3871,15.9195898419864,401033,1111652.89125372,163491654908.959,631.664179104478,920832,15275839.8023119
1182,BTC,2016-03-04,123873201,131621093,232633,528155,131621093,207485,114399971,10335,35.9612124286519,401188,1265855.86412761,163328285517.296,554.162337662338,786571,15279714.8023119
1182,BTC,2016-03-05,124137818,131870642,249549,522343,131870642,234992,114634963,30112,83.0463006553695,401338,1186072.87304251,158427203767.392,573.691275167786,780037,15283464.8023119
1182,BTC,2016-03-06,124307746,132051171,180529,418922,132051171,161739,114796702,2101,12.4379764716906,401486,1166087.2236438,158427203767.392,583.52380952381,628856,15287164.8023119
1182,BTC,2016-03-07,124503966,132257491,206320,410786,132257491,183255,114979957,3153,15.8252253641013,401619,1065988.21459153,158427203767.392,638.318181818182,708340,15290489.8023119
1182,BTC,2016-03-08,124728498,132493752,236261,467249,132493752,200298,115180255,2330,11.5382324062008,401773,1219897.44464659,158427203767.392,557.78431372549,680366,15294339.8023119
1182,BTC,2016-03-09,125027793,132715835,222083,512080,132715835,190388,115370643,2208,10.8485003827544,401941,1340617.52966272,158427203767.392,507.556886227545,744126,15298539.8023119
1182,BTC,2016-03-10,125227119,132940693,224858,442444,132940693,188726,115559369,2084,12.927374230954,402096,1222170.86136486,158427203767.392,556.746753246753,676986,15302414.8023119
1182,BTC,2016-03-11,125424942,133162401,221708,426008,133162401,189816,115749185,2486,12.4551199439945,402256,1271371.56159971,158427203767.392,535.201257861635,614320,15306414.8023119
1182,BTC,2016-03-12,125597727,133359690,197289,377340,133359690,168013,115917198,1755,10.8914135385195,402400,1165401.54544462,158427203767.392,583.867132867133,574049,15310014.8023119
1182,BTC,2016-03-13,125760799,133541830,182140,427125,133541830,149803,116067001,1864,10.8226136622383,402533,1045319.5263844,158427203767.392,650.939393939394,637964,15313339.8023119
1182,BTC,2016-03-14,125963703,133761704,219874,457318,133761704,191341,116258342,2330,12.6291240507881,402685,1198460.18412762,158427203767.392,567.761589403974,726220,15317139.8023119
1182,BTC,2016-03-15,126171008,133990919,229215,450228,133990919,202426,116460768,3247,15.6993619277565,402846,1262791.95300564,158427203767.392,538.8375,664197,15321164.8023119
1182,BTC,2016-03-16,126393418,134236646,245727,447629,134236646,211992,116672760,20270,62.945471411221,402998,1209962.53407008,158427203767.392,562.364238410596,668880,15324964.8023119
1182,BTC,2016-03-17,126614630,134479132,242486,478833,134479132,208319,116881079,10869,38.3293399846896,403139,1109278.99503796,158427203767.392,613.407142857143,746761,15328489.8023119
1182,BTC,2016-03-18,126827515,134714580,235448,439049,134714580,206022,117087101,5828,25.4314835677948,403275,1096923.45924244,162377880110.505,635.785185185186,739598,15331889.8023119
1182,BTC,2016-03-19,127001662,134921877,207297,424401,134921877,177478,117264579,2660,12.3405891035137,403411,1134301.11880183,165496835118.226,626.644444444444,640091,15335289.8023119
1182,BTC,2016-03-20,127183819,135130599,208722,438363,135130599,178143,117442722,1227,9.9551991171561,403557,1209899.59255654,165496835118.226,587.489655172414,660703,15338939.8023119
1182,BTC,2016-03-21,127399878,135355030,224431,438929,135355030,199006,117641728,1266,10.2588751396182,403696,1145921.52138495,165496835118.226,620.289855072464,754278,15342414.8023119
1182,BTC,2016-03-22,127608799,135592104,237074,465984,135592104,205208,117846936,1913,10.8915456990706,403844,1214709.69995431,165496835118.226,585.163265306122,714047,15346114.8023119
1182,BTC,2016-03-23,127802411,135814658,222554,433676,135814658,186808,118033744,1923,11.0639634692091,403993,1223712.78717176,165496835118.226,580.858108108108,674793,15349839.802312
1182,BTC,2016-03-24,128012349,136031426,216768,429318,136031426,190094,118223838,2175,12.0291499450219,404140,1225899.66435072,165496835118.226,579.821917808219,674119,15353514.8023119
1182,BTC,2016-03-25,128190451,136233250,201824,401523,136233250,172309,118396147,1834,12.2642381932383,404286,1211535.14936373,165496835118.226,586.696551724138,624015,15357164.8023119
1182,BTC,2016-03-26,128422433,136413467,180217,458307,136413467,159049,118555196,1455,9.46332570785035,404439,1295220.71488074,165496835118.226,548.789473684211,625294,15360989.8023119
1182,BTC,2016-03-27,128595913,136589534,176067,426673,136589534,160266,118715462,1698,10.838593070632,404580,1171644.91510349,165496835118.226,606.671428571429,629456,15364514.8023119
1182,BTC,2016-03-28,128880197,136802745,213211,517885,136802745,196080,118911542,1637,10.6406449222238,404750,1396308.19771599,165496835118.226,509.059171597633,674532,15368764.7998396
1182,BTC,2016-03-29,129280391,137024306,221561,671415,137024306,197409,119108951,1612,10.7205627569899,404907,1288555.38534163,165496835118.226,551.628205128205,836449,15372689.7998396
1182,BTC,2016-03-30,129545482,137252108,227802,482865,137252108,201028,119309979,1556,10.1087289919561,405054,1241043.63958749,165496835118.226,572.746575342466,748907,15376364.7998396
1182,BTC,2016-03-31,129755201,137474973,222865,422358,137474973,206476,119516455,1747,10.6013091619143,405178,1026364.76543662,165496835118.226,692.544715447155,845192,15379464.7998397
1182,BTC,2016-04-01,130001903,137705812,230839,508187,137705812,211922,119728377,1668,10.2938303074686,405331,1272653.91245244,166523911373.703,561.986842105263,768427,15383289.7998397
1182,BTC,2016-04-02,130235239,137912491,206679,479286,137912491,183503,119911880,1752,9.58439405864253,405470,1146382.20633383,166851513282.777,625.115942028986,798859,15386764.7998397
1182,BTC,2016-04-03,130432812,138114972,202481,469544,138114972,178429,120090309,1405,8.75209732237674,405612,1186320.62354835,166851513282.777,604.070921985816,727052,15390314.7998396
1182,BTC,2016-04-04,130656857,138355013,240041,489759,138355013,208929,120299238,1444,10.2049542432021,405778,1388312.73709299,166851513282.777,516.181818181818,669686,15394464.7998396
1182,BTC,2016-04-05,130883335,138593649,238636,463681,138593649,216176,120515414,1558,10.4440112547328,405933,1292435.27968469,166851513282.777,554.474025974026,741679,15398339.7998397
1182,BTC,2016-04-06,131102759,138836503,242854,480317,138836503,219290,120734704,1854,10.932474178525,406090,1305413.48096256,166851513282.777,548.961538461538,706436,15402264.7998397
1182,BTC,2016-04-07,131305680,139071065,234562,448373,139071065,218463,120953167,2514,12.5412513559878,406229,1161420.65569289,166851513282.777,617.021739130435,758243,15405739.7998396
1182,BTC,2016-04-08,131506773,139299653,228588,443851,139299653,214191,121167358,2144,12.7365535594602,406373,1213031.68058454,166851513282.777,590.769230769231,718055,15409339.7998397
1182,BTC,2016-04-09,131693994,139513892,214239,426774,139513892,196441,121363799,2459,11.448743825259,406535,1371288.59653731,166851513282.777,522.590062111801,635264,15413389.7998396
1182,BTC,2016-04-10,131842312,139716622,202730,437929,139716622,186954,121550753,1660,10.7248587463734,406708,1435915.05554606,166851513282.777,499.06976744186,553299,15417714.7998396
1182,BTC,2016-04-11,132057019,139949153,232531,479926,139949153,230040,121780793,1879,11.1773538562582,406861,1275501.0305896,166851513282.777,561.835526315789,770970,15421539.7998397
1182,BTC,2016-04-12,132293372,140209144,259991,516327,140209144,240206,122020999,3297,14.5524258377055,407009,1248381.25174361,166851513282.777,574.04081632653,835680,15425239.7998396
1182,BTC,2016-04-13,132536022,140452278,243134,497338,140452278,223506,122244505,3409,14.4014576561469,407173,1360558.06639801,166851513282.777,526.711656441718,707264,15429339.7998396
1182,BTC,2016-04-14,132768246,140694006,241728,471491,140694006,227928,122472433,2610,13.0077884800396,407337,1420871.69153029,174495660875.61,527.460122699386,714272,15433439.7980789
1182,BTC,2016-04-15,132961952,140915814,221808,437682,140915814,212178,122684611,4803,18.0142040950916,407476,1244650.92596666,178678307671.688,616.572463768116,792579,15436914.7980789
1182,BTC,2016-04-16,133147318,141116454,200640,409993,141116454,182004,122866615,2653,16.7670643918143,407614,1257324.24269329,178678307671.688,610.357664233577,674731,15440364.7980789
1182,BTC,2016-04-17,133344654,141329757,213303,479568,141329757,192428,123059043,2923,13.6116490029529,407772,1400673.63732269,178678307671.688,547.891719745223,659291,15444314.7980789
1182,BTC,2016-04-18,133556799,141560931,231174,480042,141560931,220395,123279438,5615,17.9788865153124,407906,1233730.51973833,178678307671.688,622.03007518797,837628,15447664.7980789
1182,BTC,2016-04-19,133778278,141803485,242554,481299,141803485,226511,123505949,4365,16.361225313069,408056,1330972.81727863,178678307671.688,576.58389261745,749866,15451414.7980789
1182,BTC,2016-04-20,134012007,142041223,237738,466761,142041223,216780,123722729,4887,18.8088408472384,408221,1493313.57409282,178678307671.688,513.90243902439,696925,15455539.7980789
1182,BTC,2016-04-21,134224590,142281653,240430,478570,142281653,212795,123935524,7676,23.6527585785858,408372,1353454.08276421,178678307671.688,567.006666666667,731790,15459314.7980789
1182,BTC,2016-04-22,134441184,142511426,229773,441367,142511426,210976,124146500,7802,25.078128150004,408515,1281104.17447912,178678307671.688,599.028169014084,774912,15462889.7980789
1182,BTC,2016-04-23,134610515,142713928,202502,435656,142713928,185216,124331716,5670,18.4986809854415,408659,1297907.80558115,178678307671.688,591.272727272727,654661,15466489.7980789
1182,BTC,2016-04-24,134792064,142914696,200768,458533,142914696,183155,124514871,2894,12.1420086523462,408791,1176800.24022619,178678307671.688,652.12213740458,728039,15469789.7980789
1182,BTC,2016-04-25,135012178,143153233,238537,495966,143153233,217564,124732435,3070,12.4992456887461,408918,1150058.32063406,178678307671.688,667.285714285714,874485,15472964.7980789
1182,BTC,2016-04-26,135257481,143419532,266299,525876,143419532,250744,124983179,2535,11.0476690740777,409069,1342217.77681727,178678307671.688,571.753333333334,813179,15476739.7972545
1182,BTC,2016-04-27,135488666,143666775,247243,472899,143666775,239435,125222614,2272,10.3788135581726,409198,1164670.07099963,178678307671.688,658.9140625,875343,15479964.7972545
1182,BTC,2016-04-28,135705419,143900661,233886,461287,143900661,247957,125470571,2979,10.8728824349017,409333,1231165.69803365,178666172180.371,623.283582089553,897479,15483339.7972545
1182,BTC,2016-04-29,135937198,144150470,249809,517754,144150470,261884,125732455,3089,9.63191413936246,409491,1397275.54337119,178659257772.527,549.165605095541,812847,15487289.7972545
1182,BTC,2016-04-30,136139876,144371921,221451,441150,144371921,215712,125948167,2026,8.8069576547059,409637,1310726.87269891,178659257772.527,585.427586206897,757548,15490939.7972545
1182,BTC,2016-05-01,136301298,144563593,191672,432050,144563593,191430,126139597,1839,9.81826045620707,409792,1404174.30802484,178659257772.527,546.467532467533,625717,15494814.7972545
1182,BTC,2016-05-02,136505134,144780747,217154,485098,144780747,223785,126363382,1908,10.9510815420455,409949,1388166.3930404,178659257772.527,552.76923076923,751085,15498739.7972545
1182,BTC,2016-05-03,136714889,145004254,223507,467113,145004254,235609,126598991,1891,9.65098972834421,410100,1333770.00810104,178659257772.527,575.313333333333,778229,15502514.7972545
1182,BTC,2016-05-04,136931570,145222385,218131,500458,145222385,233691,126832682,2065,9.74222905549542,410267,1484952.27383469,178659257772.527,516.740963855422,707049,15506689.7953032
1182,BTC,2016-05-05,137134772,145437787,215402,458982,145437787,229573,127062255,2241,9.41583633237397,410422,1394497.2039903,178659257772.527,550.25974025974,704524,15510564.7953032
1182,BTC,2016-05-06,137334129,145653800,216013,455802,145653800,233232,127295487,2365,9.952560112305,410584,1452654.97972794,178659257772.527,528.229813664596,685889,15514614.7953033
1182,BTC,2016-05-07,137514453,145847535,193735,419837,145847535,202062,127497549,2201,9.37182330249676,410734,1330474.72152856,178659257772.527,576.738255033557,646522,15518364.7953032
1182,BTC,2016-05-08,137679616,146031652,184117,440913,146031652,189025,127686574,1765,8.59056145741505,410902,1489521.87893349,178659257772.527,515.155688622754,578155,15522564.7953033
1182,BTC,2016-05-09,137880110,146256960,225308,486980,146256960,226449,127913023,1995,9.10715826814674,411073,1524163.57551829,178659257772.527,503.447058823529,638243,15526839.7953032
1182,BTC,2016-05-10,138093376,146490379,233419,497301,146490379,245721,128158744,1951,9.00172013782058,411231,1414252.67742675,178659257772.527,542.573248407643,726908,15530789.7953032
1182,BTC,2016-05-11,138304461,146716153,225774,472604,146716153,234412,128393156,2700,10.7083881590387,411364,1252059.67436502,190502504491.344,653.484848484849,813015,15534114.7953033
1182,BTC,2016-05-12,138505542,146937545,221392,454885,146937545,228409,128621565,2152,10.0495793962678,411503,1363442.45163917,194254820283.444,611.920289855073,779993,15537589.7953032
1182,BTC,2016-05-13,138703192,147158272,220727,460120,147158272,232146,128853711,2754,11.104137099326,411655,1464056.16654701,194254820283.444,569.867549668874,762693,15541389.7953032
1182,BTC,2016-05-14,138892866,147360798,202526,460454,147360798,211280,129064991,2319,9.04275279269131,411799,1392997.9489271,194254820283.444,598.937062937063,812342,15544989.7953032
1182,BTC,2016-05-15,139062333,147548137,187339,425394,147548137,200171,129265162,2401,10.2052597986787,411938,1338213.76650359,194254820283.444,623.45652173913,777696,15548464.7953032
1182,BTC,2016-05-16,139255058,147782780,234643,512800,147782780,239809,129504971,2990,11.2120013593517,412079,1366790.32084491,194254820283.444,610.421428571428,906763,15551989.7953032
1182,BTC,2016-05-17,139460447,148012129,229349,480691,148012129,238626,129743597,2977,11.330785057348,412220,1367334.31699251,194254820283.444,610.178571428572,867932,15555514.7953032
1182,BTC,2016-05-18,139674963,148247642,235513,511977,148247642,235083,129978680,2287,9.57190469081329,412373,1499046.68232793,194254820283.444,556.565789473685,873731,15559339.7953032
1182,BTC,2016-05-19,139874031,148467399,219757,461534,148467399,219145,130197825,2455,11.6107195186902,412493,1168347.73617551,194254820283.444,714.100840336135,955482,15562339.7953032
1182,BTC,2016-05-20,140065584,148673320,205921,445310,148673320,209396,130407221,2195,10.1940805544325,412642,1453019.83773722,194254820283.444,574.195945945946,781658,15566064.7953032
1182,BTC,2016-05-21,140287076,148865096,191776,503972,148865096,191461,130598682,1516,8.24426984536992,412783,1364889.73835664,194254820283.444,611.271428571428,891297,15569589.7953032
1182,BTC,2016-05-22,140478592,149042844,177748,446577,149042844,184348,130783030,1343,8.20393857735853,412967,1773845.6001071,194254820283.444,470.344262295082,603581,15574189.7953032
1182,BTC,2016-05-23,140671425,149264237,221393,517762,149264237,222754,131005784,2549,9.59045657257796,413147,1743357.06874751,194254820283.444,478.569832402235,646270,15578689.7953032
1182,BTC,2016-05-24,140896297,149500168,235931,516833,149500168,246517,131252301,2243,10.2009239049852,413294,1430827.87877378,194770865920.974,584.650684931507,849967,15582364.7953032
1182,BTC,2016-05-25,141121135,149736661,236493,493328,149736661,247841,131500142,2322,13.4805698194689,413432,1378306.19134357,199312067531.243,621.080291970803,870538,15585814.7953032
1182,BTC,2016-05-26,141322941,149960662,224001,461109,149960662,220091,131720233,3039,16.2852892004486,413567,1333967.51722631,199312067531.243,641.723880597015,820479,15589189.7953032
1182,BTC,2016-05-27,141557587,150193221,232559,530630,150193221,215296,131935529,3239,19.1555542225299,413706,1391687.05920701,199312067531.243,615.108695652174,948130,15592664.7953032
1182,BTC,2016-05-28,141766454,150406980,213759,483043,150406980,193054,132128583,3149,18.9870469012479,413839,1310202.71729416,199312067531.243,653.363636363636,863364,15595989.7953033
1182,BTC,2016-05-29,141935460,150595727,188747,428937,150595727,178742,132307325,3217,15.3341636910923,413986,1477866.19819018,199312067531.243,579.239726027397,680078,15599664.7953033
1182,BTC,2016-05-30,142172117,150817974,222247,549640,150817974,211368,132518693,2575,10.6374019171594,414130,1458954.17531149,199312067531.243,586.748251748252,891742,15603264.7953032
1182,BTC,2016-05-31,142374491,151045687,227713,478795,151045687,215249,132733942,3663,11.8997996610152,414257,1271045.13645827,199312067531.243,673.492063492063,867019,15606439.7953032
1182,BTC,2016-06-01,142595079,151288747,243060,509530,151288747,234384,132968326,2955,10.0346740997485,414400,1419086.27543826,199312067531.243,603.232394366197,839311,15610014.7953032
1182,BTC,2016-06-02,142807099,151523009,234262,479459,151523009,231099,133199425,3276,10.1368179752618,414538,1379457.25218535,199312067531.243,620.562043795621,826838,15613464.7953032
1182,BTC,2016-06-03,143026381,151765705,242696,497278,151765705,234669,133434094,2491,8.26266006113615,414680,1415537.56295983,199312067531.243,604.744680851064,832558,15617014.7953032
1182,BTC,2016-06-04,143198531,151967549,201844,448566,151967549,196665,133630759,2003,7.59461661526332,414799,1177371.40609465,199312067531.243,727.076271186441,840556,15619989.7953032
1182,BTC,2016-06-05,143372568,152164708,197159,464449,152164708,189802,133820561,2442,9.65210079706041,414969,1682039.77705678,199312067531.243,508.92899408284,611225,15624239.7953032
1182,BTC,2016-06-06,143588388,152401644,236936,512123,152401644,221171,134041732,2430,8.88090294050034,415139,1685370.97572055,199312067531.243,507.923076923077,705457,15628489.7953032
1182,BTC,2016-06-07,143796002,152648369,246725,511601,152648369,231016,134272748,2723,9.18713828840907,415279,1382070.90809608,199312067531.243,619.388489208633,803602,15631989.7953033
1182,BTC,2016-06-08,144002813,152887111,238742,483111,152887111,229933,134502681,2699,8.71636392107305,415423,1462874.84698759,196422606560.938,576.692307692308,802240,15635589.7953032
1182,BTC,2016-06-09,144223969,153141480,254369,526428,153141480,236353,134739034,2577,8.86474017511612,415588,1622023.39915893,196061423939.65,519.15243902439,720621,15639714.7953032
1182,BTC,2016-06-10,144447888,153386160,244680,507296,153386160,228367,134967401,2800,10.0794421061466,415732,1411060.35702035,196061423939.65,596.769230769231,822652,15643314.7953032
1182,BTC,2016-06-11,144644432,153606534,220374,468603,153606534,213159,135180560,2219,8.88808985117494,415888,1525413.40026107,196061423939.65,552.032258064516,696120,15647214.7953032
1182,BTC,2016-06-12,144854105,153825278,218744,522908,153825278,210711,135391271,4270,13.4380202782117,416034,1417786.876082,196061423939.65,593.937931034483,830047,15650864.7953032
1182,BTC,2016-06-13,145113315,154088205,262927,580046,154088205,251354,135642625,4402,10.9699733050372,416195,1597225.79382695,196061423939.65,527.2125,915602,15654889.7953032
1182,BTC,2016-06-14,145341646,154346307,258102,528082,154346307,246829,135889454,4120,9.54827642747283,416327,1286513.96467977,196061423939.65,654.541984732824,955200,15658189.7953032
1182,BTC,2016-06-15,145604839,154620463,274156,596061,154620463,259202,136148656,3291,8.87283607783906,416479,1485787.42671215,196061423939.65,566.754966887417,917150,15661989.7953032
1182,BTC,2016-06-16,145845875,154899390,278927,583844,154899390,267870,136416526,4327,10.4390029502897,416628,1492884.07861121,196061423939.65,564.06081081081,957703,15665714.7953032
1182,BTC,2016-06-17,146109997,155171313,271923,587643,155171313,253752,136670278,4912,10.9337663859279,416777,1461357.09489156,196061423939.65,576.22972972973,930753,15669439.7953032
1182,BTC,2016-06-18,146365919,155416829,245516,562920,155416829,235317,136905595,4023,9.94440093510843,416935,1534408.28682344,196061423939.65,548.79617834395,867727,15673389.7953032
1182,BTC,2016-06-19,146578540,155640628,223799,515984,155640628,218298,137123893,3277,9.21445450187258,417112,1723581.7399575,196061423939.65,488.5625,723107,15677814.7953033
1182,BTC,2016-06-20,146797744,155906711,266083,564349,155906711,249334,137373227,4485,10.6185617845182,417276,1596698.81373554,196061423939.65,527.386503067484,780292,15681914.7953032
1182,BTC,2016-06-21,147059543,156176587,269876,593632,156176587,248164,137621391,4179,11.4825166121482,417425,1538213.5304109,206307449112.491,576.047297297298,914910,15685639.7953032
1182,BTC,2016-06-22,147312962,156427165,250578,548244,156427165,235641,137857032,3512,11.510151780041,417554,1373295.62631209,209453158595.381,655.0625,945643,15688864.7953033
1182,BTC,2016-06-23,147549301,156689735,262570,550619,156689735,241300,138098332,4447,13.0929989365739,417694,1471742.17957626,209453158595.381,611.244604316547,919795,15692364.7953032
1182,BTC,2016-06-24,147780410,156947289,257554,548710,156947289,237625,138335957,4583,11.7652842827993,417823,1338091.10180835,209453158595.381,672.296875,942676,15695589.7953032
1182,BTC,2016-06-25,148008624,157170054,222765,531079,157170054,206919,138542876,2616,10.2532052809814,417985,1692053.56566213,209453158595.381,531.658385093168,792597,15699639.7953032
1182,BTC,2016-06-26,148211537,157365833,195779,502812,157365833,181348,138724224,2308,9.8783556006423,418131,1528577.9293444,209453158595.381,588.51724137931,762231,15703289.7953033
1182,BTC,2016-06-27,148433464,157601727,235894,485116,157601727,217029,138941253,2827,9.99908675326426,418278,1529103.22102609,209453158595.381,588.315068493151,777207,15706964.7953032
1182,BTC,2016-06-28,148669787,157851641,249914,542750,157851641,212607,139153860,2587,8.77563327572154,418426,1547033.06660068,209453158595.381,581.496598639456,760032,15710664.7953032
1182,BTC,2016-06-29,148889258,158092625,240984,467721,158092625,224112,139377972,1945,8.87302451821196,418572,1539111.01462642,209453158595.381,584.489655172414,764559,15714314.7953032
1182,BTC,2016-06-30,149121941,158346285,253660,508325,158346285,231960,139609932,2524,8.98810467837636,418722,1555470.68647312,209453158595.381,578.342281879195,797510,15718064.7953032
1182,BTC,2016-07-01,149358589,158579064,232779,496134,158579064,205801,139815733,3305,9.77504323001861,418877,1628167.87086903,209453158595.381,552.519480519481,749351,15721939.7953033
1182,BTC,2016-07-02,149566972,158796108,217044,447445,158796108,198875,140014608,3203,10.8183647971043,419026,1551965.08834846,209453158595.381,579.648648648649,694817,15725664.7953032
1182,BTC,2016-07-03,149727538,158992059,195951,431308,158992059,177127,140191735,2409,9.80700762785408,419180,1631902.88741425,209453158595.381,551.254901960785,614648,15729514.7953033
1182,BTC,2016-07-04,149937366,159226934,234875,506124,159226934,213900,140405635,4555,12.1531975226955,419331,1572879.14768594,209557682217.525,572.226666666667,739326,15733289.7953032
1182,BTC,2016-07-05,150168680,159464913,237979,490045,159464913,214959,140620594,2635,9.55877122162678,419476,1540154.06403179,213398925331.324,595.097222222222,789159,15736914.7953032
1182,BTC,2016-07-06,150383715,159705630,240717,466766,159705630,214691,140835285,2424,9.50033789538104,419616,1500403.43112286,213398925331.324,610.863309352518,797548,15740414.7953032
1182,BTC,2016-07-07,150609141,159949263,243633,469269,159949263,215548,141050833,3924,13.1317949386003,419753,1485958.5279936,213398925331.324,616.801470588235,821500,15743839.7953032
1182,BTC,2016-07-08,150817391,160175674,226411,464445,160175674,210701,141261534,2651,10.8717658763076,419898,1541809.33112707,213398925331.324,594.458333333333,779844,15747464.7953032
1182,BTC,2016-07-09,150994021,160385129,209455,439730,160385129,185405,141446939,2201,10.2004958057646,420047,1600813.4343243,213398925331.324,572.547297297297,658053,15750589.7953033
1182,BTC,2016-07-10,151148088,160569261,184132,401280,160569261,162608,141609547,1768,9.36601943322832,420203,1667553.88143903,213398925331.324,549.632258064516,585813,15752539.7953032
1182,BTC,2016-07-11,151362843,160802942,233681,494106,160802942,218089,141827636,2608,10.1997714325315,420346,1511970.16174143,213398925331.324,606.19014084507,793286,15754327.2953032
1182,BTC,2016-07-12,151581901,161046928,243986,478122,161046928,219034,142046670,2983,10.5651560269822,420489,1522173.51117565,213398925331.324,602.12676056338,775825,15756114.7953032
1182,BTC,2016-07-13,151782829,161280936,234008,453958,161280936,216503,142263173,2403,10.4090004244598,420618,1364646.55722815,213398925331.324,671.6328125,820023,15757727.2953032
1182,BTC,2016-07-14,152013920,161515952,235016,476585,161515952,217695,142480868,2337,9.63398299997184,420759,1497861.4239248,213398925331.324,611.9,798437,15759489.7953032
1182,BTC,2016-07-15,152219181,161746990,231038,453988,161746990,216081,142696949,4609,15.5007203059732,420894,1456656.64433124,213398925331.324,629.20895522388,790217,15761177.2953032
1182,BTC,2016-07-16,152422851,161954205,207215,468924,161954205,182192,142879141,2369,10.7903667375375,421051,1681232.98520471,213398925331.324,545.160256410256,688478,15763139.7953032
1182,BTC,2016-07-17,152608462,162141881,187676,435751,162141881,171013,143050154,2680,12.0184231603401,421200,1601720.7427687,213398925331.324,572.222972972973,709356,15765002.2953032
1182,BTC,2016-07-18,152831976,162377654,235773,498404,162377654,222835,143272989,2245,10.1214254691759,421348,1564722.75802969,213402086675.114,585.761904761905,819096,15766852.2953032
1182,BTC,2016-07-19,153044542,162607505,229851,470529,162607505,222146,143495135,3204,11.4300755535935,421476,1356804.31089094,213492501107.513,675.811023622047,860789,15768452.2953032
1182,BTC,2016-07-20,153267627,162847918,240413,479158,162847918,227429,143722564,2608,10.8030087757556,421626,1614031.67493035,213492501107.513,568.107382550335,798784,15770327.2953032
1182,BTC,2016-07-21,153470021,163073851,225933,447503,163073851,217606,143940170,2683,10.1439293056901,421759,1425686.61962305,213492501107.513,643.159090909091,809272,15771989.7953032
1182,BTC,2016-07-22,153679992,163304601,230750,469394,163304601,221404,144161574,3228,10.9361447930055,421888,1394557.44522879,213492501107.513,657.515625,863989,15773602.2953032
1182,BTC,2016-07-23,153887626,163508810,204209,448622,163508810,195796,144357370,2025,9.37002163480429,422019,1386367.26670398,213492501107.513,661.400000000001,826302,15775239.7953032
1182,BTC,2016-07-24,154059797,163700480,191670,434964,163700480,183890,144541260,3070,10.0422258941973,422143,1350334.9634754,213492501107.513,679.048780487805,791551,15776789.7953032
1182,BTC,2016-07-25,154289772,163943083,242603,499953,163943083,239715,144780975,2079,8.04228791171604,422274,1404730.6126204,213492501107.513,652.753846153846,909994,15778427.2953032
1182,BTC,2016-07-26,154511488,164191660,248577,508847,164191660,237673,145018648,2758,9.72167817782028,422403,1374550.50189544,213492501107.513,667.0859375,923046,15780039.7953032
1182,BTC,2016-07-27,154742368,164434315,242655,478489,164434315,235603,145254251,3228,10.6767297398239,422531,1405387.34018595,213492501107.513,652.448818897638,921787,15781639.7953032
1182,BTC,2016-07-28,154972721,164675899,241584,496259,164675899,234863,145489114,2690,10.4768010960232,422667,1440593.83293841,213492501107.513,636.503703703703,875243,15783339.7953032
1182,BTC,2016-07-29,155199094,164907148,231249,466728,164907148,231414,145720528,2715,9.24697347813775,422814,1570476.78767902,213492501107.513,583.86301369863,822371,15785177.2953032
1182,BTC,2016-07-30,155367590,165113044,205896,451392,165113044,199484,145920012,1407,9.41695419800816,422933,1274132.24921533,213492501107.513,719.661016949153,870160,15786664.7953032
1182,BTC,2016-07-31,155602161,165312376,199332,493131,165312376,192254,146112266,1708,9.66723364383685,423087,1642440.33928019,213492501107.513,558.281045751634,794571,15788589.7953032
1182,BTC,2016-08-01,155833487,165554190,241814,517085,165554190,225049,146337315,1842,7.67313292065133,423240,1624213.48253835,213492501107.513,564.546052631579,814182,15790502.2953032
1182,BTC,2016-08-02,156093756,165824782,270592,539439,165824782,251098,146588413,4568,14.0266991183833,423394,1607797.61931541,210856298776.955,563.267973856209,859341,15792427.2953032
1182,BTC,2016-08-03,156336647,166084856,260074,518444,166084856,241782,146830195,2389,10.2492831060747,423560,1660984.94007619,201893210853.059,522.054545454545,791052,15794502.2953032
1182,BTC,2016-08-04,156569745,166331491,246635,489611,166331491,231835,147062030,3644,12.9604019243172,423713,1560666.40806774,201893210853.059,555.611842105263,780742,15796414.7953032
1182,BTC,2016-08-05,156791289,166577924,246433,478244,166577924,228244,147290274,2176,10.0399894490581,423882,1710044.20719715,201893210853.059,507.077380952381,701046,15798527.2953032
1182,BTC,2016-08-06,156976176,166792566,214642,426155,166792566,195669,147485943,1077,7.7519313667492,424048,1678620.99342073,201893210853.059,516.569696969697,619244,15800602.2953032
1182,BTC,2016-08-07,157170428,166986563,193997,449172,166986563,192414,147678357,1237,9.7485043511231,424196,1499898.05694076,201893210853.059,578.122448979592,768321,15802452.2953032
1182,BTC,2016-08-08,157405807,167230074,243511,532467,167230074,235295,147913652,1137,8.37776043145167,424344,1484889.11700492,201893210853.059,583.965986394558,839246,15804302.2953032
1182,BTC,2016-08-09,157621176,167482064,251990,492713,167482064,231400,148145052,2259,9.60357761950523,424468,1240435.23442417,201893210853.059,699.048780487805,880534,15805852.2953032
1182,BTC,2016-08-10,157871603,167744792,262728,533284,167744792,244740,148389792,1793,8.87035014297483,424619,1542908.27730096,201893210853.059,562.006666666667,834621,15807739.7953032
1182,BTC,2016-08-11,158126872,168015112,270320,533906,168015112,254515,148644307,1467,8.85941957291873,424769,1506021.51703986,201893210853.059,575.771812080537,860473,15809614.7953032
1182,BTC,2016-08-12,158358279,168264909,249797,493299,168264909,232973,148877280,1986,8.26058012210329,424918,1491844.84805347,201893210853.059,581.243243243243,805274,15811477.2953032
1182,BTC,2016-08-13,158538933,168492820,227911,459850,168492820,214569,149091849,1385,9.54980877313759,425081,1683394.34059376,201893210853.059,515.104938271605,665115,15813514.7953032
1182,BTC,2016-08-14,158714117,168699823,207003,457243,168699823,200174,149292023,1202,8.57538659589587,425244,1639712.93964664,201893210853.059,528.827160493827,639753,15815552.2953033
1182,BTC,2016-08-15,158960378,168918141,218318,501800,168918141,202896,149494919,2153,10.2374134026505,425390,1490218.29323865,203483855226.776,586.462068965517,809769,15817377.2953032
1182,BTC,2016-08-16,159212579,169189694,271553,539127,169189694,254431,149749350,2512,10.7375213956488,425525,1475140.12638835,217375482757.238,632.902985074627,920074,15819064.7953032
1182,BTC,2016-08-17,159462218,169453381,263687,525490,169453381,238003,149987353,1987,8.40244852426251,425648,1327154.54775045,217375482757.238,703.475409836066,949801,15820602.2953032
1182,BTC,2016-08-18,159723967,169716964,263583,530304,169716964,239541,150226894,2818,9.71772182997975,425802,1672704.54673309,217375482757.238,558.150326797386,798859,15822527.2953032
1182,BTC,2016-08-19,159968936,169980541,263577,510567,169980541,246095,150472989,2067,9.65906577180694,425956,1677320.28577729,217375482757.238,556.614379084967,790802,15824452.2953032
1182,BTC,2016-08-20,160175702,170227193,246652,497305,170227193,208224,150681213,1752,10.0719580702888,426111,1678370.05506053,217375482757.238,556.266233766234,714048,15826389.7953032
1182,BTC,2016-08-21,160356928,170439461,212268,448496,170439461,184904,150866117,954,7.24110661066878,426274,1796938.72425616,217375482757.238,519.561728395062,614909,15828427.2953032
1182,BTC,2016-08-22,160603301,170694555,255094,528018,170694555,228373,151094490,2447,8.69078515935903,426432,1772218.65256434,217375482757.238,526.808917197452,784878,15830402.2953032
1182,BTC,2016-08-23,160860091,170963511,268956,515828,170963511,239021,151333511,2731,8.74728997550822,426579,1601821.54333463,217375482757.238,582.849315068493,828971,15832239.7953032
1182,BTC,2016-08-24,161099718,171230367,266856,518471,171230367,235130,151568641,2688,8.92575418161264,426731,1675800.40414356,217375482757.238,557.119205298013,756289,15834139.7953032
1182,BTC,2016-08-25,161320864,171486939,256572,495276,171486939,234009,151802650,2390,9.11419642186215,426861,1398106.12623076,217375482757.238,667.775193798449,868055,15835764.7953032
1182,BTC,2016-08-26,161550743,171741239,254300,488398,171741239,226767,152029417,2805,9.22877052381982,426993,1439415.98261329,217375482757.238,648.610687022901,844412,15837414.7953032
1182,BTC,2016-08-27,161754842,171972279,231040,458834,171972279,191098,152220515,1812,7.66392961756329,427137,1546266.52479002,217375482757.238,603.79020979021,686902,15839214.7953032
1182,BTC,2016-08-28,161946068,172175533,203254,429225,172175533,174489,152395004,1175,7.46305861653812,427289,1662127.98140204,217375482757.238,561.701986754967,608527,15841114.7953032
1182,BTC,2016-08-29,162194730,172415617,240084,502674,172415617,225282,152620286,1872,7.60922148109884,427438,1632400.88738136,218441791495.072,574.736486486487,808922,15842977.2953032
1182,BTC,2016-08-30,162462708,172696893,281276,552241,172696893,252002,152872288,1567,7.20111273546821,427602,1791908.39436118,220755908330.372,529.122699386503,783227,15845027.2953032
1182,BTC,2016-08-31,162716237,172960458,263565,501879,172960458,225360,153097648,1503,7.8876372129909,427736,1482669.7050962,220755908330.372,639.481203007519,834746,15846702.2953032
1182,BTC,2016-09-01,162959761,173219234,258776,488486,173219234,237466,153335114,2080,7.51129885529314,427876,1534563.44202747,220755908330.372,617.856115107914,849244,15848452.2953032
1182,BTC,2016-09-02,163181412,173468809,249575,478891,173468809,225856,153560970,1862,7.062616416665,428029,1691020.12103272,220755908330.372,560.690789473685,726650,15850364.7953032
1182,BTC,2016-09-03,163398649,173701808,232999,466276,173701808,182204,153743174,1881,7.18109877284264,428155,1393830.71662608,220755908330.372,680.24,769942,15851939.7953032
1182,BTC,2016-09-04,163593051,173920333,218525,440928,173920333,183244,153926418,1290,6.33381040697125,428334,1983974.96518744,220755908330.372,477.898876404494,579355,15854177.2953032
1182,BTC,2016-09-05,163841261,174183879,263546,543323,174183879,227683,154154101,2340,7.526611591709,428474,1530358.08458398,220755908330.372,619.553956834533,880298,15855927.2953032
1182,BTC,2016-09-06,164085076,174452412,268533,520832,174452412,232118,154386219,1796,6.8968947685158,428610,1515586.05057714,220755908330.372,625.592592592592,866949,15857627.2953032
1182,BTC,2016-09-07,164359531,174734439,282027,527811,174734439,250809,154637028,1468,6.39427289306987,428762,1665531.06570889,220755908330.372,569.271523178808,809331,15859527.2953032
1182,BTC,2016-09-08,164605455,175007251,272812,502324,175007251,227006,154864034,1819,7.16668414461345,428906,1607492.26575274,220755908330.372,589.825174825174,814107,15861327.2953033
1182,BTC,2016-09-09,164858604,175272896,265645,494034,175272896,220534,155084568,1927,7.93946924089265,429048,1552395.65174773,220755908330.372,610.758865248227,813034,15863102.2953032
1182,BTC,2016-09-10,165070933,175513638,240742,447527,175513638,193320,155277888,1604,7.64553577577017,429203,1718048.06123652,220755908330.372,551.87012987013,646603,15865039.7953032
1182,BTC,2016-09-11,165259024,175748302,234664,460209,175748302,180391,155458279,1510,8.35196869391067,429367,1805241.48216877,220755908330.372,525.214723926381,591717,15867089.7953032
1182,BTC,2016-09-12,165507048,176005750,257448,512355,176005750,208649,155666928,1771,8.01469689072207,429530,1829555.82921889,224586991480.297,527.228395061728,690828,15869127.2953032
1182,BTC,2016-09-13,165784138,176284346,278596,532514,176284346,239886,155906814,1924,8.26187243094007,429695,1866175.6620924,225832872179.46,519.75,780871,15871189.7953032
1182,BTC,2016-09-14,166035666,176557645,273299,493955,176557645,231800,156138614,1933,8.18643924978421,429851,1748278.2991574,225832872179.46,554.8,764206,15873139.7953032
1182,BTC,2016-09-15,166276050,176829033,271388,496662,176829033,233488,156372102,1223,6.70073059470341,430005,1722175.14543172,225832872179.46,563.209150326797,752978,15875064.7953032
1182,BTC,2016-09-16,166501398,177078708,249675,476784,177078708,211128,156583230,2356,8.90906033796616,430144,1559178.8096567,225832872179.46,622.086956521739,774627,15876802.2953032
1182,BTC,2016-09-17,166744531,177340440,261732,511960,177340440,215529,156798759,1574,6.84599086357488,430307,1829019.411714,225832872179.46,530.308641975309,754383,15878839.7953032
1182,BTC,2016-09-18,166956302,177569377,228937,467798,177569377,191603,156990362,1522,8.48873299895544,430452,1647795.0432812,225832872179.46,588.631944444444,678307,15880652.2953032
1182,BTC,2016-09-19,167199397,177835856,266479,506923,177835856,223540,157213902,2271,9.28114882323902,430585,1519387.57801692,225832872179.46,638.378787878788,835041,15882314.7953032
1182,BTC,2016-09-20,167454737,178124337,288481,535708,178124337,244315,157458217,2970,9.28541952855539,430736,1707829.70097638,225832872179.46,567.94,782657,15884202.2953032
1182,BTC,2016-09-21,167704369,178405127,280790,516795,178405127,239216,157697433,1769,7.80672950938604,430902,1858930.36671352,225832872179.46,521.775757575757,711351,15886277.2953032
1182,BTC,2016-09-22,167949613,178674198,269071,498853,178674198,231227,157928660,2565,10.0622938845148,431043,1585969.2371282,225832872179.46,611.578571428571,762582,15888039.7953032
1182,BTC,2016-09-23,168186340,178943405,269207,490768,178943405,223187,158151847,2537,10.0963652815755,431179,1530739.84768057,225832872179.46,633.644444444444,805261,15889739.7953032
1182,BTC,2016-09-24,168411783,179189873,246468,475437,179189873,208650,158360497,2488,9.67737814965722,431345,1878061.5384607,225832872179.46,516.460606060606,635886,15891814.7953032
1182,BTC,2016-09-25,168614038,179425880,236007,467720,179425880,195642,158556139,2197,9.4653835419919,431530,2150398.09970649,234736618673.551,468.836956521739,570905,15894127.2953032
1182,BTC,2016-09-26,168881455,179710711,284831,542751,179710711,230769,158786908,3131,9.8720174801401,431683,1879479.24878631,241227200229.991,551.25,770834,15896039.7953032
1182,BTC,2016-09-27,169164623,180008056,297345,551598,180008056,240335,159027243,1797,7.23011760360418,431850,2006023.76343749,241227200229.991,516.475903614458,764239,15898127.2953032
1182,BTC,2016-09-28,169436867,180302838,294782,549569,180302838,234995,159262238,4150,10.8329498797029,431998,1880215.94005503,241227200229.991,551.034013605442,782306,15899977.2953032
1182,BTC,2016-09-29,169713093,180605823,302985,555925,180605823,242730,159504968,2019,7.57570932512804,432141,1720853.600843,241227200229.991,602.06338028169,832816,15901764.7953032
1182,BTC,2016-09-30,169990167,180911064,305241,562554,180911064,250943,159755911,3505,9.82020781613111,432283,1716767.23068851,241227200229.991,603.49645390071,843357,15903539.7953032
1182,BTC,2016-10-01,170231084,181179221,268157,502197,181179221,213930,159969841,1999,7.18049914709723,432440,1881054.17640654,241227200229.991,550.788461538461,711277,15905502.2953032
1182,BTC,2016-10-02,170444527,181416181,236960,464351,181416181,192683,160162524,1751,7.37166839221986,432581,1791987.08999029,241227200229.991,578.164285714285,718532,15907264.7953032
1182,BTC,2016-10-03,170751473,181736939,320758,631275,181736939,258805,160421329,2428,7.6997252952657,432732,1854704.98835233,241227200229.991,558.613333333333,864554,15909152.2953032
1182,BTC,2016-10-04,171048669,182069123,332184,603043,182069123,264662,160685991,1890,7.20462760998364,432890,1911016.2472717,241227200229.991,542.152866242038,823938,15911127.2953032
1182,BTC,2016-10-05,171346010,182393084,323961,587930,182393084,266811,160952802,2917,8.630990850364,433057,2020493.73666091,241227200229.991,512.777108433735,788912,15913214.7953032
1182,BTC,2016-10-06,171651522,182731755,338671,623619,182731755,274486,161227288,2909,8.34915080051649,433218,1937516.88612348,241227200229.991,534.7375,827400,15915227.2953032
1182,BTC,2016-10-07,171935244,183054710,322955,580458,183054710,266324,161493612,3067,8.8920510341335,433361,1738792.08255275,241227200229.991,595.852112676056,867495,15917014.7953033
1182,BTC,2016-10-08,172199802,183358000,303290,552764,183358000,250672,161744284,3158,9.48241480053799,433530,2100023.24830474,250540187708.581,512.404761904762,761241,15919127.2953032
1182,BTC,2016-10-09,172421079,183615085,257085,513099,183615085,210548,161954832,3090,12.8151876610567,433690,2052396.94948139,258522748404.515,541.0,682252,15921127.2953032
1182,BTC,2016-10-10,172664104,183886045,270960,516746,183886045,222996,162177828,3727,11.5962498075661,433814,1593836.36226006,258522748404.515,696.650406504065,858421,15922677.2953032
1182,BTC,2016-10-11,172971427,184202731,316686,605153,184202731,263565,162441393,4399,10.8665385819476,433953,1778224.78448608,258522748404.515,624.413043478261,923088,15924414.7953032
1182,BTC,2016-10-12,173248891,184486958,284227,548243,184486958,233440,162674833,5071,11.5282269722744,434097,1848100.85785635,258522748404.515,600.804195804196,864545,15926214.7953032
1182,BTC,2016-10-13,173554804,184772390,285432,550455,184772390,229703,162904536,2264,9.09070056655368,434225,1661275.36972088,258522748404.515,668.370078740158,912039,15927814.7953032
1182,BTC,2016-10-14,173821344,185070782,298392,534462,185070782,239724,163144260,3000,8.43223482086854,434361,1768944.40753113,258522748404.515,627.688888888889,858694,15929514.7953032
1182,BTC,2016-10-15,174067787,185338010,267228,504150,185338010,210448,163354708,7312,16.1945262942951,434503,1822295.71430854,258522748404.515,609.312056737588,781651,15931289.7953032
1182,BTC,2016-10-16,174296542,185587674,249664,485071,185587674,197876,163552584,5429,12.4376679110728,434633,1671194.41250941,258522748404.515,664.403100775194,758897,15932914.7953032
1182,BTC,2016-10-17,174575298,185884039,296365,552870,185884039,237232,163789816,2781,7.95453790958467,434758,1619876.19369158,258522748404.515,685.451612903226,929673,15934477.2953032
1182,BTC,2016-10-18,174871602,186195611,311572,592884,186195611,251521,164041337,4369,9.97574230644928,434913,2005387.77544762,258522748404.515,553.681818181818,841848,15936414.7953032
1182,BTC,2016-10-19,175102456,186440563,244952,461988,186440563,199083,164240420,3383,9.73426090675593,435038,1635947.73064732,258522748404.515,678.717741935484,807401,15937977.2953032
1182,BTC,2016-10-20,175432812,186780685,340122,626591,186780685,270380,164510800,3217,9.1191839955581,435172,1762244.84136079,258522748404.515,630.075187969925,977431,15939652.2953032
1182,BTC,2016-10-21,175725016,187099325,318640,587039,187099325,265355,164776155,6494,11.9551375885014,435336,2110334.64933324,258522748404.515,526.147239263804,791085,15941702.2953033
1182,BTC,2016-10-22,175988234,187366708,267383,526716,187366708,216708,164992863,1327,6.23647128129511,435485,1909881.93201205,257535264828.067,579.148648648649,793872,15943564.7953032
1182,BTC,2016-10-23,176239027,187605034,238326,527516,187605034,191578,165184441,2105,9.80225556665687,435629,1825897.7461511,253618246641.49,596.573426573427,792336,15945364.7953032
1182,BTC,2016-10-24,176531686,187883480,278446,583734,187883480,226980,165411421,5134,16.463751145214,435772,1814852.39354159,253618246641.49,600.204225352113,886370,15947152.2953032
1182,BTC,2016-10-25,176838891,188180900,297420,620109,188180900,237030,165648451,6431,13.1122931036862,435911,1797538.16216464,253618246641.49,605.985507246377,943928,15948889.7953032
1182,BTC,2016-10-26,177147238,188466624,285724,615605,188466624,223316,165871767,2613,9.67756518777069,436049,1734828.05680225,253618246641.49,627.890510948906,974398,15950614.7953032
1182,BTC,2016-10-27,177513373,188847218,380594,724967,188847218,326388,166198155,5815,10.699355856227,436211,2137122.55607467,253618246641.49,509.695652173913,977625,15952639.7953032
1182,BTC,2016-10-28,177784412,189154171,306953,572668,189154171,250876,166449031,1718,6.23747576450685,436363,1930217.96094659,253618246641.49,564.331125827815,816514,15954539.7953032
1182,BTC,2016-10-29,178029505,189434723,280552,543922,189434723,229689,166678720,1869,6.54460923992729,436512,1872596.98573743,253618246641.49,581.695945945946,773039,15956402.2953032
1182,BTC,2016-10-30,178254506,189684582,249859,474170,189684582,207982,166886702,1930,6.45361124786429,436680,2124671.29019608,253618246641.49,512.682634730539,626403,15958502.2953032
1182,BTC,2016-10-31,178514472,189976187,291605,581814,189976187,241778,167128480,2278,7.47046371682601,436827,1866829.23992408,253618246641.49,583.493150684932,810984,15960339.7953032
1182,BTC,2016-11-01,178826796,190276480,300293,604939,190276480,246650,167375130,2448,7.48611304504176,436971,1860486.08193768,253618246641.49,585.482517482517,857051,15962139.7953032
1182,BTC,2016-11-02,179127109,190610527,334047,587580,190610527,268418,167643548,5152,17.8135386324324,437104,1686669.87963607,253618246641.49,645.818181818182,903709,15963802.2953032
1182,BTC,2016-11-03,179422311,190945518,334991,596124,190945518,271998,167915546,7220,25.0645327726015,437259,1965890.53731496,253618246641.49,554.090909090908,832612,15965739.7953032
1182,BTC,2016-11-04,179693944,191259757,314239,550065,191259757,248043,168163589,4974,23.7494709350921,437375,1491350.04791081,253618246641.49,730.4,956108,15967189.7953033
1182,BTC,2016-11-05,179949565,191562541,302784,559093,191562541,238215,168401804,4975,24.3628899604439,437522,1856357.04746546,253965858708.096,587.58904109589,792454,15969027.2953032
1182,BTC,2016-11-06,180186658,191838312,275771,522317,191838312,225786,168627590,6960,23.9109770645599,437675,1955288.92475969,254620187304.061,559.296052631579,730788,15970939.7953032
1182,BTC,2016-11-07,180491637,192177059,338747,631014,192177059,274281,168901871,5722,16.2988539266471,437821,1836553.66186388,254620187304.061,595.455172413793,886718,15972764.7953032
1182,BTC,2016-11-08,180821771,192540748,363689,665456,192540748,296060,169197931,6068,11.8143119636073,437990,2139714.93423888,254620187304.061,511.089285714286,866265,15974877.2953032
1182,BTC,2016-11-09,181132002,192872339,331591,616611,192872339,270095,169468026,4946,9.97670487900409,438137,1889933.41812196,254620187304.061,578.63698630137,891798,15976714.7953033
1182,BTC,2016-11-10,181432729,193210694,338355,614029,193210694,271374,169739400,1541,6.48517914124054,438305,2148219.79934105,254620187304.061,509.065868263473,804537,15978814.7953032
1182,BTC,2016-11-11,181706324,193526025,315331,560192,193526025,254619,169994019,1429,5.48115642449676,438468,2077109.58981287,254620187304.061,526.493827160494,754812,15980852.2953032
1182,BTC,2016-11-12,181961454,193819326,293301,573771,193819326,228886,170222905,1042,4.15084335328434,438636,2158962.04112944,254620187304.061,506.532934131736,710403,15982952.2953032
1182,BTC,2016-11-13,182204069,194096731,277405,541238,194096731,219657,170442562,1490,5.09600740594358,438778,1818000.59198146,254620187304.061,601.531914893617,773399,15984727.2953032
1182,BTC,2016-11-14,182511746,194433909,337178,635432,194433909,270506,170713068,1663,5.71984114724224,438950,2176403.28585675,254620187304.061,502.473684210526,790227,15986877.2953032
1182,BTC,2016-11-15,182822453,194788493,354584,655879,194788493,280352,170993420,1821,6.27633201762962,439106,1984194.0990391,254620187304.061,551.148387096774,854411,15988827.2953032
1182,BTC,2016-11-16,183125951,195128937,340444,619114,195128937,289789,171283209,2177,6.75135456675371,439277,2204260.25483807,254620187304.061,496.123529411765,791348,15990964.7953032
1182,BTC,2016-11-17,183434759,195470548,341611,630313,195470548,277460,171560669,2081,5.78135409170086,439436,2039909.91611666,254620187304.061,536.094936708861,898399,15992952.2953033
1182,BTC,2016-11-18,183729970,195812207,341659,628713,195812207,275925,171836594,2351,5.82013937028519,439584,1995201.79769658,272434584596.264,586.455782312925,932392,15994802.2953032
1182,BTC,2016-11-19,183989551,196126208,314001,581466,196126208,249760,172086354,1457,4.48183067853808,439726,1977358.51907988,281800917193.196,612.09219858156,852874,15996577.2953032
1182,BTC,2016-11-20,184248714,196422642,296434,581201,196422642,243591,172329945,1706,4.76868772709357,439854,1847425.77626531,281800917193.196,655.141732283465,902306,15998177.2953033
1182,BTC,2016-11-21,184537385,196771868,349226,611177,196771868,285793,172615738,1877,5.45941195178895,439993,1989979.50531026,281800917193.196,608.210144927536,922492,15999914.7953032
1182,BTC,2016-11-22,184830069,197123734,351866,610870,197123734,285635,172901373,1922,5.99304171234107,440127,1903995.75613659,281800917193.196,635.676691729323,958884,16001589.7953032
1182,BTC,2016-11-23,185156459,197462179,338445,647968,197462179,276924,173178297,1967,6.22351151560385,440274,2073180.68405968,281800917193.196,583.801369863014,951076,16003427.2953032
1182,BTC,2016-11-24,185529070,197856944,394765,737208,197856944,328538,173506835,1626,5.69357223995489,440436,2275048.35211951,281800917193.196,532.0,951714,16005452.2953032
1182,BTC,2016-11-25,185870178,198227509,370565,687120,198227509,315387,173822222,1595,4.64530052390016,440588,2116419.62899337,281800917193.196,571.87417218543,942782,16007352.2953032
1182,BTC,2016-11-26,186194584,198563415,335906,668055,198563415,277608,174099830,1403,4.33774669628303,440741,2168403.36565802,281800917193.196,558.164473684211,944997,16009264.7953032
1182,BTC,2016-11-27,186463266,198851928,288513,574090,198851928,237389,174337219,1120,4.00489603103804,440885,2037729.33074131,281800917193.196,593.958041958042,821504,16011064.7953032
1182,BTC,2016-11-28,186820086,199223083,371155,711477,199223083,298530,174635749,1625,5.07394295926734,441049,2292736.4452264,281800917193.196,527.895705521472,909111,16013114.7953032
1182,BTC,2016-11-29,187153271,199580819,357736,653139,199580819,289650,174925399,1829,4.8682371203971,441198,2079645.7502552,281800917193.196,581.986486486487,906176,16014977.2953032
1182,BTC,2016-11-30,187470266,199945423,364604,640448,199945423,292654,175218053,1743,4.66988453461289,441340,1994226.43282721,281800917193.196,606.914893617022,912247,16016752.2953032
1182,BTC,2016-12-01,187798811,200243578,298155,599176,200243578,239682,175457735,2018,6.31370212978955,441486,2059101.6060366,281800917193.196,587.793103448276,899509,16018577.2953032
1182,BTC,2016-12-02,188142795,200659033,415455,734332,200659033,315478,175773213,2127,5.65653129579844,441629,2031641.65229127,286175539941.774,604.985915492958,976568,16020364.7953032
1182,BTC,2016-12-03,188499641,201019149,360116,709304,201019149,287988,176061201,1344,4.28893548410309,441801,2462147.29843621,286765766820.55,500.233918128655,880861,16022514.7953032
1182,BTC,2016-12-04,188847912,201326694,307545,647498,201326694,245650,176306851,1110,3.73027242575461,441949,2124779.83506248,286765766820.55,579.659863945578,856999,16024364.7953032
1182,BTC,2016-12-05,189180631,201688899,362205,673204,201688899,278001,176584852,2422,6.19142619092744,442101,2171333.86384557,286765766820.55,567.23178807947,882688,16026264.7953032
1182,BTC,2016-12-06,189555540,202111271,422372,752107,202111271,319762,176904614,2286,5.16451207920563,442251,2152829.39474787,286765766820.55,572.107382550335,962761,16028139.7953032
1182,BTC,2016-12-07,189954160,202511456,400185,772764,202511456,310754,177215368,2026,4.9810811553077,442425,2488355.33625812,286765766820.55,494.965317919075,884193,16030314.7953033
1182,BTC,2016-12-08,190289558,202869840,358384,656085,202869840,282711,177498079,1766,5.04131885992774,442582,2325217.05945195,286765766820.55,529.692307692308,850177,16032277.2953032
1182,BTC,2016-12-09,190597814,203208500,338660,619016,203208500,268815,177766894,2139,5.67683026445414,442717,1956644.95221387,286765766820.55,629.470149253731,930323,16033964.7953033
1182,BTC,2016-12-10,190894272,203527592,319092,598160,203527592,250241,178017135,1596,4.67846895061728,442849,1877055.92684677,286765766820.55,656.160305343511,898481,16035614.7953032
1182,BTC,2016-12-11,191158129,203820742,293150,572051,203820742,229933,178247068,1418,4.61292487169684,443036,2675435.30889954,286765766820.55,460.354838709677,684039,16037952.2953032
1182,BTC,2016-12-12,191469574,204163406,342664,640595,204163406,268662,178515730,2379,6.30025936122042,443192,2237027.4606748,286765766820.55,550.574193548387,806014,16039902.2953032
1182,BTC,2016-12-13,191805375,204527084,363678,667959,204527084,291757,178807487,2047,5.36827774609579,443370,2544730.55807154,286765766820.55,484.0,814901,16042127.2953033
1182,BTC,2016-12-14,192104286,204882908,355824,622713,204882908,286328,179093815,2144,5.78299640482716,443509,2036174.6583932,286765766820.55,604.884057971014,901627,16043864.7953033
1182,BTC,2016-12-15,192407109,205232324,349416,614039,205232324,282685,179376500,2267,7.24193468225343,443636,1964467.08350966,308312273901.632,674.071428571429,955426,16045452.2953032
1182,BTC,2016-12-16,192719390,205580364,348040,641112,205580364,279361,179655861,2250,6.74352430299194,443769,2107249.02977614,310153855703.433,632.151515151515,966616,16047114.7953032
1182,BTC,2016-12-17,192978087,205883350,302986,588896,205883350,238130,179893991,1666,5.54875864025629,443913,2240878.9320569,310153855703.433,594.454545454545,817033,16048914.7953033
1182,BTC,2016-12-18,193259685,206168879,285529,567437,206168879,235789,180129780,1457,5.98701761127076,444054,2189488.86878426,310153855703.433,608.407142857143,861416,16050677.2953033
1182,BTC,2016-12-19,193584666,206519228,350349,662361,206519228,282129,180411909,1926,6.52800134551935,444205,2353811.99253366,310153855703.433,565.933333333333,914774,16052564.7953032
1182,BTC,2016-12-20,193911912,206882183,362955,654479,206882183,296473,180708382,2014,6.54090366283641,444343,2139055.42125852,310153855703.433,622.751824817519,970379,16054289.7953033
1182,BTC,2016-12-21,194287340,207278575,396392,708870,207278575,325677,181034059,3277,8.75571300452411,444502,2472765.46574062,310153855703.433,538.708860759494,963965,16056277.2953032
1182,BTC,2016-12-22,194651780,207668290,389715,687018,207668290,314644,181348703,3562,7.81578419397217,444661,2450482.07453695,310153855703.433,543.607594936708,919836,16058264.7953032
1182,BTC,2016-12-23,194988069,208045322,377032,666292,208045322,304997,181653700,3934,8.63548239015456,444813,2340281.5673433,310153855703.433,569.205298013245,887989,16060164.7953032
1182,BTC,2016-12-24,195267802,208340663,295341,553797,208340663,240820,181894520,2127,6.33931740130674,444950,2111242.17117514,310153855703.433,630.955882352941,854889,16061877.2953032
1182,BTC,2016-12-25,195488203,208573642,232979,472776,208573642,197364,182091884,1540,5.54548619088121,445115,2540994.10746983,310153855703.433,524.243902439025,648125,16063939.7953032
1182,BTC,2016-12-26,195766449,208870983,297341,591799,208870983,244914,182336798,2340,6.17782993367766,445257,2185779.21871515,310153855703.433,609.439716312057,855863,16065714.7953032
1182,BTC,2016-12-27,196091202,209232985,362002,650563,209232985,296546,182633344,3779,7.56041129849892,445413,2420382.89215487,310153855703.433,550.367741935484,876639,16067664.7953032
1182,BTC,2016-12-28,196427413,209607563,374578,662997,209607563,305394,182938738,3551,6.75746639396062,445577,2572055.65248781,312083434211.514,521.134969325153,868480,16069714.7953032
1182,BTC,2016-12-29,196762574,209982461,374898,656761,209982461,304605,183243343,3178,5.8496801708401,445727,2360248.58290897,317688400354.034,578.100671140939,940397,16071589.7953032
1182,BTC,2016-12-30,197091692,210337552,355091,644375,210337552,286818,183530161,3305,7.69699488422268,445884,2490825.23421298,317688400354.034,547.794871794872,871707,16073552.2953032
1182,BTC,2016-12-31,197358819,210645006,307454,573846,210645006,250273,183780434,2054,5.51121723441917,446032,2356084.26550084,317688400354.034,579.122448979592,803915,16075402.2953033
1182,BTC,2017-01-01,197551268,210858256,213250,465501,210858256,180502,183960936,1809,6.00736216152081,446188,2463729.87494542,317688400354.034,553.81935483871,698539,16077352.2953032
1182,BTC,2017-01-02,197898002,211209201,350945,706004,211209201,290951,184251887,3077,5.40978245606023,446347,2514431.98304835,317688400354.034,542.651898734177,944877,16079339.7953032
1182,BTC,2017-01-03,198215569,211572472,363271,656631,211572472,301664,184553551,3830,6.46588706299701,446511,2590799.58347927,317688400354.034,526.656441717792,906573,16081389.7953033
1182,BTC,2017-01-04,198566189,211967293,394821,699023,211967293,328642,184882193,5739,7.55240602494483,446664,2490281.52270629,317688400354.034,547.914473684211,986063,16083302.2953032
1182,BTC,2017-01-05,198890962,212319346,352053,653187,212319346,288501,185170694,5645,10.3923907076495,446804,2204094.40304523,317688400354.034,619.057553956834,984196,16085052.2953032
1182,BTC,2017-01-06,199238079,212720331,400985,719666,212720331,346405,185517099,4634,8.95094558773984,446965,2579718.13220675,317688400354.034,528.91875,984330,16087064.7953032
1182,BTC,2017-01-07,199542247,213054105,333774,649279,213054105,282060,185799159,2973,7.63293112642175,447103,2202325.62480662,317688400354.034,619.554744525547,987245,16088789.7953032
1182,BTC,2017-01-08,199837829,213360340,306235,599742,213360340,260101,186059260,1978,6.45901130456442,447270,2644829.74011018,317688400354.034,515.897590361446,810419,16090877.2953032
1182,BTC,2017-01-09,200125356,213689622,329282,612983,213689622,269947,186329207,3276,7.7621868560307,447406,2142958.38766223,317688400354.034,636.718518518519,923003,16092577.2953033
1182,BTC,2017-01-10,200466843,214063938,374316,703934,214063938,323888,186653095,3536,7.284387042688,447566,2546473.50054116,319489481520.45,538.861635220126,959720,16094577.2953033
1182,BTC,2017-01-11,200781323,214409656,345718,640611,214409656,303058,186956153,3762,13.1338887395617,447719,2568403.27203477,336899932795.808,563.375,923016,16096489.7953032
1182,BTC,2017-01-12,201093143,214753210,343554,626371,214753210,295125,187251278,4049,11.9329915906933,447891,2919489.65296894,336899932795.808,495.625730994152,801678,16098639.7953033
1182,BTC,2017-01-13,201367961,215082957,329747,593639,215082957,272747,187524025,3117,8.65908537274555,448041,2501527.54840064,336899932795.808,578.436241610738,840487,16100514.7953032
1182,BTC,2017-01-14,201648508,215379922,296965,595370,215379922,242269,187766294,2015,6.19279280305425,448213,2898253.39473163,336899932795.808,499.257309941521,742766,16102664.7953032
1182,BTC,2017-01-15,201913743,215660476,280554,554307,215660476,235999,188002293,2227,7.30988502158954,448380,2810053.06747362,336899932795.808,514.927710843373,677067,16104752.2953032
1182,BTC,2017-01-16,202230287,215987570,327094,635067,215987570,267640,188269933,3232,7.80130229359924,448549,2819794.50507807,336899932795.808,513.14880952381,758334,16106864.7953032
1182,BTC,2017-01-17,202560734,216344196,356626,660229,216344196,292697,188562630,3780,7.89465040421829,448707,2684680.13520683,336899932795.808,538.974522292994,900242,16108839.7953033
1182,BTC,2017-01-18,202876711,216699398,355202,652518,216699398,297100,188859730,2965,6.51335103332016,448857,2497788.99409155,336899932795.808,579.302013422819,893842,16110714.7953033
1182,BTC,2017-01-19,203229976,217065444,366046,688533,217065444,300605,189160335,3213,8.66218163441263,449031,2905503.2203815,336899932795.808,498.011560693642,834368,16112889.7953033
1182,BTC,2017-01-20,203556592,217428966,363522,665649,217428966,298377,189458712,3334,8.67497904614598,449220,3171524.236717,336899932795.808,456.239361702127,722272,16115252.2953032
1182,BTC,2017-01-21,203865720,217753744,324778,638695,217753744,263562,189722274,2207,5.81822581735292,449401,3034867.39619518,336899932795.808,476.783333333333,693088,16117514.7953032
1182,BTC,2017-01-22,204137984,218041424,287680,566601,218041424,236886,189959160,1640,4.79440292721279,449575,2965666.35288457,339477557142.868,491.64161849711,674559,16119689.7953033
1182,BTC,2017-01-23,204452538,218328923,287499,621707,218328923,235530,190194690,2845,6.46548493840954,449713,2732236.58081131,392963262344.37,617.722627737226,908683,16121414.7953032
1182,BTC,2017-01-24,204824595,218695605,366682,725088,218695605,278177,190472867,3177,7.03175724704605,449862,2930318.32906143,392963262344.37,575.966216216216,973657,16123277.2953033
1182,BTC,2017-01-25,205187240,219061663,366058,713203,219061663,304727,190777594,3225,6.33576163644863,450011,2992418.30179677,392963262344.37,564.013513513514,987840,16125139.7953033
1182,BTC,2017-01-26,205580735,219437133,375470,727690,219437133,313755,191091349,2903,6.73511307540992,450166,3027662.13712739,392963262344.37,557.448051948052,993137,16127077.2953033
1182,BTC,2017-01-27,205930300,219766111,328978,664609,219766111,263332,191354681,3163,6.83645048219628,450336,3375528.72059708,392963262344.37,500.0,837679,16129202.2953033
1182,BTC,2017-01-28,206240460,220081596,315485,663149,220081596,246395,191601076,1895,5.07056658304742,450488,2974919.37858311,392963262344.37,567.331125827814,877465,16131102.2953033
1182,BTC,2017-01-29,206562027,220383281,301685,647475,220383281,241627,191842703,1936,5.69413854582861,450655,3249050.61763817,392963262344.37,519.463855421687,862491,16133189.7953033
1182,BTC,2017-01-30,206877746,220691805,308524,646742,220691805,247408,192090111,2220,5.90999976672957,450799,2835612.27909264,392963262344.37,595.202797202797,955111,16134989.7953032
1182,BTC,2017-01-31,207216335,221072912,381107,679601,221072912,307683,192397794,3311,5.82342469302064,450944,2840590.32811264,392963262344.37,594.159722222222,959546,16136802.2953032
1182,BTC,2017-02-01,207626759,221505051,432139,793057,221505051,350560,192748354,3122,5.93036460676994,451136,3755743.69485764,392963262344.37,449.38219895288,962289,16139202.2953033
1182,BTC,2017-02-02,207947276,221820930,315879,641874,221820930,259559,193007913,2808,7.13396825261201,451293,3069914.76950472,392963262344.37,549.775641025641,913956,16141164.7953032
1182,BTC,2017-02-03,208287776,222231598,410668,717712,222231598,323563,193331476,3506,7.53575860283058,451442,2908278.4212668,392963262344.37,580.331081081081,970819,16143027.2953033
1182,BTC,2017-02-04,208613616,222581750,350152,657814,222581750,284778,193616254,3315,7.44040824046278,451586,2799935.40460923,393571747855.609,603.72027972028,952156,16144827.2953032
1182,BTC,2017-02-05,208962783,222939960,358210,693085,222939960,292101,193908355,2609,6.16310263329646,451745,3350137.25007049,422170566883.837,541.23417721519,957944,16146814.7953032
1182,BTC,2017-02-06,209270001,223224905,284945,620842,223224905,230027,194138382,2925,7.30089257590248,451870,2616341.09668105,422170566883.837,693.032258064516,979201,16148377.2953032
1182,BTC,2017-02-07,209627295,223636885,411980,719291,223636885,325268,194463650,3846,6.26838029586913,452021,3211492.69943298,422170566883.837,564.600000000001,945680,16150264.7953032
1182,BTC,2017-02-08,209952570,224000017,363132,667561,224000017,308316,194771966,4043,6.35655011834031,452167,3073235.21711841,422170566883.837,590.0,961128,16152089.7953032
1182,BTC,2017-02-09,210338877,224412817,412800,761694,224412817,346544,195118510,3989,9.22543420802409,452336,3535258.39334281,422170566883.837,512.892857142857,956030,16154202.2953032
1182,BTC,2017-02-10,210665147,224768259,355442,661068,224768259,301789,195420299,2997,9.09269330304779,452483,3098341.3497177,422170566883.837,585.219178082192,967545,16156039.7953033
1182,BTC,2017-02-11,210966068,225082834,314575,631522,225082834,262686,195682985,1668,5.39862192143559,452622,2931485.54164018,422170566883.837,618.528985507246,963661,16157777.2953033
1182,BTC,2017-02-12,211245192,225363619,280785,571383,225363619,237744,195920729,1166,4.01692394999584,452762,2961714.96575572,422170566883.837,612.215827338129,872459,16159527.2953033
1182,BTC,2017-02-13,211575212,225706463,342844,672274,225706463,288290,196209019,2388,5.51900740765327,452925,3453162.58407995,422170566883.837,525.086419753086,910462,16161564.7953032
1182,BTC,2017-02-14,211902044,226078831,372368,681184,226078831,315084,196524103,2733,6.11002136948468,453094,3573789.25491015,422170566883.837,507.363095238095,884733,16163677.2953032
1182,BTC,2017-02-15,212205433,226427502,348671,636426,226427502,294786,196818889,2812,5.93768931919599,453233,2994385.27808363,422170566883.837,605.536231884058,940088,16165414.7953033
1182,BTC,2017-02-16,212550889,226763007,335505,674048,226763007,283203,197102092,3940,10.5453718330859,453384,3171091.14849163,422170566883.837,571.793333333334,973947,16167302.2953033
1182,BTC,2017-02-17,212878246,227144104,381097,698688,227144104,319767,197421859,5399,7.82427817046831,453535,3153625.95328346,422170566883.837,574.96,969075,16169189.7953033
1182,BTC,2017-02-18,213212010,227486708,342604,692667,227486708,286143,197708002,2130,4.36340172266206,453686,3252689.73676584,432892501850.986,571.606666666667,961979,16171077.2953033
1182,BTC,2017-02-19,213496166,227795058,308350,600447,227795058,251721,197959723,1438,5.63820775050763,453820,2960319.21193961,440779902286.589,639.503759398496,930882,16172752.2953032
1182,BTC,2017-02-20,213813558,228130726,335668,660622,228130726,282728,198242451,2582,5.52219063793112,453968,3257683.65559761,440779902286.589,581.12925170068,951329,16174602.2953033
1182,BTC,2017-02-21,214125657,228465015,334289,647509,228465015,279090,198521541,2601,6.2852427878933,454106,3046020.77950523,440779902286.589,621.51094890511,949667,16176327.2953032
1182,BTC,2017-02-22,214423027,228801629,336614,636232,228801629,282194,198803735,3062,9.03245297142537,454244,3060470.013718,440779902286.589,618.576642335767,977160,16178052.2953032
1182,BTC,2017-02-23,214757783,229191670,390041,702509,229191670,325913,199129648,4165,10.2572112403275,454394,3349448.49545444,440779902286.589,565.208053691275,960712,16179927.2953033
1182,BTC,2017-02-24,215133007,229605418,413748,768914,229605418,343805,199473453,3567,5.58442295995713,454557,3597807.59638805,440779902286.589,526.191358024691,971179,16181964.7953033
1182,BTC,2017-02-25,215496834,229987552,382134,756336,229987552,326521,199799974,2276,3.77682953101173,454724,3696833.87444859,440779902286.589,512.096385542169,966332,16184052.2953033
1182,BTC,2017-02-26,215834267,230295793,308241,660039,230295793,265203,200065177,2049,4.25372362494878,454902,3948446.84987605,440779902286.589,479.463276836158,921750,16186277.2953033
1182,BTC,2017-02-27,216137563,230630358,334565,666849,230630358,284555,200349732,4536,6.61110523521101,455046,3182787.34146351,440779902286.589,594.804195804196,945149,16188077.2953032
1182,BTC,2017-02-28,216479796,231018965,388607,711021,231018965,325414,200675146,3866,6.00705175050477,455199,3400774.8069297,440779902286.589,556.677631578947,968234,16189989.7953032
1182,BTC,2017-03-01,216815200,231399671,380706,693531,231399671,315883,200991029,4579,7.89480936629252,455343,3185821.20719805,440779902286.589,594.237762237762,979145,16191789.7953033
1182,BTC,2017-03-02,217178884,231799349,399678,740534,231799349,329428,201320457,5526,8.3235285356722,455500,3484873.63826702,440779902286.589,543.243589743589,955612,16193752.2953032
1182,BTC,2017-03-03,217524853,232209436,410087,736366,232209436,337310,201657767,8701,13.5138845632853,455651,3323921.52673642,445545600359.096,575.706666666666,985290,16195639.7953032
1182,BTC,2017-03-04,217816596,232538250,328814,626904,232538250,265780,201923547,6554,7.42792875130431,455783,3024283.16469293,460769358090.714,654.36641221374,985903,16197289.7953032
1182,BTC,2017-03-05,218148911,232888503,350253,698112,232888503,280739,202204286,2556,4.39116311177389,455930,3488342.60520338,460769358090.714,567.315068493151,983301,16199127.2953033
1182,BTC,2017-03-06,218466821,233256309,367806,687505,233256309,287731,202492017,4615,6.65683906080461,456072,3303978.38711495,460769358090.714,598.971631205674,965532,16200902.2953032
1182,BTC,2017-03-07,218844991,233675338,419029,751777,233675338,327902,202819919,5174,6.40410531724692,456225,3523973.49165624,460769358090.714,561.578947368421,974861,16202814.7953032
1182,BTC,2017-03-08,219197882,234048470,373132,697316,234048470,297108,203117027,4719,8.49096909059113,456367,3272744.80341297,460769358090.714,604.687943262411,979427,16204589.7953032
1182,BTC,2017-03-09,219552576,234433901,385431,712606,234433901,303632,203420659,5641,18.7712280763449,456515,3517331.22101591,460769358090.714,562.639455782313,991798,16206439.7953032
1182,BTC,2017-03-10,219928275,234820570,386669,750291,234820570,308482,203729141,4833,8.92010524007245,456671,3567405.30580651,460769358090.714,554.741935483871,991821,16208389.7953033
1182,BTC,2017-03-11,220275228,235174339,353769,700488,235174339,280681,204009822,3291,5.88303509785251,456820,3416866.97175401,460769358090.714,579.182432432433,997576,16210252.2953033
1182,BTC,2017-03-12,220573165,235455433,281094,596814,235455433,221110,204230932,2496,5.43557173582439,456975,3642064.98519071,460769358090.714,543.37012987013,960146,16212189.7953032
1182,BTC,2017-03-13,220908280,235800319,344886,696369,235800319,273079,204504011,4626,7.65262074393384,457120,3320645.34259067,460769358090.714,595.965277777778,982872,16214002.2953032
1182,BTC,2017-03-14,221288307,236193647,393328,744191,236193647,310395,204814406,5761,8.70846453853371,457276,3610104.33598263,460769358090.714,548.18064516129,962449,16215952.2953033
1182,BTC,2017-03-15,221625629,236561891,368244,680432,236561891,292434,205106840,5493,7.77884635586799,457418,3262337.28132759,460769358090.714,606.617021276596,983983,16217727.2953032
1182,BTC,2017-03-16,221990467,236984922,423031,741421,236984922,327034,205433874,5875,10.1406705127401,457571,3569342.95162001,460769358090.714,554.440789473684,988260,16219639.7953032
1182,BTC,2017-03-17,222358422,237355941,371019,719835,237355941,292196,205726070,6166,10.6855089589946,457725,3636554.59711578,469886043904.13,554.960784313726,995548,16221564.7953032
1182,BTC,2017-03-18,222692708,237692595,336654,688602,237692595,263530,205989600,4056,9.86352324712765,457882,3725652.53689259,475705205061.629,548.397435897436,942046,16223527.2953032
1182,BTC,2017-03-19,223017688,238034073,341478,679122,238034073,269336,206258936,4909,23.5588237619762,458047,3897078.20236301,475705205061.629,524.274390243903,889056,16225589.7953032
1182,BTC,2017-03-20,223326779,238388974,354901,657207,238388974,277033,206535969,5371,11.8995751762079,458183,3256708.50671064,475705205061.629,627.362962962963,977387,16227289.7953032
1182,BTC,2017-03-21,223664446,238765525,376551,697181,238765525,288055,206824024,5592,21.5268879979163,458325,3355141.33045678,475705205061.629,608.957446808511,982003,16229064.7953032
1182,BTC,2017-03-22,224060924,239170368,404843,748042,239170368,316593,207140617,6474,16.5515626127248,458484,3753018.09135283,475705205061.629,544.398734177215,982097,16231052.2953033
1182,BTC,2017-03-23,224401638,239541934,371566,684539,239541934,287871,207428488,4667,8.2657094042888,458632,3551729.26192227,475705205061.629,575.251700680272,965088,16232902.2953032
1182,BTC,2017-03-24,224772590,239916872,374938,714958,239916872,289521,207718009,4501,13.3885167346318,458808,4212011.14643315,475705205061.629,485.074285714286,869937,16235102.2953033
1182,BTC,2017-03-25,225054226,240247892,331020,619575,240247892,242975,207960984,4331,13.8267763756031,458941,3182533.51788394,475705205061.629,641.984848484848,939924,16236764.7953032
1182,BTC,2017-03-26,225321407,240554695,306803,591405,240554695,221915,208182899,2976,7.98813632722664,459107,3904131.13314168,475705205061.629,523.327272727273,676743,16238839.7953032
1182,BTC,2017-03-27,225607234,240865293,310598,604343,240865293,232291,208415190,4139,10.0611617948399,459239,3105145.44844591,475705205061.629,657.984732824427,900950,16240489.7953032
1182,BTC,2017-03-28,225980025,241255398,390105,739715,241255398,294001,208709191,4537,7.93264414308635,459394,3680985.72655663,475705205061.629,555.051948051948,985683,16242427.2953032
1182,BTC,2017-03-29,226306701,241632687,377289,689325,241632687,283931,208993122,3514,6.38235290485759,459532,3259504.47585332,475705205061.629,626.824817518249,973170,16244152.2953033
1182,BTC,2017-03-30,226677071,242006262,373575,708778,242006262,288788,209281910,4174,7.49612083881151,459696,4037035.56247143,482855238677.464,513.705521472393,962550,16246202.2953033
1182,BTC,2017-03-31,226990082,242353957,347695,634614,242353957,259403,209541313,6323,13.7772075252961,459831,3359384.99147008,499635929816.668,638.783582089552,960527,16247889.7953032
1182,BTC,2017-04-01,227295145,242692119,338162,643936,242692119,255871,209797184,4403,11.1759666233765,459963,3259121.40953518,499635929816.668,658.435114503817,967154,16249539.7953033
1182,BTC,2017-04-02,227600054,243015299,323180,659287,243015299,244203,210041387,4911,16.4875482126482,460121,3935398.16165933,499635929816.668,545.286624203821,824273,16251514.7953033
1182,BTC,2017-04-03,227956560,243395457,380158,745400,243395457,288141,210329528,6335,14.4486213825198,460297,4406975.33541553,499635929816.668,486.937142857143,878287,16253714.7953032
1182,BTC,2017-04-04,228259818,243743050,347593,639720,243743050,256015,210585543,5904,9.67366559927797,460422,3088765.71208224,499635929816.668,694.75,977861,16255277.2953032
1182,BTC,2017-04-05,228637023,244152054,409004,753537,244152054,316555,210902098,5392,7.25201260427812,460584,4113454.0192822,499635929816.668,521.683229813665,966858,16257302.2953033
1182,BTC,2017-04-06,228994232,244539153,387099,707107,244539153,290465,211192563,4631,7.04172686759486,460731,3688319.69929359,499635929816.668,581.81506849315,977744,16259139.7953033
1182,BTC,2017-04-07,229380634,244928283,389130,729776,244928283,295463,211488026,5512,19.945712953208,460893,4076663.04656729,499635929816.668,526.391304347826,977586,16261164.7953033
1182,BTC,2017-04-08,229649327,245238928,310645,603135,245238928,226959,211714985,5607,43.3476391811137,461030,3516629.92013258,499635929816.668,610.220588235294,974429,16262877.2953032
1182,BTC,2017-04-09,229975822,245565645,326717,666532,245565645,238286,211953271,3110,6.34687613487641,461189,3946404.66272623,499635929816.668,543.76582278481,925461,16264864.7953033
1182,BTC,2017-04-10,230292518,245944864,379219,695999,245944864,273384,212226655,4612,7.60023226286304,461336,3702966.78670702,499635929816.668,579.513698630137,917565,16266702.2953032
1182,BTC,2017-04-11,230679851,246363432,418568,762554,246363432,307893,212534548,4778,6.57576562836891,461503,4266344.69227121,499635929816.668,502.987951807229,962831,16268789.7953033
1182,BTC,2017-04-12,231009804,246750524,387092,694225,246750524,278093,212812641,5142,7.43792861616599,461645,3676217.00682998,499635929816.668,583.730496453901,982567,16270564.7953032
1182,BTC,2017-04-13,231319856,247069536,319012,616904,247069536,228679,213041320,4574,9.37221172673455,461772,3324790.0530793,517807877352.073,668.904761904762,972980,16272152.2953032
1182,BTC,2017-04-14,231653437,247460274,390738,705778,247460274,290208,213331528,4858,7.63648269624273,461911,3611928.00838898,520808749422.14,619.297101449275,995109,16273889.7953033
1182,BTC,2017-04-15,231981580,247811775,351501,689879,247811775,270705,213602233,3150,5.94871651283626,462061,3902849.34353167,520808749422.14,573.134228187919,991701,16275764.7953032
1182,BTC,2017-04-16,232271989,248093221,281446,595592,248093221,211829,213814062,3644,8.98163185810687,462207,3782439.64087019,520808749422.14,591.379310344827,927419,16277589.7953033
1182,BTC,2017-04-17,232556107,248421085,327864,608594,248421085,245184,214059246,4362,9.99985763730774,462345,3584873.74052114,520808749422.14,623.970802919708,930786,16279314.7953032
1182,BTC,2017-04-18,232901067,248818359,397274,715616,248818359,303091,214362337,5804,8.1045658055226,462491,3783101.40788031,520808749422.14,591.275862068965,955539,16281139.7953033
1182,BTC,2017-04-19,233248884,249220574,402215,727714,249220574,310104,214672441,4829,7.01924512418044,462634,3727175.57369548,520808749422.14,600.147887323944,984213,16282927.2953033
1182,BTC,2017-04-20,233609344,249575525,354951,691989,249575525,267915,214940356,5363,8.29650492151138,462772,3635827.38336982,520808749422.14,615.226277372263,973990,16284652.2953032
1182,BTC,2017-04-21,234003143,250004098,428573,797398,250004098,330354,215270710,4932,7.08044206111287,462939,4334487.27237915,520808749422.14,516.060240963855,975939,16286739.7953032
1182,BTC,2017-04-22,234319593,250361874,357776,695315,250361874,268712,215539422,3970,6.49844187206701,463084,3743431.91616554,520808749422.14,597.541666666667,973032,16288552.2953033
1182,BTC,2017-04-23,234621558,250687579,325705,647988,250687579,245039,215784461,3518,6.43955574233485,463237,4012677.56016959,520808749422.14,557.447368421052,947631,16290464.7953033
1182,BTC,2017-04-24,234919038,250995058,307479,611649,250995058,222671,216007132,4922,8.71599640038029,463361,3203844.5571215,520808749422.14,698.178861788618,963089,16292014.7953032
1182,BTC,2017-04-25,235288157,251422350,427292,742833,251422350,325387,216332519,8622,9.97839514433969,463509,3844789.26484216,520808749422.14,581.789115646259,966010,16293864.7953032
1182,BTC,2017-04-26,235662760,251864899,442549,771922,251864899,334471,216666990,6152,7.264468229515,463662,3998614.54813936,520808749422.14,559.407894736842,971854,16295777.2953033
1182,BTC,2017-04-27,236021156,252256258,391359,727280,252256258,297884,216964874,6871,8.85208150576382,463809,3806963.30216157,521839702599.647,588.732876712329,967617,16297614.7953032
1182,BTC,2017-04-28,236356094,252666159,409901,730815,252666159,305271,217270145,6470,8.04031278346063,463945,3516750.76994887,521974519553.628,637.481481481482,996674,16299314.7953032
1182,BTC,2017-04-29,236762121,253104152,437993,837083,253104152,341319,217611464,5551,6.11150609302251,464118,4519091.50002275,521974519553.628,496.087209302326,971570,16301477.2953033
1182,BTC,2017-04-30,237135348,253468855,364703,738955,253468855,281489,217892953,6055,6.34636872058134,464269,3919250.40936367,521974519553.628,572.013333333333,971893,16303364.7953033
1182,BTC,2017-05-01,237478342,253851437,382582,716349,253851437,294786,218187739,7137,8.51127545550515,464419,3905046.29569083,521974519553.628,574.093959731544,977420,16305239.7953032
1182,BTC,2017-05-02,237865904,254285381,433944,793139,254285381,333161,218520900,8205,7.59901160468083,464577,4174297.2290945,521974519553.628,537.063694267515,980238,16307214.7953033
1182,BTC,2017-05-03,238195428,254680661,395280,693523,254680661,295149,218816049,7429,8.89568264096517,464709,3436831.40591779,521974519553.628,652.30534351145,995290,16308864.7953032
1182,BTC,2017-05-04,238596781,255153443,472782,855571,255153443,354737,219170786,9614,8.15372757325997,464877,4376489.87642088,521974519553.628,512.251497005988,971046,16310964.7953032
1182,BTC,2017-05-05,238904124,255512189,358746,666643,255512189,267193,219437979,8778,10.7162848980499,465006,3355612.12902852,521974519553.628,668.09375,961245,16312577.2953032
1182,BTC,2017-05-06,239320212,255990993,478804,877650,255990993,363022,219801001,9036,7.47408444059663,465174,4387619.71859861,521974519553.628,510.952095808383,964933,16314677.2953032
1182,BTC,2017-05-07,239711139,256384888,393895,794066,256384888,316011,220117012,7541,7.00395462281348,465341,4419091.11878633,521974519553.628,507.313253012048,964836,16316764.7953033
1182,BTC,2017-05-08,240136534,256860572,475684,894501,256860572,365096,220482108,12213,10.6197153640628,465521,4743927.42559182,521974519553.628,472.575418994414,968144,16319014.7953033
1182,BTC,2017-05-09,240526694,257306412,445840,798779,257306412,332879,220814987,10357,9.50050093695208,465676,4042183.99957306,521974519553.628,554.616883116883,987786,16320952.2953032
1182,BTC,2017-05-10,240880605,257716788,410376,740812,257716788,311391,221126378,12271,12.4434225298636,465824,4137802.67274844,555092980097.547,576.176870748299,960165,16322802.2953032
1182,BTC,2017-05-11,241205582,258114683,397895,708026,258114683,294743,221421121,10213,10.3268038851818,465959,3744148.63787234,559970892890.838,642.350746268657,961242,16324489.7953032
1182,BTC,2017-05-12,241555282,258533571,418888,749974,258533571,317698,221738819,9730,9.67282668506556,466113,4349930.49976646,559970892890.838,552.895424836602,954580,16326414.7953032
1182,BTC,2017-05-13,241934138,258964985,431414,796331,258964985,329266,222068085,9397,9.14202381605872,466271,4413154.3279468,559970892890.838,544.974522292994,955090,16328389.7953033
1182,BTC,2017-05-14,242355263,259451035,486050,896627,259451035,369098,222437183,8539,6.89696616545579,466435,4623363.49518263,559970892890.838,520.196319018405,975085,16330439.7953033
1182,BTC,2017-05-15,242742606,259876891,425856,829143,259876891,329229,222766412,10996,9.42718316442385,466605,4721823.62353152,559970892890.838,509.349112426036,970711,16332564.7953033
1182,BTC,2017-05-16,243092084,260195806,318915,662457,260195806,233977,223000389,10740,11.9632665436378,466737,3733542.18054709,559970892890.838,644.175572519084,973960,16334214.7953032
1182,BTC,2017-05-17,243479338,260615269,419463,765222,260615269,317527,223317916,13414,12.7437324581541,466892,4362169.52004455,559970892890.838,551.344155844156,981881,16336152.2953033
1182,BTC,2017-05-18,243854365,261006049,390780,744563,261006049,288904,223606820,11279,11.1117393482728,467034,3984174.24316052,559970892890.838,603.652482269503,974609,16337927.2953033
1182,BTC,2017-05-19,244256765,261439002,432953,811073,261439002,319502,223926322,11702,9.21985991328176,467198,4553973.29914415,559970892890.838,528.122699386503,971260,16339977.2953033
1182,BTC,2017-05-20,244695926,261919470,480468,854723,261919470,352805,224279127,9322,7.94797316094194,467363,4579571.03561215,559970892890.838,525.170731707317,967212,16342039.7953032
1182,BTC,2017-05-21,245072429,262354474,435004,793969,262354474,326057,224605184,11251,7.09330997721944,467510,4162921.60031533,559970892890.838,577.732876712329,990363,16343877.2953032
1182,BTC,2017-05-22,245440572,262796648,442174,775500,262796648,327868,224933052,15365,10.1376159447049,467656,4125018.83575212,559970892890.838,583.041379310345,966800,16345702.2953032
1182,BTC,2017-05-23,245862784,263285323,488675,881824,263285323,367710,225300762,19305,11.185319652391,467824,4882067.11051552,584152236545.524,513.904191616766,978685,16347802.2953033
1182,BTC,2017-05-24,246238619,263739626,454303,814969,263739626,338642,225639404,18921,10.5958106812069,467978,4700719.84205552,595921917085.416,544.483660130719,970548,16349727.2953033
1182,BTC,2017-05-25,246634808,264215282,475656,846813,264215282,350114,225989518,16351,10.0849578388085,468141,4804502.30548824,595921917085.416,532.722222222222,976875,16351764.7953032
1182,BTC,2017-05-26,247021933,264687482,472200,822114,264687482,333340,226322858,12684,8.41373966686098,468294,4635883.43542494,595921917085.416,552.098684210526,958775,16353677.2953033
1182,BTC,2017-05-27,247448551,265136678,449196,896081,265136678,331914,226654772,9375,8.00622435752785,468462,4976779.17203468,595921917085.416,514.281437125748,991460,16355777.2953032
1182,BTC,2017-05-28,247875830,265534517,397839,860215,265534517,308143,226962915,10415,9.04302894522157,468627,4874718.76893719,595921917085.416,525.048780487805,977982,16357839.7953033
1182,BTC,2017-05-29,248238059,265956989,422472,773589,265956989,321638,227284553,9577,7.85084151930086,468778,4450314.96879171,595921917085.416,575.12,977900,16359727.2953032
1182,BTC,2017-05-30,248646442,266417099,460110,851547,266417099,347961,227632514,15138,10.9967213226888,468957,5289686.11217811,595921917085.416,483.859550561798,980603,16361964.7953032
1182,BTC,2017-05-31,249035527,266854699,437600,822814,266854699,321634,227954148,13223,10.3546628292491,469121,4873007.82136816,595921917085.416,525.233128834356,976696,16364014.7953032
1182,BTC,2017-06-01,249447577,267293631,438932,841940,267293631,319709,228273857,13097,10.501459860669,469291,5048549.32981513,595921917085.416,506.970414201183,977746,16366139.7953032
1182,BTC,2017-06-02,249801209,267666664,373033,729203,267666664,271539,228545396,11874,10.7859590800078,469437,4415548.62048883,595921917085.416,579.648275862069,981988,16367964.7953032
1182,BTC,2017-06-03,250261895,268076849,410185,887640,268076849,305320,228850716,14531,10.5918678035304,469629,5715362.81088963,595921917085.416,447.821989528796,981052,16370364.7953033
1182,BTC,2017-06-04,250611044,268438492,361643,738057,268438492,266044,229116760,13148,13.1041300084383,469790,5101848.0022639,628336862171.423,528.9625,982358,16372377.2953032
1182,BTC,2017-06-05,251004131,268846944,408452,770564,268846944,289930,229406690,14896,11.2424677720018,469954,5554095.01806578,678760110082.99,524.883435582822,964430,16374427.2953032
1182,BTC,2017-06-06,251375730,269279784,432840,805562,269279784,297416,229704106,12564,8.55931642921222,470105,5105163.341685,678760110082.99,571.04,990044,16376314.7953032
1182,BTC,2017-06-07,251824624,269761254,481470,882021,269761254,339720,230043826,13162,7.74404923287437,470270,5546548.71157418,678760110082.99,525.59756097561,992122,16378377.2953032
1182,BTC,2017-06-08,252239430,270191921,430667,824752,270191921,307377,230351203,11646,7.79365144620551,470435,5586079.89251147,678760110082.99,521.878048780488,969814,16380439.7953032
1182,BTC,2017-06-09,252618199,270598372,406451,769003,270598372,282184,230633387,12053,9.20187216209767,470586,5062901.56644441,678760110082.99,575.806666666667,973540,16382327.2953032
1182,BTC,2017-06-10,252953066,270956035,357663,705037,270956035,254993,230888380,11995,9.60465036341876,470727,4807078.03551126,678760110082.99,606.45,966455,16384089.7953032
1182,BTC,2017-06-11,253283127,271274040,318005,669902,271274040,222892,231111272,11649,10.325782132927,470873,4932054.66090508,678760110082.99,591.082758620689,945474,16385914.7953033
1182,BTC,2017-06-12,253638108,271660372,386332,725777,271660372,269098,231380370,12090,10.7527330969312,471020,5033013.60219503,678760110082.99,579.22602739726,967594,16387752.2953032
1182,BTC,2017-06-13,253983157,272086038,425666,771394,272086038,291776,231672146,14824,11.4225571948061,471161,4827433.27753282,678760110082.99,603.892857142857,977147,16389514.7953032
1182,BTC,2017-06-14,254346501,272493345,407307,746991,272493345,287644,231959790,14442,11.3573501819876,471301,4743244.18506604,678760110082.99,614.611510791367,969356,16391264.7953032
1182,BTC,2017-06-15,254752532,272903387,410042,799478,272903387,293141,232252931,12012,10.4605834775706,471454,5130347.52170428,678760110082.99,568.236842105263,994383,16393177.2953033
1182,BTC,2017-06-16,255111888,273281721,378334,732364,273281721,269937,232522868,14762,12.7756999617365,471602,5002592.8484715,678760110082.99,582.748299319728,983088,16395027.2953032
1182,BTC,2017-06-17,255441770,273613564,331843,667827,273613564,236554,232759422,11763,9.88436441709783,471747,4955769.83288433,679668719409.632,589.041666666667,985705,16396839.7953032
1182,BTC,2017-06-18,255760165,273906263,292699,631933,273906263,209359,232968781,9657,10.8107024592185,471892,5120246.74262849,711697198173.757,596.986111111111,936637,16398652.2953033
1182,BTC,2017-06-19,256137124,274288252,381989,733099,274288252,269774,233238555,14223,11.3864535450829,472043,5342477.29188758,711697198173.757,572.153333333333,986316,16400539.7953032
1182,BTC,2017-06-20,256456994,274692877,404625,745136,274692877,269438,233507993,13682,11.202743259438,472181,4879064.64104769,711697198173.757,626.496350364964,965675,16402264.7953033
1182,BTC,2017-06-21,256806572,275109171,416294,758122,275109171,280203,233788196,15631,12.9390901268027,472321,4935742.83566727,711697198173.757,619.302158273381,983057,16404014.7953033
1182,BTC,2017-06-22,257190948,275486792,377621,739184,275486792,269685,234057881,14985,12.1147317354157,472460,4937689.73817083,711697198173.757,619.057971014493,992577,16405752.2953032
1182,BTC,2017-06-23,257549499,275843954,357162,715885,275843954,259938,234317819,11661,9.23972453094557,472620,5797798.75863634,711697198173.757,527.220125786164,948880,16407752.2953032
1182,BTC,2017-06-24,257862476,276160397,316443,649568,276160397,227127,234544946,11726,9.9247346033303,472766,5242956.90251146,711697198173.757,583.013793103449,949838,16409577.2953032
1182,BTC,2017-06-25,258118039,276413430,253033,538529,276413430,180719,234725665,7754,10.3388633550209,472888,4290252.39633621,711697198173.757,712.479338842975,927724,16411102.2953033
1182,BTC,2017-06-26,258473667,276771546,358116,707638,276771546,261906,234987571,16412,14.4304402942248,473030,5056632.12924851,711697198173.757,604.496453900709,987224,16412877.2953032
1182,BTC,2017-06-27,258770903,277138361,366815,700130,277138361,259737,235247308,12303,10.6654373581501,473161,4729280.97692856,711697198173.757,646.338461538461,989948,16414514.7953032
1182,BTC,2017-06-28,259158390,277532201,393840,749164,277532201,279811,235527119,11785,10.0924056876999,473318,5566164.25739222,711697198173.757,549.160256410256,972587,16416477.2953032
1182,BTC,2017-06-29,259466917,277866951,334750,624172,277866951,231054,235758173,10173,13.7917333559857,473438,4216942.30986358,711697198173.757,724.865546218487,966836,16417977.2953032
1182,BTC,2017-06-30,259827041,278238910,371959,727417,278238910,267360,236025533,13985,12.9975824289552,473592,5447359.20509354,711697198173.757,561.137254901961,956314,16419902.2953032
1182,BTC,2017-07-01,260153302,278544516,305606,647826,278544516,221856,236247389,10484,10.4411633376684,473756,5816674.90604744,711697198173.757,525.509202453988,882732,16421952.2953032
1182,BTC,2017-07-02,260453349,278815873,271357,608987,278815873,196539,236443928,9153,9.15661598187296,473944,6647184.76912485,708707940676.237,457.919786096257,779583,16424302.2953033
1182,BTC,2017-07-03,260792474,279166456,350583,672266,279166456,253244,236697172,14047,11.1830274479907,474114,5998251.99832961,708659466230.332,507.426035502958,815769,16426427.2953033
1182,BTC,2017-07-04,261111429,279531594,365138,722198,279531594,255483,236952655,11420,8.94910152406849,474267,5434485.1777509,708659466230.332,560.065789473684,897029,16428339.7953033
1182,BTC,2017-07-05,261420862,279863975,332381,658024,279863975,237008,237189663,10890,10.6071830407012,474416,5236602.80226098,708659466230.332,581.22972972973,909539,16430202.2953032
1182,BTC,2017-07-06,261729703,280193566,329591,629688,280193566,225106,237414769,10106,9.84357854249776,474558,5017565.11248405,708659466230.332,606.602836879432,956304,16431977.2953033
1182,BTC,2017-07-07,262059915,280583545,389979,741956,280583545,243614,237658383,9999,10.0722498590107,474706,5380029.30419337,708659466230.332,565.734693877551,937060,16433827.2953032
1182,BTC,2017-07-08,262377994,280894068,310523,645693,280894068,220835,237879218,10852,12.225139905349,474871,5834123.28287445,708659466230.332,521.701219512195,858895,16435889.7953032
1182,BTC,2017-07-09,262631190,281162203,268135,553222,281162203,188124,238067342,9289,12.585299171742,475009,4847114.10034097,708659466230.332,627.934306569343,749616,16437614.7953033
1182,BTC,2017-07-10,262949166,281521927,359724,775801,281521927,251722,238319064,13320,12.9868682773784,475206,6964674.20893326,708659466230.332,437.015306122449,746657,16440077.2953032
1182,BTC,2017-07-11,263299145,281894938,373011,775095,281894938,265759,238584823,12323,10.8991569237948,475379,6188732.9362596,708659466230.332,491.808139534884,890107,16442239.7953032
1182,BTC,2017-07-12,263683519,282259609,364671,754337,282259609,257138,238841961,10611,10.2335931547482,475556,6289384.95458627,708659466230.332,483.9375,881564,16444452.2953032
1182,BTC,2017-07-13,264015252,282613336,353727,684759,282613336,245895,239087856,9638,10.2332296091959,475713,5570169.63595146,708659466230.332,546.423076923077,855335,16446414.7953033
1182,BTC,2017-07-14,264313598,282938640,325304,643748,282938640,227903,239315759,10680,11.4162598961444,475852,5260486.08976871,761764941640.48,621.949275362319,900208,16448152.2953033
1182,BTC,2017-07-15,264634413,283247043,308403,639495,283247043,221851,239537610,7619,8.82832945555071,475979,5181756.97239115,804525194568.132,666.841269841269,974987,16449739.7953032
1182,BTC,2017-07-16,264944191,283529656,282613,613814,283529656,203165,239740775,7210,10.01781158722,476142,6586921.18088868,804525194568.132,524.586419753086,840269,16451777.2953032
1182,BTC,2017-07-17,265298805,283867225,337569,696719,283867225,230315,239971090,8276,11.5408706033753,476290,5977372.75204512,804525194568.132,578.081632653061,945287,16453627.2953032
1182,BTC,2017-07-18,265698602,284246165,378940,815536,284246165,260575,240231665,9556,10.1842731190214,476455,6565566.10337402,804525194568.132,526.292682926829,959427,16455689.7953032
1182,BTC,2017-07-19,266067368,284615402,369237,721931,284615402,253768,240485433,10188,9.88842497029586,476604,5965872.90305489,804525194568.132,579.195945945946,939300,16457552.2953032
1182,BTC,2017-07-20,266394436,284955374,339972,661661,284955374,230199,240715632,9723,10.6134735616248,476766,6456310.57499953,804525194568.132,535.198757763975,929456,16459577.2953032
1182,BTC,2017-07-21,266773720,285339272,383898,754509,285339272,268443,240984075,11554,8.43484270909366,476920,6162605.93696273,804525194568.132,560.705882352941,976516,16461502.2953032
1182,BTC,2017-07-22,267118123,285647146,307874,653793,285647146,223358,241207433,7970,8.02786680958412,477080,6382329.78075843,804525194568.132,541.40251572327,925754,16463502.2953032
1182,BTC,2017-07-23,267395431,285902677,255531,538475,285902677,181031,241388464,6992,8.84005309083842,477252,6907990.96639698,804525194568.132,500.204678362573,683351,16465652.2953032
1182,BTC,2017-07-24,267741105,286242054,339377,680062,286242054,240072,241628536,8831,9.96978656524547,477430,7140025.72651601,804525194568.132,483.949152542373,894424,16467877.2953032
1182,BTC,2017-07-25,268062220,286594558,352504,703420,286594558,244036,241872572,8496,30.0621888277391,477578,6023374.89740528,804525194568.132,573.666666666667,934254,16469727.2953032
1182,BTC,2017-07-26,268415979,286937109,342551,671131,286937109,237853,242110425,7449,15.5765488031327,477725,5864114.52195527,804525194568.132,589.246575342466,967338,16471564.7953032
1182,BTC,2017-07-27,268794896,287263376,326267,689863,287263376,225369,242335794,7546,11.0097488367756,477879,6459024.57110991,836351931635.612,556.137254901961,923606,16473489.7953032
1182,BTC,2017-07-28,269153186,287622888,359512,689042,287622888,247207,242583001,11240,17.0054735089395,478029,6421987.24090498,860221984436.222,575.308724832215,916863,16475364.7953032
1182,BTC,2017-07-29,269504300,287924081,301193,650841,287924081,211134,242794135,8090,19.5825495866822,478186,6703359.40859948,860221984436.222,551.160256410256,872203,16477327.2953032
1182,BTC,2017-07-30,269804560,288212619,288538,574465,288212619,184145,242978280,9534,48.1480492246982,478333,6345614.33788502,860221984436.222,582.232876712329,810337,16479164.7953032
1182,BTC,2017-07-31,270176064,288570556,357937,710260,288570556,231012,243209292,9479,12.7586566518091,478478,6203589.53166762,860221984436.222,595.5625,926722,16480977.2953033
1182,BTC,2017-08-01,270402051,288787628,217072,480718,288787628,131875,243341167,7082,19.9719291155917,478627,6497125.06965413,860221984436.222,568.655405405406,725291,16482839.7953032
1182,BTC,2017-08-02,270718142,289095620,307992,595251,289095620,209321,243550488,8350,13.474178218998,478779,6483305.2743582,860221984436.222,569.867549668874,878083,16484739.7953032
1182,BTC,2017-08-03,271026238,289413329,317709,599416,289413329,213017,243763505,6342,10.0143513363769,478917,6029346.81110387,860221984436.222,612.773722627737,868854,16486464.7953032
1182,BTC,2017-08-04,271359270,289750349,337020,669245,289750349,235792,243999297,6684,9.88038675298564,479096,7763925.40819049,860221984436.222,475.870786516854,924147,16488702.2953032
1182,BTC,2017-08-05,271705100,290094820,344471,662040,290094820,239771,244239068,6882,8.16863916576463,479273,7736146.41920513,860221984436.222,477.579545454546,881231,16490914.7953032
1182,BTC,2017-08-06,271963723,290388185,293365,542263,290388185,199627,244438695,6727,8.81569364194397,479413,6027404.14507796,860221984436.222,612.971223021583,786434,16492664.7953032
1182,BTC,2017-08-07,272297773,290761868,373683,686861,290761868,249002,244687697,9851,9.47751252260098,479566,6748903.92074337,860221984436.222,547.440789473684,943697,16494577.2953032
1182,BTC,2017-08-08,272675401,291168283,406415,793854,291168283,275574,244963271,14031,9.79773222405978,479730,7014021.92340984,860221984436.222,526.748466257669,979247,16496627.2953032
1182,BTC,2017-08-09,273031693,291560238,391955,710242,291560238,260955,245224226,12468,9.28579869339886,479868,6052334.42012512,888074709978.061,630.211678832117,954165,16498352.2953032
1182,BTC,2017-08-10,273393654,291949879,389641,736567,291949879,257965,245482191,12049,10.9900294141689,480002,6233131.53602232,923233068448.905,636.157894736842,981281,16500027.2953032
1182,BTC,2017-08-11,273769756,292378982,429103,741169,292378982,284001,245766192,12991,11.3731981378953,480146,6648667.22737938,923233068448.905,596.398601398601,967170,16501827.2953032
1182,BTC,2017-08-12,274104526,292753723,374741,697206,292753723,260521,246026713,10440,9.26804794047704,480281,6177847.19987543,923233068448.905,641.850746268657,979915,16503514.7953032
1182,BTC,2017-08-13,274476430,293133459,379736,709669,293133459,263310,246290023,10676,8.52029646609229,480429,6835926.39563435,923233068448.905,580.061224489796,983320,16505364.7953032
1182,BTC,2017-08-14,274794083,293523285,389826,692104,293523285,255362,246545385,12629,11.0517110696704,480559,5942839.25027613,923233068448.905,667.232558139535,955262,16506989.7953032
1182,BTC,2017-08-15,275161065,293976378,453093,825387,293976378,311002,246856387,15476,8.61443406282773,480711,6963628.05637906,923233068448.905,569.423841059603,975069,16508889.7953032
1182,BTC,2017-08-16,275497957,294379994,403616,691449,294379994,274866,247131253,12306,10.7506401123807,480841,6005988.1973161,923233068448.905,660.217054263566,966727,16510514.7953032
1182,BTC,2017-08-17,275972271,294857114,477120,879024,294857114,347319,247478572,13517,8.0354963367594,481020,8282275.741987,923233068448.905,478.76404494382,978681,16512752.2953032
1182,BTC,2017-08-18,276341448,295291561,434447,763319,295291561,312250,247790822,13340,8.54853165335702,481169,6824246.05405971,923233068448.905,581.054054054054,959987,16514614.7953032
1182,BTC,2017-08-19,276695377,295666056,374495,721026,295666056,266832,248057654,11517,8.8167458875618,481320,6900497.42254268,923233068448.905,574.633333333333,966455,16516502.2953032
1182,BTC,2017-08-20,277000242,295975378,309322,621899,295975378,210852,248268506,9217,8.45881869964145,481450,6117465.5901863,923233068448.905,648.186046511628,961449,16518127.2953032
1182,BTC,2017-08-21,277286549,296331892,356514,637529,296331892,236772,248505278,12336,10.5502116146594,481565,5412864.80093173,923233068448.905,732.561403508772,976486,16519564.7953032
1182,BTC,2017-08-22,277515987,296634327,302435,532361,296634327,196283,248701561,8703,9.39061216573142,481654,4055066.33892102,923233068448.905,977.852272727273,998175,16520677.2953032
1182,BTC,2017-08-23,277948314,297087837,453510,846625,297087837,315734,249017295,13880,7.48674367860345,481813,7299178.89413928,923233068448.905,543.246835443038,986510,16522664.7953025
1182,BTC,2017-08-24,278213704,297398413,310576,550862,297398413,203805,249221100,10095,8.08952940401021,481914,4503955.98577299,891643263405.002,850.27,938809,16523927.2953025
1182,BTC,2017-08-25,278437334,297718681,320268,580873,297718681,208169,249429269,9183,6.818775921748,482015,4582735.55484479,888171856257.321,832.4,928758,16525189.7953025
1182,BTC,2017-08-26,278722729,298057600,338919,620764,298057600,226485,249655754,10345,6.19419649125801,482120,4697256.46631729,888171856257.321,812.105769230769,998218,16526502.2953025
1182,BTC,2017-08-27,279124385,298425329,367729,767714,298425329,261891,249917645,8790,4.90719583942472,482275,6842057.27558038,888171856257.321,557.532467532468,990802,16528439.7953025
1182,BTC,2017-08-28,279419783,298766287,340958,657289,298766287,223771,250141416,11061,7.68847696895996,482404,5810892.10393153,888171856257.321,656.46875,981300,16530052.2953025
1182,BTC,2017-08-29,279828229,299188729,422442,802531,299188729,281116,250422532,14059,6.96621074893144,482553,6553044.81772425,888171856257.321,582.121621621622,998177,16531914.7953025
1182,BTC,2017-08-30,280251645,299592899,404170,804606,299592899,271466,250693998,14105,6.03640904181047,482721,7488447.71623019,888171856257.321,509.407185628743,983372,16534014.7953025
1182,BTC,2017-08-31,280658398,300011025,418126,802342,300011025,280724,250974722,14601,6.37407445081276,482884,7233547.03493017,888171856257.321,527.358024691358,981641,16536052.2953024
1182,BTC,2017-09-01,281036098,300428558,417533,787641,300428558,283670,251258392,16243,6.35400615525019,483058,7826122.14791029,888171856257.321,487.42774566474,971879,16538227.2953025
1182,BTC,2017-09-02,281339034,300781862,353304,700573,300781862,236811,251495203,12493,6.6732788890946,483222,7300159.19417678,888171856257.321,522.546012269939,809001,16540277.2953025
1182,BTC,2017-09-03,281623387,301072910,291048,590837,301072910,195289,251690492,10244,7.29663852682501,483376,6830404.08910073,888171856257.321,558.483660130719,765766,16542202.2953025
1182,BTC,2017-09-04,281995363,301462330,389420,758033,301462330,269280,251959772,16013,8.98972592153268,483551,7723349.96332819,888171856257.321,493.913793103449,927660,16544389.7953024
1182,BTC,2017-09-05,282369825,301872715,410385,789682,301872715,277948,252237720,19678,23.3610245043059,483748,8786564.56896747,888171856257.321,434.147959183674,763565,16546852.2953025
1182,BTC,2017-09-06,282758772,302287074,414359,780740,302287074,276225,252513945,16427,9.1246149661657,483910,7260476.53042943,903315386419.503,534.360248447205,904135,16548877.2953025
1182,BTC,2017-09-07,283177256,302667376,380302,773169,302667376,256374,252770319,14366,8.71036951999797,484086,8131047.20667712,922724699725.963,487.4,810041,16551077.2953025
1182,BTC,2017-09-08,283568965,303068203,400827,831233,303068203,279488,253049807,13791,7.75820677465093,484261,8089136.26385669,922724699725.963,489.925287356322,913187,16553264.7953025
1182,BTC,2017-09-09,283882715,303384455,316252,631540,303384455,217890,253267697,11498,8.48936067942953,484430,7714635.2343926,922724699725.963,513.708333333333,731735,16555377.2953025
1182,BTC,2017-09-10,284154638,303666611,282156,562566,303666611,193240,253460937,10229,8.40002095234072,484568,6317233.14603608,922724699725.963,627.343065693431,784202,16557102.2953025
1182,BTC,2017-09-11,284512275,304037704,371093,740040,304037704,253492,253714429,13879,10.6196862138298,484742,8019692.44337365,922724699725.963,494.167630057803,829352,16559277.2953025
1182,BTC,2017-09-12,284856587,304420020,382316,715977,304420020,256230,253970659,12090,9.48734285885244,484930,8695741.16040996,922724699725.963,455.748663101604,711239,16561627.2953024
1182,BTC,2017-09-13,285207348,304801872,381852,723604,304801872,263320,254233979,12287,10.7519857359913,485120,8764473.68054442,922724699725.963,452.174603174603,713780,16564002.2953025
1182,BTC,2017-09-14,285592761,305191076,389204,778850,305191076,268068,254502047,13268,11.9378108703981,485294,8047555.92084579,922724699725.963,492.456647398844,802350,16566177.2953025
1182,BTC,2017-09-15,285973352,305618360,427284,839597,305618360,292079,254794126,14789,12.1015632249167,485474,8322266.08549581,922724699725.963,476.201117318436,844177,16568427.2953025
1182,BTC,2017-09-16,286286176,305954902,336542,651462,305954902,228257,255022383,11620,9.81633375376549,485643,7755342.62823278,922724699725.963,511.011904761905,701067,16570539.7953025
1182,BTC,2017-09-17,286557274,306249675,294773,592822,306249675,197683,255220066,10889,8.79627928810237,485819,8147572.56048408,922724699725.963,486.411428571428,581463,16572739.7953025
1182,BTC,2017-09-18,286868539,306586076,336401,677054,306586076,218204,255438270,13561,10.6962168166074,485946,6686947.54933319,1052185622755.0,675.809523809524,911992,16574327.2953024
1182,BTC,2017-09-19,287284118,307001793,415717,793721,307001793,282917,255721187,11778,6.79805245139366,486102,8608212.54424971,1103400932964.29,550.529032258064,956767,16576277.2953025
1182,BTC,2017-09-20,287589096,307355806,354013,625106,307355806,235723,255956910,11474,8.22824613663066,486219,6608708.83340433,1103400932964.29,717.094827586207,948245,16577739.7953025
1182,BTC,2017-09-21,287936466,307730776,374970,699463,307730776,255257,256212167,9931,7.57169280114336,486395,9737321.5208823,1103400932964.29,486.691428571429,767394,16579939.7953025
1182,BTC,2017-09-22,288220392,308072445,341669,653300,308072445,227615,256439782,9710,8.2390669757773,486534,7698640.20955089,1103400932964.29,615.572463768116,802007,16581677.2953025
1182,BTC,2017-09-23,288490137,308367289,294844,572873,308367289,203861,256643643,6788,6.44806059231481,486700,9077415.22184872,1103400932964.29,522.072727272727,630479,16583752.2953025
1182,BTC,2017-09-24,288751750,308637494,270205,536331,308637494,185277,256828920,6756,6.04110046102333,486845,7966033.74333038,1103400932964.29,594.909722222222,656781,16585564.7953025
1182,BTC,2017-09-25,289053881,308979222,341728,661983,308979222,226603,257055523,10888,8.80696602163083,486970,7019923.2390096,1103400932964.29,675.08870967742,916413,16587127.2953025
1182,BTC,2017-09-26,289421832,309365957,386735,734006,309365957,263648,257319171,12091,7.94015881440451,487108,7562288.49255342,1103400932964.29,626.671532846715,962231,16588852.2953025
1182,BTC,2017-09-27,289747062,309747098,381141,696320,309747098,257961,257577132,13227,8.40818797933986,487255,8189574.06591386,1103400932964.29,578.671232876712,848984,16590689.7953025
1182,BTC,2017-09-28,290127539,310151437,404339,764653,310151437,275976,257853108,13711,8.34438900833768,487432,9848582.85720303,1103400932964.29,481.193181818182,843941,16592902.2953025
1182,BTC,2017-09-29,290453539,310528798,377361,749352,310528798,254438,258107546,12647,7.70593522637476,487601,9383303.45442921,1103400932964.29,505.053571428572,832814,16595014.7953025
1182,BTC,2017-09-30,290747626,310848280,319482,632166,310848280,212678,258320224,10612,7.80965083299735,487739,7612563.65260451,1103400932964.29,622.532846715329,786213,16596739.7953025
1182,BTC,2017-10-01,291048055,311147214,298934,627850,311147214,203653,258523877,9299,7.06647707178195,487869,7176785.84773981,1103400932964.29,660.333333333333,912847,16598364.7953025
1182,BTC,2017-10-02,291436168,311562077,414863,818801,311562077,295002,258818879,15882,6.87694201853357,488019,8479667.12702736,1123590453770.72,569.10067114094,1001502,16600239.7953025
1182,BTC,2017-10-03,291820442,311974952,412875,789969,311974952,282132,259101011,10762,5.75154637770799,488202,10286112.4027007,1123863285132.97,469.269230769231,875862,16602527.2953025
1182,BTC,2017-10-04,292118571,312322698,347746,642436,312322698,232826,259333837,10226,6.30853401465373,488336,7438217.97600738,1123863285132.97,648.93984962406,837474,16604202.2953025
1182,BTC,2017-10-05,292463492,312715537,392839,731053,312715537,273243,259607080,10341,6.09937574511142,488461,7027456.80267964,1123863285132.97,686.870967741936,1018034,16605764.7953025
1182,BTC,2017-10-06,292845970,313120853,405316,823148,313120853,283699,259890779,10740,4.87498026480996,488620,8899068.34998135,1123863285132.97,542.411392405063,920435,16607752.2953025
1182,BTC,2017-10-07,293154975,313475606,354753,675356,313475606,231226,260122005,7917,4.56490855019976,488778,8916196.25397884,1123863285132.97,541.369426751592,836508,16609727.2953025
1182,BTC,2017-10-08,293493927,313808948,333342,693180,313808948,238385,260360390,9038,5.34266810820928,488960,10287048.6980177,1123863285132.97,469.226519337017,764419,16612002.2953025
1182,BTC,2017-10-09,293892016,314221705,412757,804344,314221705,296946,260657336,14373,8.63463012548042,489121,8982263.36641849,1123863285132.97,537.3875,921536,16614014.7953025
1182,BTC,2017-10-10,294296033,314647178,425473,830235,314647178,303101,260960437,14377,6.44105320583805,489281,9036157.21100339,1123863285132.97,534.182389937107,964272,16616014.7953025
1182,BTC,2017-10-11,294657939,315071724,424546,785188,315071724,292459,261252896,12809,6.08100336012884,489420,7830256.67762229,1123863285132.97,616.449275362319,1016095,16617752.2953025
1182,BTC,2017-10-12,295038638,315499469,427745,787272,315499469,293164,261546060,16226,6.75238012306088,489573,8539705.29741637,1123863285132.97,565.236842105263,977542,16619664.7953025
1182,BTC,2017-10-13,295371047,315950864,451395,822103,315950864,309819,261855879,19325,6.36269364941078,489709,7596897.38975325,1123863285132.97,635.385185185185,1025495,16621364.7953025
1182,BTC,2017-10-14,295738294,316362090,411226,802715,316362090,293140,262149019,15853,5.17975436980702,489850,7874224.81298249,1123863285132.97,613.007142857143,1023221,16623127.2953025
1182,BTC,2017-10-15,296145685,316761592,399502,830841,316761592,283473,262432492,13183,4.67298107271158,490045,11452043.4518793,1182954806243.74,443.654639175258,893767,16625564.7953025
1182,BTC,2017-10-16,296545798,317213811,452219,854172,317213811,314725,262747217,14752,6.11710402328795,490219,10347961.6949504,1196792694098.79,496.734104046243,917763,16627739.7953024
1182,BTC,2017-10-17,296962737,317693367,479556,878772,317693367,334438,263081655,20630,8.45051081859926,490383,9762878.506678,1196792694098.79,526.503067484663,986573,16629789.7953025
1182,BTC,2017-10-18,297336059,318158169,464802,822776,318158169,329579,263411234,19745,6.53668244002455,490534,9201028.92893515,1196792694098.79,558.653333333333,1017521,16631677.2953025
1182,BTC,2017-10-19,297778436,318649319,491150,914723,318649319,356985,263768219,18741,5.35403971449887,490712,10589438.9955486,1196792694098.79,485.406779661017,994041,16633902.2953025
1182,BTC,2017-10-20,298139280,319077522,428203,854048,319077522,312409,264080628,20297,6.16898815674641,490891,10709471.8222464,1196792694098.79,479.966292134831,993012,16636139.7953025
1182,BTC,2017-10-21,298514401,319504348,426826,809071,319504348,312257,264392885,17194,5.00417476546745,491044,9100216.5620271,1196792694098.79,564.842105263158,1040078,16638052.2953025
1182,BTC,2017-10-22,299005561,319891293,386945,909573,319891293,289131,264682016,16305,5.18520841737925,491226,10862505.2201464,1196792694098.79,473.204419889502,1005286,16640327.2953025
1182,BTC,2017-10-23,299428754,320351858,460565,881597,320351858,316096,264998112,26574,9.47439492130619,491397,10217861.6909709,1196792694098.79,503.058823529412,972171,16642464.7953024
1182,BTC,2017-10-24,299885753,320858037,506179,962656,320858037,347220,265345332,22190,7.44782013733276,491564,9911265.86852103,1196792694098.79,518.620481927711,1041011,16644552.2953025
1182,BTC,2017-10-25,300353218,321310369,452332,926100,321310369,315415,265660747,15394,6.2927355400194,491749,11001187.9280379,1196792694098.79,467.239130434783,969675,16646864.7953025
1182,BTC,2017-10-26,300685188,321700682,390313,738100,321700682,265827,265926574,15289,6.56035563537128,491929,11067862.8470536,1233777273050.04,478.776536312849,732356,16649114.7953025
1182,BTC,2017-10-27,300939091,322072880,372198,675820,322072880,246692,266173266,15675,8.12339769793325,492033,7611615.99977779,1452839779145.92,819.78640776699,1031948,16650414.7953025
1182,BTC,2017-10-28,301160346,322378000,305120,557169,322378000,207066,266380332,12629,6.84658906794104,492118,6095210.64692659,1452839779145.92,1023.7380952381,1007806,16651477.2953025
1182,BTC,2017-10-29,301590715,322851143,473143,924869,322851143,334025,266714357,15710,4.96956786198018,492272,11152830.5258898,1452839779145.92,559.490196078431,1018008,16653402.2953025
1182,BTC,2017-10-30,301989862,323332095,480952,895467,323332095,316077,267030434,17135,5.87067147386811,492419,10672617.5104896,1452839779145.92,584.664383561644,1028509,16655239.7953025
1182,BTC,2017-10-31,302378319,323764939,432844,833764,323764939,277535,267307969,19076,6.9061072536466,492557,9997032.10395106,1452839779145.92,624.175182481752,1036997,16656964.7953025
1182,BTC,2017-11-01,302818034,324290156,525217,967634,324290156,351529,267659498,21792,6.23364876143897,492713,11770529.3580715,1452839779145.92,530.129032258064,1043786,16658914.7953025
1182,BTC,2017-11-02,303239793,324809474,519318,922062,324809474,341474,268000972,22645,6.59311738229751,492863,10981715.7592594,1452839779145.92,568.208053691275,1037395,16660789.7953025
1182,BTC,2017-11-03,303531249,325251079,441605,821734,325251079,277598,268278570,18684,10.9400269791361,492982,8653387.88627944,1452839779145.92,721.093220338983,1046605,16662277.2953025
1182,BTC,2017-11-04,303912650,325687544,436465,805930,325687544,294121,268572691,15903,19.6040722867669,493112,9509569.43707898,1452839779145.92,656.170542635659,1028248,16663902.2953025
1182,BTC,2017-11-05,304297626,326069474,381930,808762,326069474,251728,268824419,17054,24.1428252778789,493253,10189492.0018469,1452839779145.92,612.385714285714,1042667,16665664.7953025
1182,BTC,2017-11-06,304663612,326490813,421339,829421,326490813,271029,269095448,16922,10.2669772840983,493386,9960778.22960499,1452839779145.92,626.446969696969,1044553,16667327.2953025
1182,BTC,2017-11-07,305093196,326992805,501992,947186,326992805,335636,269431084,18747,10.4989873430369,493542,11333705.1613337,1452839779145.92,550.56129032258,1026380,16669277.2953025
1182,BTC,2017-11-08,305484602,327449525,456720,866204,327449525,301346,269732430,20472,14.1608759863035,493686,10473193.4095426,1452839779145.92,595.797202797203,1026831,16671077.2953025
1182,BTC,2017-11-09,305913668,327963845,514320,949958,327963845,341281,270073711,20389,6.55708806426273,493839,11000390.8483949,1452839779145.92,567.243421052632,1024794,16672989.7953025
1182,BTC,2017-11-10,306238086,328385951,422106,798478,328385951,271745,270345456,25049,8.58875333109802,493959,8804228.05607047,1423367213139.0,694.361344537815,1050013,16674489.7953025
1182,BTC,2017-11-11,306454821,328687197,301246,580285,328687197,194634,270540090,15049,8.55390306787571,494039,5644788.8054899,1364422081125.15,1038.15189873418,1058251,16675489.7953025
1182,BTC,2017-11-12,306676161,328994541,307344,600267,328994541,185966,270726056,12959,11.2274858153936,494119,5451108.10443492,1364422081125.15,1075.03797468354,1053113,16676489.7953025
1182,BTC,2017-11-13,307063339,329473172,478631,922985,329473172,309299,271035355,19851,14.1421527383474,494259,9469873.07100789,1364422081125.15,618.820143884892,1041787,16678239.7953025
1182,BTC,2017-11-14,307421637,329891168,417996,820592,329891168,271995,271307350,19386,14.1956618207268,494387,8839465.80532503,1364422081125.15,662.952755905512,1027411,16679839.7953025
1182,BTC,2017-11-15,307852277,330380197,489029,954914,330380197,321788,271629138,23901,10.6371246298195,494539,10338135.6248369,1364422081125.15,566.847682119205,1045910,16681739.7953025
1182,BTC,2017-11-16,308263930,330843443,463246,907546,330843443,310396,271939534,26554,12.3003979189511,494691,10411728.3492251,1364422081125.15,562.841059602649,1022789,16683639.7953025
1182,BTC,2017-11-17,308727425,331296374,452931,996197,331296374,306617,272246151,21917,12.4527328657169,494858,11331740.6043133,1364422081125.15,517.144578313253,1034528,16685727.2953025
1182,BTC,2017-11-18,309116098,331710734,414360,853524,331710734,270874,272517025,18785,10.027222610967,494994,9454449.9588934,1364422081125.15,619.82962962963,1047779,16687427.2953025
1182,BTC,2017-11-19,309575442,332109073,398339,912452,332109073,264855,272781880,26273,20.5477141198898,495154,10901261.9938843,1364422081125.15,537.566037735849,1042986,16689427.2953025
1182,BTC,2017-11-20,310040001,332610333,501260,993656,332610333,336204,273118084,29591,12.5644615329749,495329,12163640.1442086,1364422081125.15,481.775862068965,1018682,16691614.7953025
1182,BTC,2017-11-21,310513262,333151300,540967,1002106,333151300,371091,273489175,28063,9.80145980877397,495502,11773826.2707906,1364422081125.15,497.726744186047,1055894,16693777.2953025
1182,BTC,2017-11-22,310916324,333618544,467244,875893,333618544,312033,273801208,31284,11.2416982760177,495650,10007106.9526712,1364422081125.15,585.598639455782,1065519,16695627.2953024
1182,BTC,2017-11-23,311356092,334140854,522310,964629,334140854,352207,274153415,30726,9.67317228362926,495807,10721291.9472035,1364422081125.15,546.589743589744,1056894,16697589.7953025
1182,BTC,2017-11-24,311758023,334601010,460156,917417,334601010,305735,274459150,24490,8.75872520685044,495956,10181477.7865566,1361966821649.32,574.533783783784,1048611,16699452.2953025
1182,BTC,2017-11-25,312218835,335095433,494423,945295,335095433,336689,274795839,32089,8.61304543139384,496112,10415295.5300035,1347001430558.57,555.464516129033,1047860,16701402.2953025
1182,BTC,2017-11-26,312655885,335601682,506249,942272,335601682,329677,275125516,27459,6.21916393218966,496265,10219287.8323181,1347001430558.57,566.118421052632,1042223,16703314.7953025
1182,BTC,2017-11-27,313144206,336195034,593352,1064910,336195034,379256,275504772,28388,6.39775024392112,496435,11419031.0730129,1347001430558.57,506.639053254438,1047396,16705439.7953025
1182,BTC,2017-11-28,313593273,336776947,581913,1030379,336776947,365977,275870749,33859,7.8718928754801,496591,10498211.1201132,1347001430558.57,551.077419354839,1062805,16707389.7953025
1182,BTC,2017-11-29,314083774,337419505,642558,1136365,337419505,398090,276268839,37662,8.19423482731031,496764,11611429.2026565,1347001430558.57,498.244186046512,1064409,16709552.2953018
1182,BTC,2017-11-30,314551084,338012487,592982,1089772,338012487,384386,276653225,32494,7.0184458505726,496931,11331197.3152626,1347001430558.57,510.566265060241,1068302,16711639.7953018
1182,BTC,2017-12-01,315049466,338621474,608987,1149321,338621474,412908,277066133,30954,5.61654875814535,497114,12231703.8489858,1347001430558.57,472.978021978022,1068084,16713927.2953017
1182,BTC,2017-12-02,315512049,339109926,488452,965635,339109926,326354,277392487,31381,6.56584695526165,497275,10800321.269296,1347001430558.57,535.6625,1036298,16715939.7953018
1182,BTC,2017-12-03,315974898,339649758,539832,1032301,339649758,353044,277745531,23273,5.29810478107324,497451,11777260.9909265,1347001430558.57,491.228571428571,1047375,16718139.7953018
1182,BTC,2017-12-04,316486668,340271118,621360,1154127,340271118,400686,278146217,40778,6.52219987546865,497632,12074006.0818172,1347001430558.57,479.155555555555,1068300,16720402.2953018
1182,BTC,2017-12-05,316981702,340908063,636945,1162235,340908063,405709,278551926,49488,7.43385718602774,497810,12117230.2654048,1347001430558.57,477.446327683616,1058658,16722627.2953018
1182,BTC,2017-12-06,317512869,341617732,709669,1243969,341617732,443587,278995513,67807,7.96125896673113,497998,13189188.9915311,1407975304733.45,458.497326203209,1059046,16724977.2953018
1182,BTC,2017-12-07,317942007,342262351,644619,1074279,342262351,374917,279370430,52737,9.1993933546573,498150,12226967.0951357,1590896927258.08,558.834437086092,1045256,16726877.2953018
1182,BTC,2017-12-08,318389472,342922946,660595,1129057,342922946,385092,279755522,35418,6.47228977386809,498306,12305720.0075693,1590896927258.08,555.258064516129,1051352,16728827.2953018
1182,BTC,2017-12-09,318906650,343558385,635439,1192760,343558385,403399,280158921,35061,7.17693872345881,498480,13760032.330093,1590896927258.08,496.572254335261,1051266,16731002.2953017
1182,BTC,2017-12-10,319394266,344086150,527765,1081860,344086150,341420,280500341,30551,5.82178864864249,498644,13005378.3909304,1590896927258.08,525.386503067484,1056458,16733052.2953018
1182,BTC,2017-12-11,319849714,344686987,600837,1157672,344686987,368598,280868939,42505,7.29228799426267,498815,13513711.0447166,1590896927258.08,505.623529411765,1060447,16735189.7953018
1182,BTC,2017-12-12,320276010,345300568,613581,1101611,345300568,372977,281241916,59792,8.85343937326993,498971,12634105.4594104,1590896927258.08,540.825806451613,1061313,16737139.7953018
1182,BTC,2017-12-13,320825320,345986295,685727,1266277,345986295,424579,281666495,74071,7.69597815341776,499157,14718083.2809522,1590896927258.08,464.248648648649,1057064,16739464.7953017
1182,BTC,2017-12-14,321380292,346790223,803928,1289172,346790223,490644,282157139,46769,5.99934503780126,499342,14703581.6246109,1590896927258.08,464.70652173913,1041837,16741777.2953018
1182,BTC,2017-12-15,321886820,347454318,664095,1186295,347454318,405676,282562815,40643,6.79519932044888,499511,13381190.9403853,1590896927258.08,510.630952380952,1057938,16743889.7953009
1182,BTC,2017-12-16,322440253,348037869,583551,1142998,348037869,364222,282927037,40068,6.4688649305979,499682,13559299.9236539,1590896927258.08,503.923529411765,1056583,16746027.2953009
1182,BTC,2017-12-17,322978531,348667415,629546,1182589,348667415,391910,283318947,41159,6.09594793509413,499867,14856479.6917494,1590896927258.08,459.923913043478,1041074,16748339.7953009
1182,BTC,2017-12-18,323508486,349319186,651771,1204506,349319186,394239,283713186,46289,7.62418558273641,500049,15642525.0155664,1718045833483.41,471.723756906077,1042035,16750614.795301
1182,BTC,2017-12-19,323895555,349960062,640876,1054026,349960062,378622,284091808,43037,5.24242576998772,500189,13149169.4715252,1873105475221.61,611.820143884892,1060159,16752364.7953009
1182,BTC,2017-12-20,324285644,350571573,611511,1030900,350571573,370277,284462085,38466,6.01677981103415,500325,12791985.0219638,1873105475221.61,628.903703703704,1072800,16754064.795301
1182,BTC,2017-12-21,324634275,351150773,579200,1006303,351150773,335482,284797567,33960,5.33884509267731,500457,12406533.6249221,1873105475221.61,648.442748091603,1038692,16755714.795301
1182,BTC,2017-12-22,325085171,351768557,617784,1118979,351768557,380648,285178215,30981,4.99595150949652,500612,14474364.0995566,1873105475221.61,555.805194805195,1062319,16757652.295301
1182,BTC,2017-12-23,325477983,352258885,490328,989778,352258885,308211,285486426,27493,5.77925273135203,500751,13093215.0746401,1873105475221.61,614.434782608696,1060037,16759389.795301
1182,BTC,2017-12-24,325941135,352680297,421412,1028472,352680297,279523,285765949,23158,5.10630082294913,500903,14197869.8292836,1873105475221.61,566.629139072848,1064142,16761289.7953009
1182,BTC,2017-12-25,326330538,353030728,350431,884229,353030728,228926,285994875,26051,7.90922436938425,501038,12615653.2466178,1873105475221.61,637.694029850746,1050745,16762977.295301
1182,BTC,2017-12-26,326738105,353425997,395269,917770,353425997,247440,286242315,29875,8.83132032247329,501180,13330528.6320025,1873105475221.61,603.496453900709,1050313,16764752.295301
1182,BTC,2017-12-27,327188094,353937061,511064,1036878,353937061,307642,286549957,30449,7.55288165595858,501336,14593416.3574553,1873105475221.61,551.270967741935,1067594,16766702.295301
1182,BTC,2017-12-28,327630221,354436445,499384,1008308,354436445,305053,286855010,29146,6.77724026368382,501485,13938436.9388358,1873105475221.61,577.175675675676,1083203,16768564.795301
1182,BTC,2017-12-29,328099851,355004038,567593,1100149,355004038,353824,287208834,30354,6.53165884515584,501650,15560052.6973983,1873105475221.61,517.024390243902,1047753,16770627.2953009
1182,BTC,2017-12-30,328515272,355556029,551991,1014272,355556029,344407,287553241,28708,6.51543767654812,501797,13650999.5894233,1873105475221.61,589.328767123288,1036882,16772452.295301
1182,BTC,2017-12-31,328978509,356000123,444094,1011390,356000123,290422,287843663,23855,5.64050087889747,501960,15290769.2419805,1873105475221.61,526.12962962963,1037056,16774489.795301
1182,BTC,2018-01-01,329446920,356379364,379241,971215,356379364,241757,288085420,20176,6.96254846572128,502116,14973621.295306,1922580604980.53,551.464516129032,1043382,16776439.795301
1182,BTC,2018-01-02,329940978,356947768,568404,1147833,356947768,340980,288426400,33245,7.44013899835647,502287,16459371.8131287,1931136454487.72,503.917647058824,1041367,16778577.2953009
1182,BTC,2018-01-03,330370428,357601795,654027,1138158,357601795,395963,288822363,34527,7.11400967357251,502444,15099135.2259525,1931136454487.72,549.314102564102,1065513,16780539.795301
1182,BTC,2018-01-04,330800331,358312642,710847,1261665,358312642,425008,289247371,41084,6.4418210041666,502612,16148365.3977857,1931136454487.72,513.622754491018,1065832,16782639.795301
1182,BTC,2018-01-05,331167393,358908977,596335,1074215,358908977,342707,289590078,37818,8.52398910563531,502755,13780105.5832128,1931136454487.72,601.894366197183,1067635,16784427.2953002
1182,BTC,2018-01-06,331652447,359504397,595420,1178753,359504397,358847,289948925,35141,8.30330220315193,502923,16141214.5245484,1931136454487.72,513.850299401197,1054609,16786527.2953002
1182,BTC,2018-01-07,332102604,360129289,624892,1133382,360129289,368187,290317112,29813,7.48853008013086,503085,15559296.1700485,1931136454487.72,533.068322981366,1047738,16788552.2953002
1182,BTC,2018-01-08,332550935,360712869,583580,1165435,360712869,345672,290662784,31496,7.29282930547907,503251,15955901.9023294,1931136454487.72,519.818181818182,1050648,16790627.2953002
1182,BTC,2018-01-09,332985719,361334492,621623,1156807,361334492,360265,291023049,36391,6.23433230835482,503415,15833199.0856983,1931136454487.72,523.846625766871,1054599,16792677.2953002
1182,BTC,2018-01-10,333432830,361922283,587791,1131299,361922283,347393,291370442,36237,6.22631935805264,503581,16007786.765578,1931136454487.72,518.133333333333,1058194,16794752.2953002
1182,BTC,2018-01-11,334017314,362479068,556785,1230730,362479068,337959,291708401,31985,5.49904124747206,503774,18487331.4050375,1931136454487.72,448.640625,1057117,16797164.7953002
1182,BTC,2018-01-12,334562556,362973858,494790,1158813,362973858,300091,292008492,29852,5.92992031798398,503952,17043800.0946938,1931136454487.72,486.638418079096,1054668,16799389.7953002
1182,BTC,2018-01-13,335002729,363411002,437144,948768,363411002,265735,292274227,23978,5.13706397443788,504101,16018061.0478031,2134254177773.78,572.263513513513,1014637,16801252.2953002
1182,BTC,2018-01-14,335474553,363795011,384009,972468,363795011,235045,292509272,21337,5.39970133067979,504256,17495447.2326264,2227847638503.63,546.915584415584,1050657,16803189.7953002
1182,BTC,2018-01-15,335917193,364248130,453119,959309,364248130,273623,292782895,27660,5.47399220148208,504406,16727222.7825929,2227847638503.63,572.033557046979,1059330,16805064.7953002
1182,BTC,2018-01-16,336360802,364729820,481690,1006185,364729820,303725,293086620,29873,9.51283756395565,504565,17669594.4900052,2227847638503.63,541.525316455696,1050054,16807052.2953002
1182,BTC,2018-01-17,336853810,365236357,506537,1097689,365236357,315771,293402391,25883,7.82062378828277,504732,18596642.5811606,2227847638503.63,514.530120481928,1062211,16809139.7953002
1182,BTC,2018-01-18,337342353,365728005,491648,1060979,365728005,309495,293711886,29821,6.96852679538791,504905,19288457.4582966,2227847638503.63,496.075581395349,1050848,16811302.2953002
1182,BTC,2018-01-19,337900891,366111025,383020,1033373,366111025,243619,293955505,23531,8.01866647984821,505070,18319394.941004,2227847638503.63,522.317073170732,1048356,16813364.7953003
1182,BTC,2018-01-20,338410546,366488633,377608,979236,366488633,240611,294196116,20205,6.06945526007705,505248,19783320.6364795,2227847638503.63,483.666666666667,1106568,16815589.7953002
1182,BTC,2018-01-21,338949543,366816326,327693,991753,366816326,215622,294411738,17386,5.1410573664479,505435,20717378.1935949,2227847638503.63,461.860215053764,1077492,16817927.2953002
1182,BTC,2018-01-22,339448846,367190645,374319,951619,367190645,245562,294657300,21423,6.21241069793001,505602,18803585.0476145,2227847638503.63,508.867469879518,1081038,16820014.7953002
1182,BTC,2018-01-23,339940378,367577815,387170,937619,367577815,271936,294929236,20844,5.66131170444196,505779,19525580.1646457,2227847638503.63,490.051136363636,1070344,16822227.2953002
1182,BTC,2018-01-24,340423016,367964986,387171,953050,367964986,250423,295179659,20942,6.00090133043119,505955,19501918.5315291,2227847638503.63,490.645714285714,1069993,16824427.2953002
1182,BTC,2018-01-25,340837150,368321655,356669,847796,368321655,236580,295416239,20547,5.73797580792235,506113,19675514.1383438,2460585023617.97,537.12101910828,1110326,16826402.2953002
1182,BTC,2018-01-26,341241444,368662632,340977,813618,368662632,220459,295636698,17797,7.72106100857697,506268,20147210.4250441,2603077300218.59,554.922077922077,1042627,16828339.7953002
1182,BTC,2018-01-27,341651218,369054089,391457,876974,369054089,193578,295830276,12672,7.04264465991073,506425,20820606.5830654,2603077300218.59,536.974358974359,1038547,16830302.2953002
1182,BTC,2018-01-28,342004138,369372115,318026,777053,369372115,213446,296043722,13070,14.6590055391964,506583,20357217.2959224,2603077300218.59,549.197452229299,1031008,16832277.2953002
1182,BTC,2018-01-29,342362595,369720270,348155,785522,369720270,232176,296275898,16271,8.36024762552163,506731,19244263.9476075,2603077300218.59,580.959183673469,1018173,16834127.2953002
1182,BTC,2018-01-30,342783555,370078537,358267,845783,370078537,236609,296512507,15796,9.97287197917349,506898,21529934.5829423,2603077300218.59,519.283132530121,987508,16836214.7953002
1182,BTC,2018-01-31,343086207,370395676,317139,681635,370395676,204276,296716783,13443,8.74164603961576,507015,15159678.0478353,2603077300218.59,737.491379310345,1042831,16837677.2953002
1182,BTC,2018-02-01,343468019,370785230,389554,848865,370785230,257664,296974447,15023,8.50182126785542,507175,20771929.6541256,2603077300218.59,538.232704402516,1053963,16839677.2953002
1182,BTC,2018-02-02,343893009,371139450,354220,859632,371139450,235918,297210365,14968,6.19196661380255,507343,21660135.5335631,2603077300218.59,516.161676646707,1022478,16841777.2953002
1182,BTC,2018-02-03,344244253,371422059,282609,722943,371422059,194891,297405256,11632,4.66949463657193,507501,20679312.2621507,2603077300218.59,540.643312101911,996566,16843752.2953002
1182,BTC,2018-02-04,344630837,371674710,252651,727585,371674710,173687,297578943,9911,5.59770451828519,507679,23111856.0836186,2603077300218.59,483.74011299435,990487,16845977.2953002
1182,BTC,2018-02-05,345134709,371987641,312931,910410,371987641,216363,297795306,12984,8.54542003252705,507864,24154241.2519566,2603077300218.59,462.864130434783,1102733,16848289.7952994
1182,BTC,2018-02-06,345634949,372352154,364513,1007028,372352154,244120,298039426,13306,7.84176886904195,508034,22166651.456893,2607870187292.66,505.295857988166,1067524,16850414.7952995
1182,BTC,2018-02-07,346039731,372671149,318995,819765,372671149,213719,298253145,11710,5.42821140127719,508175,20180358.8307124,2874674234415.94,611.814285714286,1071722,16852177.2952994
1182,BTC,2018-02-08,346422466,372931252,260103,750412,372931252,173289,298426434,10564,6.7604380776347,508306,18789358.2254535,2874674234415.94,657.107692307692,1048305,16853814.7952995
1182,BTC,2018-02-09,346774878,373211174,279922,778811,373211174,177860,298604294,10938,6.43293979730299,508441,19374750.1445688,2874674234415.94,637.253731343283,1076192,16855502.2952995
1182,BTC,2018-02-10,347152982,373488209,277035,746239,373488209,181783,298786077,9857,8.46056231847918,508584,20378716.2792076,2874674234415.94,605.859154929577,1034792,16857289.7952995
1182,BTC,2018-02-11,347593147,373717697,229488,821981,373717697,147208,298933285,7898,9.50087667687109,508735,21622570.3555189,2874674234415.94,571.006666666666,1006919,16859177.2952995
1182,BTC,2018-02-12,348107292,374006877,289180,918494,374006877,186918,299120203,10414,8.95976751686189,508901,23820146.9864904,2874674234415.94,518.327272727273,1041291,16861252.2952995
1182,BTC,2018-02-13,348576929,374288637,281760,856261,374288637,182984,299303187,10686,7.19058988430273,509065,24067508.4278173,2874674234415.94,513.0,1032956,16863302.2952995
1182,BTC,2018-02-14,349113147,374586317,297680,941608,374586317,196417,299499604,11546,7.92709887114252,509244,25756515.7698441,2874674234415.94,479.359550561798,1015834,16865539.7952994
1182,BTC,2018-02-15,349508186,374891519,305202,792480,374891519,198183,299697787,11754,7.15890961213641,509375,19244657.1112687,2874674234415.94,641.561538461538,1063894,16867177.2952995
1182,BTC,2018-02-16,349909845,375172728,281209,777060,375172728,187738,299885525,10573,5.87465329048658,509532,23016593.3469727,2874674234415.94,536.423076923077,989634,16869139.7952994
1182,BTC,2018-02-17,350312329,375438148,265420,773685,375438148,173789,300059314,9821,8.48097514619107,509681,21344736.0659931,2874674234415.94,578.439189189189,973017,16871002.2952994
1182,BTC,2018-02-18,350695568,375683163,245015,733485,375683163,159495,300218809,10298,10.2763320522248,509843,23433667.6244441,2874674234415.94,526.875776397516,972766,16873027.2952994
1182,BTC,2018-02-19,351171393,375971211,288048,853281,375971211,187367,300406176,12306,9.5509112660927,510005,23330802.7321125,2874674234415.94,529.198757763976,1006584,16875052.2952994
1182,BTC,2018-02-20,351519313,376280205,308994,718120,376280205,198455,300604631,14671,6.38944788153445,510146,21156067.7102067,2967853337744.77,602.514285714286,1010840,16876814.7952995
1182,BTC,2018-02-21,351838850,376589286,309081,709530,376589286,205201,300809832,13242,6.46099843479247,510315,25329357.4170497,3007383866429.73,509.946428571428,985094,16878927.2952994
1182,BTC,2018-02-22,352093069,376869941,280655,717202,376869941,183235,300993067,11769,8.15824379375736,510464,22434943.1658556,3007383866429.73,575.736486486487,918956,16880789.7952994
1182,BTC,2018-02-23,352435066,377143131,273190,743339,377143131,185193,301178260,11169,5.45545779727992,510612,22212710.0709705,3007383866429.73,581.496598639456,1006292,16882639.7952994
1182,BTC,2018-02-24,352846378,377368331,225200,707478,377368331,154534,301332794,8730,4.82828861969948,510757,21713665.7810887,3007383866429.73,594.861111111112,1027894,16884452.2952994
1182,BTC,2018-02-25,353068316,377588953,220622,531590,377588953,144869,301477663,7053,4.1788327424986,510928,25665349.127843,3007383866429.73,503.270588235294,710161,16886589.7952994
1182,BTC,2018-02-26,353377974,377871633,282680,675606,377871633,186474,301664137,10278,4.53252191589219,511069,21133205.7474374,3007383866429.73,611.2,982314,16888352.2952994
1182,BTC,2018-02-27,353696640,378205390,333757,720090,378205390,219624,301883761,14793,4.30511349379867,511229,23959003.7343012,3007383866429.73,539.11320754717,1016192,16890352.2952995
1182,BTC,2018-02-28,354073511,378480916,275526,809779,378480916,189223,302072984,11966,7.30930158085989,511384,23194211.4053753,3007383866429.73,556.889610389611,1054216,16892289.7952987
1182,BTC,2018-03-01,354486975,378828064,347148,824240,378828064,233744,302306728,12767,5.65845488250924,511549,24705802.4989472,3007383866429.73,522.817073170732,1068240,16894352.2952987
1182,BTC,2018-03-02,354798298,379130998,302934,752596,379130998,195073,302501801,13654,5.00210830183649,511705,23842745.9770064,3007383866429.73,541.741935483871,861064,16896302.2952987
1182,BTC,2018-03-03,355364564,379400579,269581,935002,379400579,177024,302678825,11835,4.46111425215417,511885,27195753.1306723,3007383866429.73,474.949720670391,976833,16898552.2952987
1182,BTC,2018-03-04,355846906,379647393,246814,805403,379647393,160231,302839056,9452,3.89392345818163,512033,22143285.637759,3007383866429.73,583.319727891157,1002853,16900402.2952987
1182,BTC,2018-03-05,356342959,379956180,308787,854266,379956180,201438,303040494,12870,4.48063598215396,512182,23985561.605726,3233581400367.36,579.02027027027,1016060,16902264.7952987
1182,BTC,2018-03-06,356825463,380256519,300339,845625,380256519,206016,303246510,12472,4.56026266847046,512338,25532022.4173626,3290605988755.0,553.541935483871,1022209,16904214.7952987
1182,BTC,2018-03-07,357376476,380563452,306933,928851,380563452,213978,303460488,11703,4.3520396637723,512495,26281813.3067866,3290605988755.0,537.75,1022321,16906177.2952987
1182,BTC,2018-03-08,357954016,380848958,285506,920570,380848958,196422,303656910,10790,5.18433958185493,512657,26523450.1162345,3290605988755.0,532.850931677018,1019423,16908202.2952987
1182,BTC,2018-03-09,358441698,381134791,285833,887960,381134791,198180,303855090,11718,6.09272205037178,512803,24151648.6585903,3290605988755.0,585.179310344827,1031228,16910027.2952987
1182,BTC,2018-03-10,358965135,381364787,229996,814934,381364787,156228,304011318,7980,4.00626051983665,512943,23115220.7948945,3290605988755.0,611.41726618705,1013145,16911777.2952987
1182,BTC,2018-03-11,359566913,381586958,222171,888958,381586958,150884,304162202,7672,5.19654903292496,513096,25454687.0164955,3290605988755.0,555.223684210526,1013150,16913689.7952987
1182,BTC,2018-03-12,360080907,381858289,271331,851084,381858289,188394,304350596,10620,5.41136828704895,513257,26642559.2567413,3290605988755.0,530.46875,947042,16915702.2952987
1182,BTC,2018-03-13,360527663,382133175,274886,771468,382133175,196140,304546736,16206,8.1687239531711,513415,26098731.8316934,3290605988755.0,541.522292993631,892580,16917677.2952987
1182,BTC,2018-03-14,360790626,382413506,280331,579629,382413506,191042,304737778,11330,5.43915251911868,513559,23773413.7547476,3290605988755.0,594.489510489511,744636,16919477.2952987
1182,BTC,2018-03-15,361067614,382712714,299208,622464,382712714,206186,304943964,12486,9.45166834255391,513703,23449035.2499025,3290605988755.0,602.713286713286,770433,16921277.2952987
1182,BTC,2018-03-16,361301826,382987108,274394,598710,382987108,186979,305130943,12686,5.60053630698902,513859,25644404.8018367,3290605988755.0,551.116129032258,683671,16923227.2952987
1182,BTC,2018-03-17,361492689,383213309,226201,464245,383213309,154496,305285439,8668,15.7328074384029,514008,24449634.4361518,3290605988755.0,578.047297297297,515427,16925089.7952987
1182,BTC,2018-03-18,361714178,383454605,241296,539648,383454605,164401,305449840,10410,9.85622940398422,514159,25243525.011991,3381698122496.23,575.366666666667,695280,16926977.2952987
1182,BTC,2018-03-19,361984558,383734440,279835,588000,383734440,191528,305641368,11455,6.96078463563965,514314,26878213.9378447,3462542391191.56,553.292207792208,678044,16928914.7952987
1182,BTC,2018-03-20,362242849,384023575,289135,574335,384023575,195168,305836536,11518,5.7152163340337,514441,21770259.7561211,3462542391191.56,683.111111111111,793882,16930502.2952987
1182,BTC,2018-03-21,362502189,384308717,285142,579292,384308717,194846,306031382,11308,4.78240628935642,514593,26233002.2196723,3462542391191.56,566.900662251656,670269,16932402.2952987
1182,BTC,2018-03-22,362771789,384582761,274044,600305,384582761,185187,306216569,10863,5.95969309358189,514736,25473509.0353167,3462542391191.56,583.802816901409,797819,16934189.7952987
1182,BTC,2018-03-23,363064058,384847397,264636,629230,384847397,179818,306396387,9884,5.45155908773571,514869,22757232.0393687,3462542391191.56,653.484848484848,830547,16935852.2952973
1182,BTC,2018-03-24,363331091,385080830,233433,542035,385080830,157087,306553474,7460,4.99921399886146,515025,26919425.4438697,3462542391191.56,552.445161290323,596551,16937802.2952973
1182,BTC,2018-03-25,363529974,385283925,203095,446626,385283925,135274,306688748,6202,6.02300682317518,515160,23975622.8975818,3462542391191.56,620.276119402985,568772,16939489.7952973
1182,BTC,2018-03-26,363817193,385559481,275556,589103,385559481,187850,306876598,9029,8.93531331119744,515310,25842073.6051364,3462542391191.56,575.476510067114,712413,16941364.7952973
1182,BTC,2018-03-27,364126432,385833519,274038,608149,385833519,187065,307063663,9838,5.7362232159745,515462,26107955.3551643,3462542391191.56,569.615894039735,763199,16943264.7952973
1182,BTC,2018-03-28,364384043,386094611,261092,548051,386094611,177521,307241184,8693,6.56874199237037,515597,23709762.7381445,3462542391191.56,627.231343283582,724552,16944952.2952973
1182,BTC,2018-03-29,364634026,386371131,276520,570132,386371131,192411,307433595,9227,4.39747142869103,515749,26716446.2423518,3462542391191.56,556.64238410596,679723,16946852.2952973
1182,BTC,2018-03-30,364853455,386636832,265701,575601,386636832,185940,307619535,9818,6.88707088001753,515911,28042356.9290975,3462542391191.56,530.32298136646,625428,16948877.2952973
1182,BTC,2018-03-31,365085413,386850896,214064,483684,386850896,148617,307768152,6874,6.04836299531077,516039,22287428.9497538,3462542391191.56,667.259842519685,676326,16950477.2952973
1182,BTC,2018-04-01,365265077,387048801,197905,427489,387048801,135129,307903281,5988,6.21849440420531,516201,28295818.9153203,3494288842679.62,530.391304347826,453174,16952502.2952973
1182,BTC,2018-04-02,365478094,387292071,243270,498636,387292071,168178,308071459,8118,8.65794132945243,516357,27610364.1631059,3511060552899.72,546.167741935484,566611,16954452.2952973
1182,BTC,2018-04-03,365764787,387582306,290235,599016,387582306,198919,308270378,9328,6.61003879927166,516520,28386500.3524838,3511060552899.72,531.234567901235,675785,16956489.7952973
1182,BTC,2018-04-04,366014792,387853656,271350,572121,387853656,185710,308456088,8900,7.64352805436735,516667,25589139.5338286,3511060552899.72,589.308219178082,723346,16958327.2952973
1182,BTC,2018-04-05,366260195,388119441,265785,539742,388119441,181832,308637920,8678,5.73241752561375,516823,27147620.6296461,3511060552899.72,555.477419354839,646244,16960277.2952973
1182,BTC,2018-04-06,366500397,388380983,261542,643506,388380983,172889,308810809,8465,7.25756870096391,516961,24007541.3590333,3511060552899.72,628.131386861314,824647,16962002.2952973
1182,BTC,2018-04-07,366748371,388600698,219715,504278,388600698,154639,308965448,5887,4.81009624972297,517141,31868577.1663548,3511060552899.72,473.189944134078,538825,16964252.2952973
1182,BTC,2018-04-08,366913782,388800772,200074,410502,388800772,138535,309103983,5283,5.28368593206511,517302,28452623.111283,3511060552899.72,530.0,431451,16966264.7952973
1182,BTC,2018-04-09,367176947,389055170,254398,549006,389055170,176563,309280546,8163,6.84910233236222,517449,25710461.8120477,3511060552899.72,586.527397260274,738487,16968102.2952973
1182,BTC,2018-04-10,367432884,389327470,272300,571412,389327470,186415,309466961,8538,5.05405269418561,517613,28544146.7674304,3511060552899.72,528.300613496932,683104,16970152.2952973
1182,BTC,2018-04-11,367688981,389593828,266358,543094,389593828,183248,309650209,8502,5.50348051639887,517774,28303097.3141516,3511060552899.72,532.8,638290,16972164.7952973
1182,BTC,2018-04-12,367989954,389893984,300156,625416,389893984,210879,309861088,11697,10.1316093649284,517928,27147635.0554659,3511060552899.72,555.477124183007,825766,16974089.7952973
1182,BTC,2018-04-13,368262818,390212420,318436,654807,390212420,217282,310078370,12255,5.74065723237309,518093,28927199.5793005,3511060552899.72,521.304878048781,722759,16976152.2952973
1182,BTC,2018-04-14,368473488,390454319,241899,497549,390454319,161843,310240213,7444,4.28247291697837,518230,26354472.9097506,3796188328005.3,618.661764705882,798910,16977864.7952973
1182,BTC,2018-04-15,368763864,390722404,268085,591039,390722404,174031,310414244,7814,4.31574263256592,518393,31258708.4366847,3839316899029.67,527.524691358025,847521,16979902.2952973
1182,BTC,2018-04-16,369183858,391014189,291785,742491,391014189,196106,310610350,9312,6.94449938606131,518534,27159253.1010666,3839316899029.67,607.15,967547,16981664.7952973
1182,BTC,2018-04-17,369465300,391316543,302354,613343,391316543,201820,310812170,9875,5.89790817787286,518696,31145568.0874041,3839316899029.67,529.44099378882,727804,16983689.7952973
1182,BTC,2018-04-18,369728611,391616110,299567,593728,391616110,200740,311012910,9672,5.55792606101534,518856,30831368.4630546,3839316899029.67,534.836477987422,674461,16985689.7952973
1182,BTC,2018-04-19,369998450,391934584,318474,649807,391934584,213523,311226433,11379,6.17120224976209,519034,33960695.7180378,3839316899029.67,485.553672316384,625799,16987914.7952973
1182,BTC,2018-04-20,370252620,392242887,308303,658440,392242887,207777,311434210,11606,7.34050616092209,519171,26060435.4331293,3839316899029.67,632.75,818439,16989627.2952973
1182,BTC,2018-04-21,370562068,392530115,287228,625491,392530115,193975,311628185,9089,4.71858530081284,519330,30658731.4922263,3839316899029.67,537.848101265823,764312,16991614.7952973
1182,BTC,2018-04-22,370772251,392785113,254998,515379,392785113,171870,311800055,7631,4.54110837288241,519490,31578507.5063497,3839316899029.67,522.182389937107,558847,16993614.7952973
1182,BTC,2018-04-23,371048368,393104999,319886,651279,393104999,226353,312026408,10637,4.84714503745513,519643,29260338.0701321,3839316899029.67,563.552631578947,762616,16995527.2952973
1182,BTC,2018-04-24,371410892,393474214,369215,783122,393474214,254493,312280901,14251,6.96122193382973,519802,30628456.2471714,3839316899029.67,538.379746835443,967178,16997514.7952973
1182,BTC,2018-04-25,371737794,393789700,315486,694533,393789700,213155,312494056,12546,9.26830614297652,519925,24284159.5263047,3839316899029.67,679.032786885246,1043031,16999052.2952973
1182,BTC,2018-04-26,372044996,394107706,318006,666593,394107706,216732,312710788,11762,4.92307489235443,520066,27268969.3103363,3839316899029.67,604.707142857143,884706,17000814.7952973
1182,BTC,2018-04-27,372318942,394417098,309392,681912,394417098,211119,312921907,11044,7.27410949910212,520208,27994143.1479651,3943557223451.91,605.035460992908,955995,17002589.7952973
1182,BTC,2018-04-28,372558689,394689800,272702,580639,394689800,203681,313125588,9651,9.00667206631492,520336,26941200.1938215,4022059196164.95,641.196850393701,844274,17004189.7952973
1182,BTC,2018-04-29,372786061,394951987,262187,549012,394951987,180798,313306386,10978,8.93693229792005,520494,31592416.6888349,4022059196164.95,546.796178343949,623489,17006164.7952973
1182,BTC,2018-04-30,373082644,395269127,317140,648401,395269127,215107,313521493,11415,5.65881869271428,520649,31100684.5771014,4022059196164.95,555.441558441558,748396,17008102.2952973
1182,BTC,2018-05-01,373334362,395592634,323507,638057,395592634,199959,313721452,11056,5.1272051709561,520807,31602356.0415569,4022059196164.95,546.624203821656,673271,17010077.2952973
1182,BTC,2018-05-02,373684583,395906523,313889,689284,395906523,212296,313933748,11649,5.07321976082696,520947,28000363.4389194,4022059196164.95,616.942446043165,877978,17011827.2952973
1182,BTC,2018-05-03,373987650,396246888,340365,670349,396246888,228521,314162269,13914,5.9284302964272,521098,30126285.0858109,4022059196164.95,573.406666666667,867924,17013714.7952973
1182,BTC,2018-05-04,374284163,396570234,323346,702444,396570234,219069,314381338,12464,6.11013860326733,521236,27773992.9736454,4022059196164.95,621.970802919708,973819,17015439.7952973
1182,BTC,2018-05-05,374573738,396868956,298722,634526,396868956,202703,314584041,10066,5.2349822938769,521397,32309377.8039502,4022059196164.95,534.6625,726489,17017452.2952973
1182,BTC,2018-05-06,374807445,397115551,246595,539977,397115551,171761,314755802,9382,6.37269998856213,521534,27379755.8279632,4022059196164.95,630.926470588236,758401,17019164.7952973
1182,BTC,2018-05-07,375137369,397416546,300995,667042,397416546,205063,314960865,11543,6.71205120570059,521684,30055433.7837384,4022059196164.95,574.758389261745,867701,17021039.7952973
1182,BTC,2018-05-08,375445208,397733484,316938,675731,397733484,217810,315178675,11746,4.8465840342381,521823,27924943.2339334,4022059196164.95,618.608695652174,915397,17022777.2952965
1182,BTC,2018-05-09,375723791,398041205,307721,617853,398041205,206579,315385254,11133,5.14135996443598,521983,31900482.2348941,4022059196164.95,541.51572327044,732925,17024777.2952965
1182,BTC,2018-05-10,376007072,398351347,310142,623605,398351347,208961,315594215,12628,5.76702080136466,522137,30878516.5390798,4022059196164.95,559.437908496732,733376,17026702.2952966
1182,BTC,2018-05-11,376369159,398658364,307017,765655,398658364,213624,315807839,13236,6.12472627795866,522264,26015765.7286306,4138123233246.03,683.166666666667,1075571,17028289.7952965
1182,BTC,2018-05-12,376626393,398919870,261506,594827,398919870,182054,315989893,8920,5.5128604968974,522429,34124943.2335386,4143878474754.19,521.548780487804,644236,17030352.2952965
1182,BTC,2018-05-13,376847246,399154043,234173,488183,399154043,158794,316148687,7539,5.24022228690618,522577,30987195.5983837,4143878474754.19,574.360544217687,576345,17032202.2952965
1182,BTC,2018-05-14,377150209,399465251,311208,641742,399465251,209697,316358384,11652,6.07998692461318,522709,27178266.2803308,4143878474754.19,654.854961832061,872704,17033852.2952966
1182,BTC,2018-05-15,377456780,399784460,319209,645896,399784460,214779,316573163,11184,4.9677999023121,522855,30001677.1665442,4143878474754.19,593.227586206896,791380,17035677.2952965
1182,BTC,2018-05-16,377736479,400084298,299838,611010,400084298,208463,316781626,10640,5.52831174663955,523034,37395679.7998587,4143878474754.19,475.932584269663,606597,17037914.7952965
1182,BTC,2018-05-17,378051773,400362720,278422,635087,400362720,192683,316974309,10656,5.45723904072674,523166,27361664.0002401,4143878474754.19,650.465648854962,860254,17039564.7952965
1182,BTC,2018-05-18,378381790,400667340,304620,710771,400667340,211496,317185805,10773,5.31006739063089,523314,30665399.7628507,4143878474754.19,580.387755102041,839280,17041414.7952965
1182,BTC,2018-05-19,378621160,400916210,248870,520662,400916210,173274,317359079,7706,4.33560968323228,523468,31701905.17292,4143878474754.19,561.411764705883,580258,17043339.7952965
1182,BTC,2018-05-20,378815561,401152400,236190,480119,401152400,158663,317517742,7359,4.61920223131215,523612,29913361.4801775,4143878474754.19,594.979020979021,555049,17045139.7952966
1182,BTC,2018-05-21,379122386,401448036,295636,628005,401448036,202647,317720389,9839,4.12815780558824,523769,32327274.6933859,4143878474754.19,550.551282051282,755369,17047102.2952965
1182,BTC,2018-05-22,379399059,401744688,296652,593732,401744688,203337,317923726,9640,4.5539677420198,523920,31265571.7984019,4143878474754.19,569.246666666667,697712,17048989.7952965
1182,BTC,2018-05-23,379703420,402059780,315092,648114,402059780,223196,318146922,10550,4.83254250055848,524082,33577649.1944325,4143878474754.19,530.049689440994,748044,17051014.7952965
1182,BTC,2018-05-24,379955318,402354386,294606,576660,402354386,206825,318353747,10381,5.78266768618358,524225,30327447.7213184,4219142059012.95,597.514084507042,726173,17052802.2952965
1182,BTC,2018-05-25,380223864,402637252,282866,624360,402637252,196181,318549928,9113,4.8609940817464,524401,37805231.0460369,4306949573981.51,489.302857142857,625061,17055002.2952965
1182,BTC,2018-05-26,380421843,402866018,228766,472333,402866018,158783,318708711,6064,3.83223853962446,524563,34798287.2943769,4306949573981.51,531.583850931677,488469,17057027.2952965
1182,BTC,2018-05-27,380602671,403076683,210665,447062,403076683,144304,318853015,5638,5.56938734462919,524727,35054034.5194009,4306949573981.51,527.705521472393,448727,17059077.2952958
1182,BTC,2018-05-28,380896515,403340693,264010,597039,403340693,189063,319042078,9346,6.95488299156086,524883,34138067.7552372,4306949573981.51,541.864516129032,710101,17061027.2952958
1182,BTC,2018-05-29,381185526,403632174,291481,610910,403632174,204769,319246847,10080,6.25247107876905,525022,29724300.4165822,4306949573981.51,622.326086956522,832153,17062764.7952958
1182,BTC,2018-05-30,381466062,403930728,298554,598661,403930728,204077,319450924,9787,6.22351187532186,525196,38138361.4453404,4306949573981.51,485.028901734104,625990,17064939.7952958
1182,BTC,2018-05-31,381776774,404237979,307251,633570,404237979,209526,319660450,9083,6.57342046967818,525366,36742478.9456939,4306949573981.51,503.455621301775,706883,17067064.7952958
1182,BTC,2018-06-01,382008798,404540515,302536,697999,404540515,205481,319865931,9558,5.8888790702026,525532,35829881.0644042,4306949573981.51,516.278787878788,721915,17069139.7952959
1182,BTC,2018-06-02,382248421,404793270,252755,528261,404793270,174497,320040428,7097,5.4005036446034,525684,32472991.8787162,4306949573981.51,569.649006622516,622946,17071039.7952958
1182,BTC,2018-06-03,382471192,405028689,235419,536366,405028689,163443,320203871,6495,5.72535262536499,525847,35167282.2885595,4306949573981.51,526.006172839506,771284,17073077.2952958
1182,BTC,2018-06-04,382815641,405328967,300278,708308,405328967,209916,320413787,9140,7.12119943775572,526030,39230849.0971539,4306949573981.51,471.521978021978,1055892,17075364.7952958
1182,BTC,2018-06-05,383117612,405637192,308225,661376,405637192,212901,320626688,8638,5.78211798592012,526205,38431923.4724746,4415593341674.14,493.465517241379,848479,17077552.2952958
1182,BTC,2018-06-06,383410823,405938947,301755,657356,405938947,206417,320833105,8080,5.51578519034387,526352,36135861.5023506,4940704885521.83,587.232876712329,991682,17079389.7952951
1182,BTC,2018-06-07,383693198,406231942,292995,641565,406231942,207627,321040732,8579,5.80788738201583,526495,35156909.5212349,4940704885521.83,603.584507042253,1082513,17081177.295295
1182,BTC,2018-06-08,383960248,406521569,289627,655501,406521569,200379,321241111,8615,7.18944669214918,526640,35903416.6769734,4940704885521.83,591.034722222222,897163,17082983.5452951
1182,BTC,2018-06-09,384188022,406764421,242852,498294,406764421,171306,321412417,6331,5.10453378741305,526783,35339981.9170295,4940704885521.83,600.457746478873,630925,17084771.0452944
1182,BTC,2018-06-10,384431039,407010919,246498,537058,407010919,179809,321592226,7970,7.80753912175564,526910,31355070.2299141,4940704885521.83,676.769841269841,759267,17086358.5452943
1182,BTC,2018-06-11,384708261,407304548,293629,596633,407304548,213196,321805422,9304,7.91781651376198,527050,34756823.3932882,4940704885521.83,610.532374100719,793075,17088108.5452936
1182,BTC,2018-06-12,385019178,407606728,302180,662459,407606728,214595,322020017,8748,6.56683265865924,527195,35730868.685226,4940704885521.83,593.888888888889,1044931,17089921.0452936
1182,BTC,2018-06-13,385331701,407901930,295202,668119,407901930,211829,322231846,9597,8.86729515300285,527338,35353250.0106241,4940704885521.83,600.232394366197,913050,17091708.5452928
1182,BTC,2018-06-14,385609296,408196922,294992,592409,408196922,210029,322441875,9273,8.79053822528356,527491,37799011.1233835,4940704885521.83,561.394736842105,743882,17093621.0452921
1182,BTC,2018-06-15,385890133,408486737,289815,637867,408486737,205861,322647736,8361,8.39761518537756,527644,37939954.3278311,4940704885521.83,559.309210526315,801346,17095533.5452906
1182,BTC,2018-06-16,386079605,408712262,225525,448709,408712262,159090,322806826,4893,5.15708302100792,527810,41090086.6544591,4940704885521.83,516.430303030302,473838,17097608.5452906
1182,BTC,2018-06-17,386268332,408919396,207134,442321,408919396,144908,322951734,4707,4.61825660220064,527967,39194708.4477743,4940704885521.83,541.403846153846,490980,17099571.0452899
1182,BTC,2018-06-18,386546230,409204486,285090,581840,409204486,196305,323148039,7079,5.40468041425165,528131,40511677.7009616,4940704885521.83,523.803680981595,648707,17101621.0452899
1182,BTC,2018-06-19,386868338,409480981,276495,630701,409480981,191805,323339844,7765,7.67828920680889,528286,38614092.2077194,5024546460934.29,558.87012987013,908624,17103558.5452891
1182,BTC,2018-06-20,387147774,409769842,288861,593528,409769842,198889,323538733,7319,5.82472444427183,528441,39662993.0939337,5077499034879.02,549.824675324675,1078000,17105496.0452883
1182,BTC,2018-06-21,387410208,410051504,281662,572851,410051504,198113,323736846,7615,4.66617043109377,528611,42953544.1918231,5077499034879.02,507.704142011835,616743,17107621.0452876
1182,BTC,2018-06-22,387689177,410336377,284873,628367,410336377,204144,323940990,8579,9.14391932201353,528762,38260899.2823236,5077499034879.02,569.973333333333,795271,17109508.5452876
1182,BTC,2018-06-23,387899064,410571635,235258,490606,410571635,163295,324104285,5685,8.76218803230975,528922,41106102.6370613,5077499034879.02,530.522012578617,534422,17111508.5452876
1182,BTC,2018-06-24,388102183,410791211,219576,465351,410791211,158022,324262307,5764,5.69767339405868,529093,43680648.6285047,5077499034879.02,499.25294117647,484736,17113646.0452869
1182,BTC,2018-06-25,388391787,411069193,277982,622576,411069193,200173,324462480,7712,6.46327328101617,529250,40021175.2113782,5077499034879.02,544.903846153846,920947,17115608.5452869
1182,BTC,2018-06-26,388652203,411343658,274465,620530,411343658,195404,324657884,7412,4.50026533437284,529396,36798735.9890627,5077499034879.02,592.620689655173,1067591,17117433.5452869
1182,BTC,2018-06-27,388919685,411610819,267161,596895,411610819,188510,324846394,6745,5.2610314331036,529517,30346062.8511669,5077499034879.02,718.633333333334,1088043,17118946.0452869
1182,BTC,2018-06-28,389192414,411875016,264197,562176,411875016,187624,325034018,6454,4.86511307544925,529674,40449919.1339675,5077499034879.02,539.128205128205,689429,17120908.5452869
1182,BTC,2018-06-29,389437390,412153335,278319,597323,412153335,197881,325231899,7037,5.46275035108651,529825,38475562.462997,5077499034879.02,566.793333333333,746513,17122796.0452869
1182,BTC,2018-06-30,389703504,412399764,246429,575034,412399764,181065,325412964,5771,4.07710420506973,529966,36097340.0257602,5077499034879.02,604.135714285715,987340,17124558.5452861
1182,BTC,2018-07-01,389905772,412616262,216498,491879,412616262,156247,325569211,4599,5.49664508002854,530113,37208403.3638008,5077499034879.02,586.095890410959,705291,17126396.0452853
1182,BTC,2018-07-02,390191735,412895966,279704,647264,412895966,199294,325768505,7131,5.00750925252973,530254,36872734.3838123,5172892177079.79,602.542857142857,987550,17128158.5452853
1182,BTC,2018-07-03,390518678,413203622,307656,667943,413203622,216747,325985252,8018,4.90259532816551,530370,31720903.6664036,5363678461481.36,726.234782608696,1113817,17129608.5452846
1182,BTC,2018-07-04,390790510,413496047,292425,619779,413496047,206788,326192040,7770,4.30356210506625,530504,35771047.5513622,5363678461481.36,644.007518796993,935352,17131283.5452301
1182,BTC,2018-07-05,391046758,413773736,277689,554487,413773736,199600,326391640,8183,5.17288385641067,530641,36581757.1184414,5363678461481.36,629.735294117647,783748,17132996.0452294
1182,BTC,2018-07-06,391255514,414060804,287068,655859,414060804,200993,326592633,8014,4.81747846699084,530801,43156892.6390395,5363678461481.36,533.792452830189,685458,17134996.0451756
1182,BTC,2018-07-07,391473705,414295170,234366,482580,414295170,170160,326762793,6241,3.5889473088502,530957,41829197.9597947,5363678461481.36,550.735483870968,537210,17136946.0451756
1182,BTC,2018-07-08,391694379,414520818,225648,499531,414520818,155685,326918478,5391,4.82406085159964,531115,42354540.7913594,5363678461481.36,543.904458598726,592209,17138921.0451756
1182,BTC,2018-07-09,391975365,414810101,289283,636033,414810101,206546,327125024,7935,5.07732939758625,531251,36717053.9081413,5363678461481.36,627.414814814814,1060415,17140621.0451748
1182,BTC,2018-07-10,392302721,415110127,300026,674996,415110127,216063,327341087,8728,5.43364661359372,531400,39647532.2649447,5363678461481.36,581.040540540541,971490,17142483.5451208
1182,BTC,2018-07-11,392596385,415391827,281700,625249,415391827,202603,327543690,7667,4.16836702697833,531535,35980772.0760794,5363678461481.36,640.253731343283,1006592,17144171.0451208
1182,BTC,2018-07-12,393266414,415667383,275556,952133,415667383,203535,327747225,7394,4.03415149648989,531676,38594108.8596449,5363678461481.36,596.9,1179159,17145933.5451208
1182,BTC,2018-07-13,393858686,415960297,292914,940736,415960297,207904,327955129,6959,4.26258820532284,531819,38845163.9685761,5363678461481.36,593.042253521127,1113532,17147721.0451208
1182,BTC,2018-07-14,394395044,416201847,241550,816904,416201847,176475,328131604,5837,4.19501977426718,531952,35367070.3923995,5363678461481.36,651.363636363636,1159489,17149383.5451208
1182,BTC,2018-07-15,394656762,416424920,223073,515490,416424920,161151,328292755,6025,4.63857269665624,532085,36112590.8477941,5363678461481.36,637.916666666667,773946,17151046.0451208
1182,BTC,2018-07-16,394942596,416716466,291546,591036,416716466,207842,328500597,8717,5.84787327253024,532205,32265598.0346777,5363678461481.36,713.974789915966,928807,17152546.0451208
1182,BTC,2018-07-17,395295185,417049999,333533,696983,417049999,233966,328734563,10196,4.54147358883222,532364,41285720.1496579,5199615302175.17,540.917721518987,909335,17154533.5451208
1182,BTC,2018-07-18,395661658,417386326,336327,780118,417386326,238769,328973332,11019,4.76408897257144,532538,44850508.8696687,5178671069072.25,495.919075144508,1046474,17156708.5451193
1182,BTC,2018-07-19,395978663,417702108,315782,645071,417702108,225039,329198371,9282,4.29162055288586,532709,43942658.6245948,5178671069072.25,506.164705882353,734628,17158846.0451186
1182,BTC,2018-07-20,396275269,418014409,312301,659346,418014409,225529,329423900,9016,4.05319885504077,532863,39708522.6589681,5178671069072.25,560.137254901961,815292,17160771.0451187
1182,BTC,2018-07-21,396520843,418269553,255144,511231,418269553,184803,329608703,6283,3.47404298508617,533000,35555765.5680017,5178671069072.25,625.558823529412,715741,17162483.5451186
1182,BTC,2018-07-22,396721210,418508967,239414,463902,418508967,167129,329775832,5421,3.48885094002974,533182,47881093.4941913,5178671069072.25,464.530386740331,451292,17164758.5451186
1182,BTC,2018-07-23,397094744,418830649,321682,717809,418830649,229480,330005312,9743,4.23321381616799,533348,42636353.62862,5178671069072.25,521.672727272728,890057,17166833.5451186
1182,BTC,2018-07-24,397421926,419197380,366731,728369,419197380,259358,330264670,12643,4.56720222465172,533507,41189784.3948974,5178671069072.25,539.993670886076,917435,17168821.0451179
1182,BTC,2018-07-25,397775508,419553818,356438,785007,419553818,250208,330514878,10786,3.98462086372302,533684,45776594.1648297,5178671069072.25,485.886363636364,965074,17171033.5451171
1182,BTC,2018-07-26,398068181,419880112,326294,648173,419880112,231679,330746557,9125,3.80171790948666,533849,42296381.7172456,5178671069072.25,525.865853658537,771370,17173096.0451172
1182,BTC,2018-07-27,398348414,420205461,325349,726245,420205461,229397,330975954,9358,4.25398122231751,534016,43188277.1030343,5178671069072.25,515.006024096386,886276,17175183.5451156
1182,BTC,2018-07-28,398628582,420470022,264561,570157,420470022,188238,331164192,6552,3.49881784965915,534161,37403714.7552325,5178671069072.25,594.652777777778,759045,17176996.0451149
1182,BTC,2018-07-29,398841568,420719113,249091,490273,420719113,168407,331332599,5758,3.9250347328095,534331,47467539.557984,5595791656327.72,506.319526627219,539320,17179121.0450063
1182,BTC,2018-07-30,399155624,421041840,322727,643271,421041840,230924,331563523,9022,3.78837263479799,534465,40336854.2260596,5949437371609.53,633.481203007519,911087,17180796.0450063
1182,BTC,2018-07-31,399498604,421382913,341073,697539,421382913,242977,331806500,8873,3.58858798740259,534612,43606714.9642539,5949437371609.53,585.979452054795,950214,17182633.5450056
1182,BTC,2018-08-01,399818045,421718470,335557,713287,421718470,241044,332047544,8663,3.75724662267279,534762,44536059.6352608,5949437371609.53,573.751677852349,990541,17184508.545004
1182,BTC,2018-08-02,400139300,422034788,316318,640776,422034788,224873,332272417,8240,4.09541039384244,534915,45239605.8306054,5949437371609.53,564.828947368421,806938,17186421.0450025
1182,BTC,2018-08-03,400422674,422349121,314333,696718,422349121,229859,332502276,8262,4.27587402525753,535081,49493296.221365,5949437371609.53,516.284848484848,834025,17188496.0450025
1182,BTC,2018-08-04,400670573,422620223,271102,548835,422620223,191657,332693933,5772,5.0412373107802,535257,53543175.1354956,5949437371609.53,477.234285714286,574082,17190696.0450025
1182,BTC,2018-08-05,400893532,422856621,236398,501318,422856621,172181,332866114,6044,5.9373398369539,535417,47594648.6992812,5949437371609.53,536.880503144654,578105,17192696.0450025
1182,BTC,2018-08-06,401205477,423161074,304453,660988,423161074,218607,333084721,7355,5.7615093736497,535548,38739598.1513995,5949437371609.53,659.6,1050986,17194333.5450017
1182,BTC,2018-08-07,401542512,423486252,325178,713514,423486252,233045,333317766,8043,4.88466284636002,535699,45641666.1637509,5949437371609.53,559.853333333333,1016458,17196221.0450017
1182,BTC,2018-08-08,401851818,423814961,328709,657844,423814961,235311,333553077,8780,5.64202850414647,535856,46837647.6052904,5949437371609.53,545.557692307692,812957,17198183.5450002
1182,BTC,2018-08-09,402170532,424123354,308393,636348,424123354,222326,333775403,7258,5.02864931606389,536005,44031139.7643254,5949437371609.53,580.331081081081,804355,17200046.0450002
1182,BTC,2018-08-10,402481173,424436559,313205,664519,424436559,226148,334001551,7570,4.30667545071701,536181,51948928.4798389,5949437371609.53,491.88,792378,17202246.0449995
1182,BTC,2018-08-11,402745207,424695436,258877,531739,424695436,192438,334193989,6570,4.16036470033673,536351,53071972.718561,6197839919507.38,501.573964497041,611510,17204371.0449995
1182,BTC,2018-08-12,402962971,424922797,227361,483751,424922797,165044,334359033,4632,3.67318782400972,536506,49479032.9934498,6389316883511.96,554.616883116883,584546,17206308.5449988
1182,BTC,2018-08-13,403270979,425231632,308835,618980,425231632,222229,334581262,7991,4.14325922504979,536656,47939925.1000834,6389316883511.96,572.422818791946,906496,17208183.544998
1182,BTC,2018-08-14,403592232,425576990,345358,665106,425576990,247622,334828884,10106,4.73017896082493,536792,43277697.4006765,6389316883511.96,634.088888888889,1011792,17209883.544998
1182,BTC,2018-08-15,403912565,425925851,348861,690139,425925851,246066,335074950,8430,4.28240275454732,536953,52430086.0880102,6389316883511.96,523.4,791067,17211896.0449972
1182,BTC,2018-08-16,404211901,426247878,322027,627176,426247878,232335,335307285,7998,3.92183181009697,537111,50159259.1820026,6389316883511.96,547.095541401274,761947,17213871.0449972
1182,BTC,2018-08-17,404524341,426572850,324972,659137,426572850,233794,335541079,7803,3.68629437723941,537263,48222133.8976858,6389316883511.96,569.072847682119,833029,17215771.0449972
1182,BTC,2018-08-18,404760266,426838193,265343,508161,426838193,190935,335732014,5402,3.49247384242653,537423,52415347.9205211,6389316883511.96,523.547169811321,590060,17217771.0449972
1182,BTC,2018-08-19,404996823,427085992,247799,518565,427085992,167400,335899414,4607,3.57832808930119,537568,46547318.645608,6389316883511.96,589.548611111111,619528,17219583.5449957
1182,BTC,2018-08-20,405324306,427403413,317421,629941,427403413,214983,336114397,7480,3.99925329127661,537718,47837285.6273395,6389316883511.96,573.65100671141,818181,17221458.5449957
1182,BTC,2018-08-21,405613477,427709633,306220,595311,427709633,217777,336332174,7751,4.78218513370581,537866,47605092.6100956,6389316883511.96,576.448979591837,779786,17223308.544995
1182,BTC,2018-08-22,405924917,428037144,327511,644814,428037144,230333,336562507,7711,3.93494972169411,538026,51519798.1166341,6389316883511.96,532.647798742139,774898,17225308.5449935
1182,BTC,2018-08-23,406195851,428338587,301443,575309,428338587,217352,336779859,6659,4.0316952601959,538175,47112756.0106344,6389316883511.96,582.472972972973,768391,17227171.0449927
1182,BTC,2018-08-24,406495395,428645545,306958,637445,428645545,219848,336999707,7218,3.44782610327881,538321,48436074.284763,6505039002077.23,576.820689655172,820710,17228996.0449928
1182,BTC,2018-08-25,406767150,428919802,274257,553307,428919802,196420,337196127,5682,3.36098876732369,538456,45123021.265306,6727225469722.53,640.320895522388,763551,17230683.5449928
1182,BTC,2018-08-26,407016603,429155667,235865,506696,429155667,172747,337368874,4491,2.9841809810289,538629,58205370.0737583,6727225469722.53,496.401162790698,569715,17232846.0449913
1182,BTC,2018-08-27,407371985,429468406,312739,670286,429468406,223656,337592530,7893,4.35672538839347,538814,61659587.141078,6727225469722.53,468.592391304348,701549,17235158.5449906
1182,BTC,2018-08-28,407722700,429799135,330729,669852,429799135,238039,337830569,9394,7.97353595654313,538967,51912156.4369035,6727225469722.53,556.578947368421,879880,17237071.0449906
1182,BTC,2018-08-29,408054597,430141185,342050,677005,430141185,237508,338068077,8610,3.79494994146126,539106,46386721.8163519,6727225469722.53,622.876811594203,907886,17238808.5449906
1182,BTC,2018-08-30,408376655,430458477,317292,627437,430458477,231391,338299468,8410,3.6933653359727,539260,51382728.3160995,6727225469722.53,562.313725490196,817750,17240733.5449898
1182,BTC,2018-08-31,408690969,430787842,329365,657088,430787842,237076,338536544,9195,6.51136566517433,539415,52172772.0153906,6727225469722.53,553.798701298701,809181,17242671.0449883
1182,BTC,2018-09-01,408972794,431078441,290599,572708,431078441,213331,338749875,6995,4.13398096101621,539566,51243033.067991,6727225469722.53,563.846666666667,769296,17244558.5449883
1182,BTC,2018-09-02,409197510,431334430,255989,501961,431334430,187145,338937020,6320,4.42240048142339,539710,48254902.468899,6727225469722.53,598.762237762238,648996,17246358.5449875
1182,BTC,2018-09-03,409512531,431642580,308150,619115,431642580,222897,339159917,7852,4.14810713432626,539854,48084182.0858932,6727225469722.53,600.888111888112,846752,17248158.5449868
1182,BTC,2018-09-04,409831730,431966591,324011,635288,431966591,232265,339392182,8668,4.03344570488171,539980,43048125.9762994,6727225469722.53,671.184,957670,17249733.5449868
1182,BTC,2018-09-05,410171429,432306657,340066,671171,432306657,246477,339638659,9246,3.90710076728482,540112,44771305.6797439,6727225469722.53,645.351145038168,1008443,17251383.5449837
1182,BTC,2018-09-06,410515435,432646218,339561,674168,432646218,252261,339890920,10015,5.04619065733482,540262,50193410.2180973,6727225469722.53,575.637583892617,888037,17253258.5449829
1182,BTC,2018-09-07,410815030,432964308,318090,695708,432964308,230790,340121710,8289,4.70578539002023,540414,52693944.1187686,6971177230937.92,568.205298013245,889911,17255158.5449829
1182,BTC,2018-09-08,411089071,433243324,279016,551231,433243324,204428,340326138,5647,3.51645771227777,540564,52458745.2721088,7019199231177.17,574.684563758389,710539,17257033.5449829
1182,BTC,2018-09-09,411333561,433497811,254487,512601,433497811,188912,340515050,5897,3.81165100958139,540727,56750696.5651807,7019199231177.17,531.222222222222,616029,17259071.0449829
1182,BTC,2018-09-10,411642410,433802833,305022,619760,433802833,222866,340737916,7713,3.86506279064694,540862,47998870.9175043,7019199231177.17,628.082089552239,899061,17260758.5449829
1182,BTC,2018-09-11,411982577,434128009,325176,657659,434128009,237571,340975487,8674,3.88284227887086,541003,49203902.631001,7019199231177.17,612.7,941821,17262521.0449829
1182,BTC,2018-09-12,412288169,434444355,316346,606273,434444355,233275,341208762,7735,3.75742886539852,541171,58648101.2151855,7019199231177.17,514.035928143713,709051,17264621.0449822
1182,BTC,2018-09-13,412604112,434764248,319893,614272,434764248,234209,341442971,8345,4.78619659476216,541319,51522943.9488926,7019199231177.17,585.122448979592,819058,17266471.0449814
1182,BTC,2018-09-14,412890979,435066043,301795,626748,435066043,223250,341666221,7271,3.40574473954146,541451,46559155.8846525,7019199231177.17,647.503816793893,1057485,17268121.0449814
1182,BTC,2018-09-15,413165785,435353511,287468,563724,435353511,211071,341877292,6293,3.41549048578639,541591,48920884.5494874,7019199231177.17,616.244604316547,789859,17269871.0449814
1182,BTC,2018-09-16,413385590,435600714,247203,476502,435600714,179483,342056775,5599,3.83781230639632,541730,49952787.3878607,7019199231177.17,603.514492753623,627328,17271608.5449806
1182,BTC,2018-09-17,413706331,435941416,340702,640997,435941416,240152,342296927,9272,4.4965103897923,541865,46895615.1170718,7019199231177.17,642.858208955224,907647,17273296.0449807
1182,BTC,2018-09-18,414054488,436287828,346412,648567,436287828,244259,342541186,8948,4.21081325439407,542007,49708928.3620504,7019199231177.17,606.475177304965,936313,17275071.0449807
1182,BTC,2018-09-19,414400445,436639176,351348,646913,436639176,251037,342792223,8329,3.73113442897923,542163,54352189.955128,7019199231177.17,554.664516129032,804437,17277021.0449807
1182,BTC,2018-09-20,414740250,436997195,358019,641789,436997195,253674,343045897,8525,3.58266324071931,542317,53968948.9774076,7031329605788.92,559.568627450981,815061,17278946.0449807
1182,BTC,2018-09-21,415104173,437376800,379605,727401,437376800,273051,343318948,11053,4.33598463775972,542461,52032580.0056914,7152633351906.41,590.405594405595,1012301,17280746.0449799
1182,BTC,2018-09-22,415398513,437693543,316743,573260,437693543,225537,343544485,7266,3.32165107973703,542616,55031293.6710684,7152633351906.41,558.233766233766,732038,17282683.5449792
1182,BTC,2018-09-23,415644260,437970640,277097,517479,437970640,200319,343744804,5493,2.62857306463466,542766,53817368.2607412,7152633351906.41,570.825503355705,655633,17284558.5449792
1182,BTC,2018-09-24,415955233,438300623,329983,625278,438300623,237670,343982474,7590,3.3173188173005,542914,54079252.3804249,7152633351906.41,568.061224489796,807114,17286408.5449792
1182,BTC,2018-09-25,416294864,438646584,345961,659797,438646584,252113,344234587,8100,5.42110589107051,543083,60424230.771527,7152633351906.41,508.410714285714,768240,17288521.0449792
1182,BTC,2018-09-26,416622478,438979334,332750,638491,438979334,243927,344478514,8120,4.38614048331251,543222,49588904.4821903,7152633351906.41,619.5,898005,17290258.5449792
1182,BTC,2018-09-27,416954714,439318493,339159,645101,439318493,248686,344727200,8411,3.64677037823734,543365,51275772.417206,7152633351906.41,599.119718309859,877031,17292046.0449792
1182,BTC,2018-09-28,417277679,439670868,352375,684920,439670868,254239,344981439,9725,4.24161475554647,543519,55159014.3170878,7152633351906.41,556.941176470588,855168,17293971.0449792
1182,BTC,2018-09-29,417550336,439970577,299709,563086,439970577,218339,345199778,7123,3.4519310200589,543671,54842160.1642657,7152633351906.41,560.158940397351,693383,17295871.0449792
1182,BTC,2018-09-30,417806181,440253336,282759,543253,440253336,208210,345407988,6482,3.07990014512776,543834,59209690.0124701,7152633351906.41,518.83950617284,626711,17297908.5449792
1182,BTC,2018-10-01,418168720,440589134,335798,682978,440589134,242820,345650808,8302,3.39172187239581,543992,56450698.5486084,7152633351906.41,544.197452229299,857105,17299883.5449792
1182,BTC,2018-10-02,418536221,440929945,340811,686740,440929945,244772,345895580,8967,5.1195402766968,544129,49049230.2144132,7152633351906.41,626.316176470588,1015335,17301596.0449792
1182,BTC,2018-10-03,418843881,441344395,414450,703346,441344395,242303,346137883,8492,3.2652011440692,544274,51557387.8353329,7152633351906.41,595.847222222222,838225,17303408.5449792
1182,BTC,2018-10-04,419149616,441708556,364161,652955,441708556,243157,346381040,8326,3.47087063965051,544424,54702265.5115077,7364268059356.19,578.208053691275,798640,17305283.5449792
1182,BTC,2018-10-05,419456651,442058221,349665,697142,442058221,244719,346625759,8071,3.02078887348747,544554,48590450.0120284,7454968648263.24,658.953488372093,963110,17306908.5449792
1182,BTC,2018-10-06,419756368,442371320,313099,597479,442371320,214843,346840602,5811,2.86072066281056,544679,46334266.5988341,7454968648263.24,691.040322580645,922101,17308471.0449792
1182,BTC,2018-10-07,420099108,442695080,323760,607630,442695080,219731,347060333,4816,2.27845574619744,544821,53328813.4674797,7454968648263.24,600.404255319149,831893,17310246.0449785
1182,BTC,2018-10-08,420438254,443030067,334987,656648,443030067,248041,347308374,7787,3.34592755484154,544956,49925242.7414498,7454968648263.24,641.335820895522,965177,17311933.5449785
1182,BTC,2018-10-09,420740959,443350762,320695,632009,443350762,235862,347544236,7832,3.18077806491881,545086,49012509.3834619,7454968648263.24,653.279069767441,966413,17313558.5449785
1182,BTC,2018-10-10,421040204,443686306,335544,653131,443686306,244945,347789181,8370,4.25046528751381,545230,53515685.9065245,7454968648263.24,598.307692307692,896905,17315358.5449785
1182,BTC,2018-10-11,421382018,444032743,346437,699363,444032743,262467,348051648,9580,4.04349274490603,545389,58858858.5687817,7454968648263.24,543.993670886076,920825,17317346.0449785
1182,BTC,2018-10-12,421726042,444361807,329064,704003,444361807,243174,348294822,8547,4.59901926289106,545521,48745687.2483552,7454968648263.24,656.854961832061,1128503,17318996.0449784
1182,BTC,2018-10-13,422000283,444637240,275433,583522,444637240,205097,348499919,5279,3.34067187597824,545662,53853917.3105642,7454968648263.24,594.55,862022,17320758.5449785
1182,BTC,2018-10-14,422248928,444895302,258062,533594,444895302,191259,348691178,5258,3.46422709787085,545776,41941062.7317577,7454968648263.24,763.424778761062,957302,17322183.5449785
1182,BTC,2018-10-15,422599528,445246956,351654,716731,445246956,266945,348958123,10864,4.81000426933233,545938,60242772.5801539,7454968648263.24,531.496894409938,943760,17324208.5449784
1182,BTC,2018-10-16,422953640,445596420,349464,694685,445596420,257967,349216090,8680,3.20910681365744,546073,50246228.3166349,7454968648263.24,637.238805970149,1066273,17325896.0449785
1182,BTC,2018-10-17,423301020,445946844,350424,688109,445946844,260362,349476452,8980,3.43276040819386,546211,50845952.0536031,7454968648263.24,629.722627737226,1049207,17327621.0449785
1182,BTC,2018-10-18,423629273,446288270,341426,670447,446288270,253450,349729902,8403,3.88763214405496,546349,51133009.3818174,7427362643331.73,623.868613138686,996208,17329346.0449785
1182,BTC,2018-10-19,423960720,446628819,340549,701213,446628819,253826,349983728,8415,3.78788017257913,546491,52400452.0434537,7182852313938.32,588.737588652482,1018147,17331121.0449785
1182,BTC,2018-10-20,424257614,446935934,307115,611379,446935934,227821,350211549,5871,2.96192875348032,546634,50872901.7292976,7182852313938.32,606.415492957746,887885,17332908.5449785
1182,BTC,2018-10-21,424520112,447218470,282536,572486,447218470,211505,350423054,5315,2.54661890387783,546772,49667616.9212026,7182852313938.32,621.131386861313,823540,17334633.5449784
1182,BTC,2018-10-22,424857358,447563271,344801,692314,447563271,255324,350678378,9518,3.43572438461469,546927,55355228.3710752,7182852313938.32,557.311688311688,916539,17336571.0449785
1182,BTC,2018-10-23,425196031,447903004,339733,697985,447903004,253463,350931841,8654,4.01612247864501,547081,55875982.1293598,7182852313938.32,552.117647058824,932260,17338496.0449777
1182,BTC,2018-10-24,425513138,448240666,337662,652136,448240666,254091,351185932,8634,3.94944461373606,547194,41335243.0601825,7182852313938.32,746.339285714286,1141656,17339908.5449777
1182,BTC,2018-10-25,425836580,448574540,333874,674946,448574540,254599,351440531,9074,3.96988217128618,547331,49173326.6074724,7182852313938.32,627.375,1035430,17341621.0449777
1182,BTC,2018-10-26,426177450,448908333,333793,705500,448908333,253002,351693533,7508,3.26636871787654,547474,51601583.612834,7182852313938.32,597.852112676056,1058047,17343408.5449777
1182,BTC,2018-10-27,426481208,449214750,306417,599637,449214750,233749,351927282,4994,2.47019970684332,547610,48785456.4344083,7182852313938.32,632.362962962963,913874,17345108.5449777
1182,BTC,2018-10-28,426754674,449504266,289516,583240,449504266,219860,352147142,4386,2.38321722792477,547750,49940210.2516765,7182852313938.32,617.741007194245,828287,17346858.5449777
1182,BTC,2018-10-29,427128586,449861470,357204,732345,449861470,269754,352416896,8068,3.00287893415167,547896,52468029.4656466,7182852313938.32,587.979310344828,983820,17348683.5449777
1182,BTC,2018-10-30,427495238,450229179,367709,722192,450229179,283327,352700223,8088,3.00279841522799,548050,55007956.3951139,7182852313938.32,560.830065359477,943664,17350608.5449777
1182,BTC,2018-10-31,427859536,450602966,373787,732516,450602966,288283,352988506,8372,3.23353217166333,548213,58650410.228827,7182852313938.32,526.0,918292,17352646.0449776
1182,BTC,2018-11-01,428217510,450967686,364720,716325,450967686,281941,353270447,8437,3.28761512913422,548367,56069058.8276014,7183013626017.64,550.228758169935,979455,17354571.0449777
1182,BTC,2018-11-02,428585982,451339670,371984,789905,451339670,292704,353563151,7942,4.33115596808376,548510,51544735.9200741,7184404942701.79,598.640845070423,1117054,17356358.5449776
1182,BTC,2018-11-03,428921665,451667076,327406,664462,451667076,249564,353812715,5354,2.39484465544498,548671,57709266.790803,7184404942701.79,534.69375,885550,17358371.0449769
1182,BTC,2018-11-04,429269978,451958448,291372,638497,451958448,226247,354038962,5160,2.65209187941537,548794,45926796.8104046,7184404942701.79,671.868852459016,1035187,17359908.5449769
1182,BTC,2018-11-05,429633430,452347918,389470,736330,452347918,296283,354335245,8498,2.97065806710638,548938,51457960.9402667,7184404942701.79,599.65034965035,1044358,17361708.5449769
1182,BTC,2018-11-06,429991473,452728349,380431,715671,452728349,285451,354620696,8117,3.11115921183776,549066,45819048.7595392,7184404942701.79,673.448818897638,1072038,17363308.544977
1182,BTC,2018-11-07,430362139,453108985,380636,727200,453108985,293734,354914430,8571,2.9906364464651,549196,47564438.5728502,7184404942701.79,648.736434108527,1144160,17364933.5449762
1182,BTC,2018-11-08,430740131,453469778,360793,721536,453469778,277597,355192027,7930,2.84501045155239,549317,43341731.0923764,7184404942701.79,711.941666666666,1169965,17366446.0449762
1182,BTC,2018-11-09,431086147,453839446,369668,725173,453839446,283896,355475923,8178,3.01902540297278,549444,45570158.9117858,7184404942701.79,677.126984126984,1135195,17368033.5449762
1182,BTC,2018-11-10,431390597,454164909,325463,616864,454164909,252499,355728422,5238,2.33088721277783,549575,47104615.5440558,7184404942701.79,655.06923076923,955554,17369671.0449762
1182,BTC,2018-11-11,431690422,454471583,306674,614666,454471583,246991,355975413,6102,2.20485495236106,549721,52642379.009661,7184404942701.79,586.158620689655,874062,17371496.0449762
1182,BTC,2018-11-12,432037050,454842624,371041,708464,454842624,300006,356275419,9203,2.88022494012373,549861,50391740.7454311,7184404942701.79,612.338129496403,1066877,17373246.0449762
1182,BTC,2018-11-13,432358139,455195558,352934,669519,455195558,279160,356554579,8949,3.18658256764253,549981,43013275.7959056,7184404942701.79,717.378151260505,1110003,17374746.0449761
1182,BTC,2018-11-14,432712183,455559625,364067,746378,455559625,292755,356847334,10154,3.94877642428327,550116,48005492.6414892,7184404942701.79,642.776119402985,1094776,17376433.5449762
1182,BTC,2018-11-15,433067786,455913184,353559,736412,455913184,291525,357138859,9279,6.49287936628039,550243,45107023.8999901,7184404942701.79,684.079365079365,1193645,17378021.0449755
1182,BTC,2018-11-16,433403417,456264376,351192,728953,456264376,283124,357421983,7837,4.04514429536394,550369,46226057.8269017,7175974755379.64,666.736,1158173,17379596.0449755
1182,BTC,2018-11-17,433699720,456567778,303402,616227,456567778,262649,357684632,5064,2.59979991840582,550514,47994490.0566922,6653303141405.96,595.395833333333,914248,17381408.5449755
1182,BTC,2018-11-18,433978162,456841406,273628,572212,456841406,239803,357924435,4078,2.42008287399553,550637,40499503.573738,6653303141405.96,705.581967213115,954274,17382946.0449755
1182,BTC,2018-11-19,434318332,457163113,321707,693761,457163113,267971,358192406,8142,4.00748047642159,550763,41663341.5603971,6653303141405.96,685.872,1100711,17384521.0449755
1182,BTC,2018-11-20,434711367,457530637,367524,781612,457530637,288450,358480856,9948,7.33520515238197,550895,44618162.8118972,6653303141405.96,640.450381679389,1203740,17386171.0449755
1182,BTC,2018-11-21,435014341,457850295,319658,642219,457850295,254942,358735798,7324,5.1359847202956,551000,35015550.5034831,6653303141405.96,816.086538461538,1213546,17387483.5449755
1182,BTC,2018-11-22,435364402,458171872,321577,674777,458171872,266116,359001914,6113,3.82191728693356,551122,40262489.2024527,6653303141405.96,709.735537190083,1218455,17389008.5449755
1182,BTC,2018-11-23,435672774,458481103,309231,658702,458481103,275261,359277175,6797,4.20352732836326,551247,41962402.6661658,6653303141405.96,680.983870967742,1131096,17390571.0449755
1182,BTC,2018-11-24,435971989,458761434,280331,602095,458761434,250017,359527192,5250,3.62283081539115,551390,47257347.640892,6653303141405.96,604.68309859155,980274,17392358.5449755
1182,BTC,2018-11-25,436246629,459035751,274317,588419,459035751,239256,359766448,5651,4.46197714687782,551517,41837562.6858215,6653303141405.96,683.015873015873,1010554,17393946.0449755
1182,BTC,2018-11-26,436562301,459354014,318263,649621,459354014,257062,360023510,7905,5.02668939736671,551628,37346780.5800251,6653303141405.96,765.145454545454,1186164,17395333.5449755
1182,BTC,2018-11-27,436895298,459678290,324276,664504,459678290,268533,360292043,6807,4.67901541791154,551759,43400746.8088026,6653303141405.96,658.415384615385,1071254,17396971.0449755
1182,BTC,2018-11-28,437193646,459991752,313462,634492,459991752,254456,360546499,7810,5.34462868932157,551877,38760438.8063274,6653303141405.96,737.239316239317,1111968,17398446.0449747
1182,BTC,2018-11-29,437495944,460308527,316775,627382,460308527,246226,360792725,6487,4.76164467249417,551982,35654511.2040757,6653303141405.96,801.461538461539,1202130,17399758.5449747
1182,BTC,2018-11-30,437782547,460623487,314960,611146,460623487,250157,361042882,9525,7.41500107026919,552083,33310081.2509036,6653303141405.96,857.87,1209791,17401021.0449747
1182,BTC,2018-12-01,438079674,460911985,288498,611585,460911985,241847,361284729,10614,5.15269805786262,552207,41210630.7558262,6653303141405.96,693.406504065041,1068438,17402571.0449747
1182,BTC,2018-12-02,438343499,461176677,264692,529374,461176677,222673,361507402,7233,4.38683631386257,552321,37524476.9733014,6653303141405.96,761.522123893805,1005271,17403996.0449747
1182,BTC,2018-12-03,438624922,461477470,300793,594029,461477470,240652,361748054,8347,6.17916773166456,552435,35297948.004348,6194015746026.1,753.672566371681,1101028,17405421.0449747
1182,BTC,2018-12-04,438994425,461838384,360914,697990,461838384,270189,362018243,8690,8.23112608685194,552573,39447229.101942,5646403851534.72,614.773722627737,1083459,17407146.0449747
1182,BTC,2018-12-05,439305527,462154175,315791,623076,462154175,256501,362274744,7305,6.67845596911193,552703,36598826.187126,5646403851534.72,662.62015503876,1036768,17408771.0449747
1182,BTC,2018-12-06,439654351,462501790,347615,678431,462501790,279654,362554398,7229,5.84012360780582,552838,38210049.3166709,5646403851534.72,634.679104477612,1091929,17410458.5449747
1182,BTC,2018-12-07,439973391,462824006,322216,680079,462824006,253890,362808288,6835,5.68097993520891,552952,32533289.1705811,5646403851534.72,745.424778761062,1222291,17411883.5449747
1182,BTC,2018-12-08,440251854,463100206,276200,557725,463100206,231104,363039392,4157,3.99999099502981,553079,35850446.4840626,5646403851534.72,676.452380952381,970701,17413471.0449747
1182,BTC,2018-12-09,440528691,463371376,271170,545200,463371376,238569,363277961,3529,3.14306227569366,553207,36985040.0492165,5646403851534.72,655.700787401575,948841,17415071.0449747
1182,BTC,2018-12-10,440845107,463686242,314866,642160,463686242,258353,363536314,5393,4.14362320792462,553331,35464970.5798385,5646403851534.72,683.80487804878,1141154,17416621.0449747
1182,BTC,2018-12-11,441184472,463999710,313468,643565,463999710,251487,363787801,5403,4.89601925273847,553456,35199621.512231,5646403851534.72,688.959677419355,1076672,17418183.544974
1182,BTC,2018-12-12,441523437,464319481,319771,649869,464319481,261423,364049224,5869,4.2108579092799,553576,33478147.4443709,5646403851534.72,724.386554621849,1133562,17419683.544974
1182,BTC,2018-12-13,441880042,464643056,323575,669120,464643056,268422,364317646,5801,4.31104840323256,553707,36549446.2444267,5646403851534.72,663.515384615384,1084257,17421321.044974
1182,BTC,2018-12-14,442275179,464966807,323751,723450,464966807,275801,364593447,5532,4.20391648069706,553853,41791404.80308,5646403851534.72,580.289655172414,1058685,17423146.044974
1182,BTC,2018-12-15,442619626,465267031,300224,629936,465267031,262879,364856326,4122,3.09304465543748,554002,42233429.1465195,5646403851534.72,574.216216216216,941854,17425008.544974
1182,BTC,2018-12-16,442920586,465533112,266081,560839,465533112,226453,365082779,4272,3.73956496581825,554117,32223645.5106697,5646403851534.72,752.587719298245,1019919,17426446.044974
1182,BTC,2018-12-17,443321555,465881358,348246,727582,465881358,298823,365381602,5996,4.01761638054571,554277,45018540.8547805,5646403851534.72,538.691823899371,990779,17428446.044974
1182,BTC,2018-12-18,443667141,466213727,332369,669403,466213727,266245,365647847,6753,5.15013848469444,554405,36003402.2034718,5621092245587.46,670.55905511811,1078395,17430046.044974
1182,BTC,2018-12-19,444059620,466573199,359472,734734,466573199,302392,365950239,8080,5.05552952908503,554554,38341157.8239983,5106422924659.82,572.02027027027,1084764,17431908.544974
1182,BTC,2018-12-20,444399963,466917015,343816,674536,466917015,287273,366237512,8063,4.60664324496535,554689,34674562.3645341,5106422924659.82,632.507462686568,1139195,17433596.044974
1182,BTC,2018-12-21,444732820,467256809,339794,684456,467256809,280588,366518100,7245,4.56684687149554,554829,35668333.6071938,5106422924659.82,614.884892086331,1048346,17435346.044974
1182,BTC,2018-12-22,445044337,467542732,285923,580350,467542732,251216,366769316,4884,3.21269334340989,555004,44646434.4686376,5106422924659.82,491.235632183908,806539,17437533.544974
1182,BTC,2018-12-23,445326129,467818034,275302,556098,467818034,250739,367020055,4057,3.11485753701526,555180,45336899.5554739,5106422924659.82,483.754285714286,740468,17439733.544974
1182,BTC,2018-12-24,445633875,468121408,303374,613783,468121408,272297,367292352,7172,4.05011239545922,555332,39463290.0607103,5106422924659.82,555.754966887417,932735,17441633.544974
1182,BTC,2018-12-25,445888791,468383053,261645,526841,468383053,265052,367557404,5718,4.05035316831973,555491,40471412.4270802,5106422924659.82,541.911392405063,821911,17443621.044974
1182,BTC,2018-12-26,446174611,468677374,294321,578227,468677374,281305,367838709,5696,3.97746322493045,555648,39833505.2846545,5106422924659.82,550.589743589744,889580,17445583.544974
1182,BTC,2018-12-27,446518227,469001389,324015,651466,469001389,300020,368138729,6507,4.19583805480241,555822,44987752.6025426,5106422924659.82,487.508670520231,885621,17447758.544974
1182,BTC,2018-12-28,446850359,469346506,345117,671839,469346506,308267,368446996,5961,4.09908234236918,555989,42624642.9761176,5106422924659.82,514.536144578313,930544,17449846.044974
1182,BTC,2018-12-29,447149713,469660311,313805,595184,469660311,264980,368711976,5085,4.27478437643162,556127,35454205.0095734,5106422924659.82,618.598540145986,973710,17451571.044974
1182,BTC,2018-12-30,447429453,469947921,287610,566963,469947921,267639,368979615,4109,2.61607257392566,556303,45174679.0370612,5106422924659.82,485.491428571429,762486,17453771.044974
1182,BTC,2018-12-31,447736206,470237553,289632,581317,470237553,259684,369239299,6203,3.27830938228701,556458,40392996.2368619,5248509606855.42,558.071428571429,888393,17455708.544974
1182,BTC,2019-01-01,447967223,470470408,232855,461105,470470408,234725,369474024,3844,2.3421734092435,556607,41826596.7372394,5618595848853.28,576.945945945946,801778,17457571.044974
1182,BTC,2019-01-02,448298911,470781235,310827,613261,470781235,271696,369745720,6423,3.62801345390838,556758,42361558.5090514,5618595848853.28,569.66,947860,17459458.544974
1182,BTC,2019-01-03,448630375,471117765,336530,630077,471117765,291016,370036736,5360,3.23143045088246,556913,43529916.4222997,5618595848853.28,554.37012987013,966222,17461396.044974
1182,BTC,2019-01-04,448937386,471442837,325072,615961,471442837,281772,370318508,5601,3.45121524807153,557062,41786468.2602012,5618595848853.28,577.5,959198,17463258.544974
1182,BTC,2019-01-05,449220986,471742030,299193,545846,471742030,265192,370583700,3985,2.87503052910555,557225,46904866.9172261,5618595848853.28,514.481481481481,812945,17465296.044974
1182,BTC,2019-01-06,449495567,472035964,293934,545467,472035964,258522,370842222,3832,2.6734244550791,557366,39548562.5851597,5618595848853.28,610.178571428571,826675,17467058.544974
1182,BTC,2019-01-07,449826393,472368515,332551,633246,472368515,284782,371127004,5807,3.45769535451679,557507,39132613.9348484,5618595848853.28,616.664285714286,984752,17468821.044974
1182,BTC,2019-01-08,450170306,472725896,357381,655007,472725896,318524,371445528,5915,2.84836407903078,557676,47709037.264695,5618595848853.28,505.809523809524,867930,17470933.544974
1182,BTC,2019-01-09,450499483,473071607,345711,646347,473071607,319056,371764584,6104,2.96380412787874,557840,45871308.7289025,5618595848853.28,526.073619631902,884137,17472983.544974
1182,BTC,2019-01-10,450847255,473429547,357940,680078,473429547,327338,372091922,6598,3.55960793504833,557996,43320877.9057847,5618595848853.28,557.045161290322,970871,17474933.544974
1182,BTC,2019-01-11,451166525,473768932,339385,655751,473768932,308372,372400294,5832,3.89867391329673,558144,41195175.491855,5618595848853.28,585.789115646259,983164,17476783.544974
1182,BTC,2019-01-12,451444352,474071205,302273,542093,474071205,281502,372681796,4493,2.8489060074748,558282,38468279.8000567,5618595848853.28,627.313868613138,896714,17478508.544974
1182,BTC,2019-01-13,451706563,474354705,283500,518576,474354705,276997,372958793,4290,2.69580487533414,558419,39343881.4754508,5618595848853.28,613.35294117647,853370,17480221.044974
1182,BTC,2019-01-14,452023647,474704635,349930,636617,474704635,326685,373285478,5974,2.88889572810414,558568,43646215.5613221,5862614531725.71,576.905405405406,956647,17482083.544974
1182,BTC,2019-01-15,452357599,475054752,350117,645081,475054752,302279,373587757,6560,4.59110541228564,558700,38793183.2152996,5883988430955.41,651.442748091603,1065034,17483733.544974
1182,BTC,2019-01-16,452713401,475428288,373536,678059,475428288,305702,373893459,6510,3.26960111888666,558833,39086108.3154623,5883988430955.41,646.560606060606,1112098,17485396.0449739
1182,BTC,2019-01-17,453038346,475772165,343877,636329,475772165,296695,374190154,5295,2.91572712274026,558960,37302036.8661536,5883988430955.41,677.484126984127,1097214,17486983.544974
1182,BTC,2019-01-18,453354783,476122476,350311,652367,476122476,305965,374496119,5054,2.90953370951821,559098,40539092.8960755,5883988430955.41,623.386861313869,1037986,17488708.544974
1182,BTC,2019-01-19,453639369,476427147,304671,557299,476427147,282188,374778307,3611,2.2529654562902,559231,38857097.9311518,5883988430955.41,650.371212121212,959122,17490371.0449739
1182,BTC,2019-01-20,453934055,476723029,295882,549773,476723029,294118,375072425,4001,2.29117419183199,559388,45828604.9176433,5883988430955.41,551.435897435897,805785,17492333.544974
1182,BTC,2019-01-21,454253198,477061242,338213,631330,477061242,315202,375387627,7758,4.93201829442992,559538,43712740.0920396,5883988430955.41,578.127516778523,943183,17494208.544974
1182,BTC,2019-01-22,454576742,477397782,336540,626613,477397782,296040,375683667,7202,3.94923102238708,559668,39338591.1434454,5883988430955.41,642.410852713178,1055254,17495833.544974
1182,BTC,2019-01-23,454954548,477751652,353870,708846,477751652,293494,375977161,5876,4.01357972489192,559814,43036349.2441735,5883988430955.41,587.213793103449,1026111,17497658.544974
1182,BTC,2019-01-24,455303669,478106357,354705,660872,478106357,308146,376285307,8733,4.80792199703342,559976,47441409.4520985,5883988430955.41,532.689440993789,911348,17499683.5449732
1182,BTC,2019-01-25,455627420,478464509,358152,657356,478464509,301085,376586392,9017,6.07624849419134,560114,40091720.2970973,5883988430955.41,630.343065693431,1017360,17501408.5449732
1182,BTC,2019-01-26,455956146,478813652,349143,621149,478813652,288285,376874677,5667,3.31876307200271,560264,44106488.5942508,5883988430955.41,572.96644295302,980735,17503283.5449732
1182,BTC,2019-01-27,456233400,479109651,295999,532591,479109651,276651,377151328,4272,2.65770939287586,560401,40299811.8265493,5883988430955.41,627.088235294117,881242,17504996.0449732
1182,BTC,2019-01-28,456577808,479464452,354801,666174,479464452,308062,377459390,8341,5.32494749316673,560546,42000616.6800578,5836655168808.53,596.854166666667,1022644,17506808.5449732
1182,BTC,2019-01-29,456928381,479835645,371193,664300,479835645,326162,377785552,8085,4.80176361638398,560692,42408751.973731,5814661935891.8,588.88275862069,1010222,17508633.5449732
1182,BTC,2019-01-30,457268627,480193553,357908,647204,480193553,321980,378107532,8695,6.9716594957397,560828,39051366.6112242,5814661935891.8,639.511111111111,1074707,17510333.5449732
1182,BTC,2019-01-31,457623098,480570631,377078,678650,480570631,353945,378461477,9689,6.15999216527559,560983,45575836.7406976,5814661935891.8,547.961038961039,1015420,17512271.0449732
1182,BTC,2019-02-01,457984926,480939810,369179,700878,480939810,339341,378800818,9460,8.26776553751881,561141,45775306.8443916,5814661935891.8,545.573248407643,1024592,17514246.0449732
1182,BTC,2019-02-02,458305358,481272340,332530,597362,481272340,322032,379122850,6055,4.74784338141188,561285,41518932.1377555,5814661935891.8,601.503496503497,981337,17516046.0449732
1182,BTC,2019-02-03,458603459,481582270,309930,561526,481582270,300171,379423021,3312,2.30753979395578,561423,40303070.3802164,5814661935891.8,619.649635036496,935500,17517771.0449732
1182,BTC,2019-02-04,458935576,481931848,349578,650416,481931848,335288,379758309,8741,6.26396584123759,561570,43473057.7115712,5814661935891.8,574.465753424658,1012398,17519608.5449731
1182,BTC,2019-02-05,459272285,482323144,391296,683680,482323144,354069,380112378,9675,7.81225184247678,561717,42697225.8230467,5814661935891.8,584.904109589041,1051188,17521446.0449732
1182,BTC,2019-02-06,459668047,482697501,374357,722314,482697501,349596,380461974,9048,10.4978911287756,561881,47475905.9616304,5814661935891.8,526.030674846626,1050370,17523496.0449731
1182,BTC,2019-02-07,460027649,483069168,371667,685367,483069168,353046,380815020,9327,7.43297788583881,562055,50442661.8882159,5814661935891.8,495.092485549133,942216,17525671.0449732
1182,BTC,2019-02-08,460389214,483440236,371068,727382,483440236,335280,381150300,9464,8.75673885733119,562218,46903472.4372065,5814661935891.8,532.450617283951,984610,17527708.5449732
1182,BTC,2019-02-09,460710472,483771034,330798,604407,483771034,310892,381461192,6689,5.44129153403066,562368,43228318.3659474,5814661935891.8,577.718120805369,934364,17529583.5449732
1182,BTC,2019-02-10,460982273,484072799,301765,537945,484072799,299609,381760801,3965,2.06712555422411,562508,41094129.4392953,5894008795042.49,616.014388489209,899240,17531333.5449732
1182,BTC,2019-02-11,461379523,484421042,348243,723279,484421042,315725,382076526,8656,6.95075325312383,562653,43503836.6635231,6061518831027.27,598.430555555555,1091101,17533146.0449732
1182,BTC,2019-02-12,461878215,484781183,360141,842858,484781183,271573,382348099,8702,11.6971450479899,562781,38536110.3196518,6061518831027.27,675.574803149606,1304964,17534746.0449732
1182,BTC,2019-02-13,462306218,485193919,412736,792204,485193919,352651,382700750,9274,10.6597000863679,562934,46136477.6181838,6061518831027.27,564.282894736843,1153285,17536658.5449732
1182,BTC,2019-02-14,462639367,485561949,368030,659013,485561949,354483,383055233,8141,7.75295150856168,563075,43830433.4031103,6061518831027.27,593.971428571429,1111246,17538421.0449732
1182,BTC,2019-02-15,462958089,485903592,341643,645085,485903592,296729,383351962,7697,7.25377918065315,563202,38524988.174124,6061518831027.27,675.769841269841,1101274,17540008.5449732
1182,BTC,2019-02-16,463288349,486245602,342010,642958,486245602,332137,383684099,4255,2.17096704960257,563352,45243824.094139,6061518831027.27,575.41610738255,1008760,17541883.5449732
1182,BTC,2019-02-17,463580541,486556433,310831,568092,486556433,327463,384011562,4653,2.08287143742334,563511,47847756.9868945,6061518831027.27,544.101265822785,881877,17543871.0449732
1182,BTC,2019-02-18,463953670,486934296,377863,719362,486934296,344274,384355836,7793,3.44869041561068,563666,46557352.7193714,6061518831027.27,559.181818181818,1080017,17545808.5449732
1182,BTC,2019-02-19,464331651,487342641,408345,748424,487342641,348242,384704078,8228,5.11206030491411,563822,47463759.4064703,6061518831027.27,548.503225806452,1060471,17547758.5449732
1182,BTC,2019-02-20,464699559,487730786,388145,719167,487730786,314320,385018398,6965,4.36813887631532,563952,39188196.4024339,6061518831027.27,664.333333333333,1191522,17549383.5449731
1182,BTC,2019-02-21,465025414,488090416,359630,671016,488090416,297595,385315993,6130,3.64170710688815,564071,35886348.3822641,6061518831027.27,725.457627118644,1178449,17550871.0449732
1182,BTC,2019-02-22,465427886,488482343,391927,765893,488482343,350306,385666299,6323,3.92862782848512,564233,48557437.9990662,6061518831027.27,536.149068322981,1085184,17552896.0449732
1182,BTC,2019-02-23,465723037,488815276,332933,600634,488815276,328239,385994538,5679,3.03916540778999,564376,43326983.8539653,6061518831027.27,600.87323943662,982793,17554683.5449732
1182,BTC,2019-02-24,466017963,489133371,318095,600042,489133371,320446,386314984,5274,2.97612129221934,564513,41699034.4806698,6064081790460.69,624.595588235294,1044065,17556396.0449732
1182,BTC,2019-02-25,466373058,489499248,365877,698360,489499248,336634,386651618,7410,4.50968710087243,564656,43762393.6695945,6071846049920.75,595.908450704225,1109526,17558183.5449732
1182,BTC,2019-02-26,466746613,489896556,397308,734105,489896556,366568,387018186,7298,4.69887392862459,564817,48518480.8395566,6071846049920.75,537.49375,1092907,17560196.0449732
1182,BTC,2019-02-27,467113089,490281540,384984,706548,490281540,344560,387362746,6807,4.08612154522327,564958,43378758.7418273,6071846049920.75,601.178571428571,1125122,17561958.5449732
1182,BTC,2019-02-28,467493425,490671293,389753,723161,490671293,367827,387730573,6992,4.18912418628839,565108,45752082.9328346,6071846049920.75,569.993288590604,1130737,17563833.5449724
1182,BTC,2019-03-01,467850613,491053305,382012,752393,491053305,354422,388084995,6863,3.87153512009297,565270,48990912.8600474,6071846049920.75,532.310559006211,1053071,17565858.5449724
1182,BTC,2019-03-02,468192502,491427871,374566,664627,491427871,335864,388420859,4993,4.35954190355462,565402,40419159.8254764,6071846049920.75,645.198473282443,1155579,17567508.5449724
1182,BTC,2019-03-03,468504616,491756592,328721,595430,491756592,353683,388774542,4609,4.09172190453856,565548,44106296.648428,6071846049920.75,591.262068965517,1003580,17569333.5449724
1182,BTC,2019-03-04,468863087,492119994,363402,700424,492119994,304188,389078730,7772,5.85375666583192,565685,41519277.3367853,6071846049920.75,628.10294117647,1104753,17571046.0449724
1182,BTC,2019-03-05,469220857,492499052,379058,718015,492499052,285716,389364446,7525,7.58738270541524,565834,45583496.961084,6071846049920.75,572.101351351352,1029825,17572908.5449724
1182,BTC,2019-03-06,469607160,492867788,368736,748454,492867788,277863,389642309,6959,5.15205874867485,565962,38440027.0054906,6071846049920.75,678.417322834646,1235649,17574508.5449725
1182,BTC,2019-03-07,469948755,493232296,364508,700381,493232296,282523,389924832,6503,4.66047022029176,566104,43094151.9550507,6071846049920.75,605.148936170213,1008441,17576283.5449724
1182,BTC,2019-03-08,470296511,493600901,368605,722941,493600901,285264,390210096,6829,4.60705743686792,566250,44044134.5838246,6071846049920.75,592.096551724138,998636,17578108.5449724
1182,BTC,2019-03-09,470580763,493929257,328356,611435,493929257,239492,390449588,4875,3.42272688421814,566388,42067846.7510553,6071846049920.75,619.912408759124,882423,17579833.5449724
1182,BTC,2019-03-10,470826892,494202207,272950,530849,494202207,212877,390662465,4176,3.11417899051114,566524,41859992.1319056,6071216044486.33,622.925925925926,783473,17581533.5449724
1182,BTC,2019-03-11,471197479,494594497,392290,762249,494594497,294741,390957206,6861,3.83625216787993,566666,42943836.8358263,6068891541676.55,606.971631205674,1099574,17583308.5449724
1182,BTC,2019-03-12,471533584,494965825,371328,710449,494965825,285653,391242859,6988,5.20581901464728,566809,43928506.2381613,6068891541676.55,593.366197183098,1004161,17585096.0449725
1182,BTC,2019-03-13,471910701,495331524,365699,728433,495331524,285957,391528816,6036,3.99917331645478,566944,41261208.4093421,6068891541676.55,631.723880597015,1163580,17586783.5449724
1182,BTC,2019-03-14,472290168,495718126,386602,754397,495718126,299929,391828745,7416,4.72936452788813,567099,47063222.423541,6068891541676.55,553.844155844156,1043826,17588721.0449724
1182,BTC,2019-03-15,472632989,496096545,378419,732220,496096545,296970,392125715,7446,4.60802666412247,567252,46388378.1048802,6068891541676.55,561.901315789474,987588,17590633.5449724
1182,BTC,2019-03-16,472930703,496424705,328160,624234,496424705,262267,392387982,5923,3.2467916866231,567415,49592956.715576,6068891541676.55,525.592592592592,788659,17592671.0449724
1182,BTC,2019-03-17,473178710,496710898,286193,549122,496710898,227290,392615272,4736,3.04212271067834,567561,44219453.7474075,6068891541676.55,589.462068965517,742798,17594496.0449724
1182,BTC,2019-03-18,473524154,497075627,364729,729520,497075627,291505,392906777,7668,6.10830032972162,567722,49152726.1822965,6068891541676.55,530.3,926942,17596508.5449724
1182,BTC,2019-03-19,473897419,497464390,388763,764409,497464390,304744,393211521,7622,4.81089476085803,567896,53416464.1863043,6068891541676.55,487.971098265896,909794,17598683.5449724
1182,BTC,2019-03-20,474281563,497846826,382436,753347,497846826,304960,393516481,7743,4.31324112410175,568057,48338052.7030702,6068891541676.55,539.2375,992002,17600696.0449724
1182,BTC,2019-03-21,474636745,498225045,378219,721365,498225045,300712,393817193,6623,4.88932942802988,568200,45218106.1464174,6068891541676.55,576.443661971831,1039646,17602483.5449724
1182,BTC,2019-03-22,474989113,498595741,370696,735026,498595741,298524,394115717,7418,5.87379482838412,568361,49268278.551613,6068891541676.55,529.05625,944549,17604496.0449724
1182,BTC,2019-03-23,475271243,498911182,315441,593810,498911182,251573,394367290,5459,3.03025852887758,568506,43829368.5046818,6068891541676.55,594.708333333333,840116,17606308.5449724
1182,BTC,2019-03-24,475549726,499202959,291777,569880,499202959,226166,394593456,4935,2.81151305317475,568656,47228168.5093996,6368919654419.9,579.194630872483,753646,17608183.5449724
1182,BTC,2019-03-25,475912838,499579287,376328,738507,499579287,322191,394915647,7643,4.44728995586,568804,47026846.4415673,6379265451411.05,582.619047619047,1056967,17610033.5449724
1182,BTC,2019-03-26,476253941,499965604,386317,725012,499965604,366415,395282062,6740,3.37146591501562,568938,42479651.5939014,6379265451411.05,644.984962406015,1207859,17611708.5449724
1182,BTC,2019-03-27,476658799,500394048,428444,823614,500394048,383186,395665248,6969,3.38988913897903,569087,47681353.1815806,6379265451411.05,574.621621621622,1199629,17613571.0449724
1182,BTC,2019-03-28,477062716,500832805,438757,816964,500832805,393698,396058946,7181,3.67823463258383,569233,46366994.1237997,6379265451411.05,590.910344827587,1217287,17615396.0449724
1182,BTC,2019-03-29,477448416,501251992,419187,809947,501251992,369817,396428763,8496,3.57485491978062,569380,46549858.3447962,6379265451411.05,588.58904109589,1233981,17617233.5449724
1182,BTC,2019-03-30,477811600,501636913,384921,735911,501636913,377783,396806546,5824,2.44281943970814,569519,43914861.2075775,6379265451411.05,623.905797101449,1204920,17618971.0449724
1182,BTC,2019-03-31,478173001,502008265,371352,691799,502008265,381652,397188198,5635,2.40229028097683,569658,44877577.2101696,6379265451411.05,610.521739130435,1173565,17620708.5449724
1182,BTC,2019-04-01,478520341,502403950,395685,742925,502403950,368904,397557102,8584,4.72776822933728,569794,43406358.4112033,6379265451411.05,631.214814814815,1205358,17622408.5449724
1182,BTC,2019-04-02,478958921,502895416,491466,931387,502895416,401507,397958609,10891,8.54081991682805,569951,51037696.0316296,6379265451411.05,536.833333333333,1215506,17624371.0449724
1182,BTC,2019-04-03,479399700,503357740,462324,897707,503357740,360250,398318859,9513,3.62745975103969,570093,45252156.4063927,6379265451411.05,605.468085106383,1248329,17626146.0449724
1182,BTC,2019-04-04,479795817,503795924,438184,839066,503795924,354660,398673519,9626,3.60760092191214,570233,45930007.6171341,6379265451411.05,596.53237410072,1212958,17627896.0449724
1182,BTC,2019-04-05,480250270,504241535,445611,925289,504241535,387090,399060609,9440,2.79660839104945,570391,50019786.8363353,6379265451411.05,547.75796178344,1240968,17629871.0449724
1182,BTC,2019-04-06,480630919,504604464,362929,716047,504604464,359569,399420178,6298,2.15912940270549,570530,44033511.1232459,6379562392399.34,622.253623188406,1211691,17631608.5449724
1182,BTC,2019-04-07,480958721,504945236,340772,663859,504945236,350631,399770809,6842,2.37563887313489,570671,46123800.3228922,6393023717201.86,595.307142857143,1138896,17633371.0449724
1182,BTC,2019-04-08,481347673,505372025,426789,815867,505372025,372417,400143226,10588,3.99824240072287,570819,47281190.6666004,6393023717201.86,580.734693877552,1218371,17635221.0449724
1182,BTC,2019-04-09,481749920,505791631,419606,809788,505791631,346071,400489297,10430,5.71038064086742,570951,42541074.1217863,6393023717201.86,645.442748091603,1251238,17636871.0449724
1182,BTC,2019-04-10,482145440,506229679,438048,820131,506229679,396501,400885798,10213,3.9771249171762,571099,47251301.5947455,6393023717201.86,581.102040816327,1213674,17638721.0449724
1182,BTC,2019-04-11,482555372,506694917,465238,853807,506694917,402802,401288600,10253,4.68521137965946,571256,50089119.4035942,6393023717201.86,548.179487179487,1201692,17640683.5449724
1182,BTC,2019-04-12,482944037,507100978,406061,807079,507100978,376767,401665367,9815,3.99045039856341,571407,48383269.1326992,6393023717201.86,567.506666666666,1184258,17642571.0449724
1182,BTC,2019-04-13,483251765,507453048,352070,634235,507453048,367076,402032443,6250,2.95671182462169,571542,43111981.2005906,6393023717201.86,636.89552238806,1107431,17644258.5449724
1182,BTC,2019-04-14,483578118,507780424,327376,632313,507780424,337030,402369473,6516,2.9880405721299,571664,38878908.9268042,6393023717201.86,706.239669421488,1196266,17645783.5449724
1182,BTC,2019-04-15,483991925,508207978,427554,812394,508207978,381473,402750946,9749,4.07286870089188,571809,46120157.2530654,6393023717201.86,595.354166666667,1227139,17647596.0449724
1182,BTC,2019-04-16,484403049,508618616,410638,805383,508618616,358517,403109463,9636,4.99903207469398,571954,46135225.1550418,6393023717201.86,595.159722222222,1252634,17649408.5449724
1182,BTC,2019-04-17,484795005,509027888,409272,782031,509027888,350737,403460200,10568,4.53518367906534,572092,43697260.9593547,6393023717201.86,628.36496350365,1229380,17651133.5449724
1182,BTC,2019-04-18,485170212,509439809,411921,784146,509439809,382981,403843181,10063,4.7077886221594,572241,47305812.4489463,6393023717201.86,580.432432432432,1214881,17652996.0449724
1182,BTC,2019-04-19,485554587,509873649,433840,828920,509873649,362128,404205309,9407,5.64929160024334,572393,48575719.895706,6393023717201.86,565.258278145695,1212485,17654896.0449724
1182,BTC,2019-04-20,485950803,510221122,347473,727204,510221122,319840,404525149,7628,3.37686977419972,572524,41893779.7806613,6393023717201.86,655.415384615385,1240556,17656533.5449724
1182,BTC,2019-04-21,486369763,510552485,331363,736169,510552485,390735,404915884,7314,2.04683220228979,572686,51365832.698247,6357721118108.3,531.602484472049,1142430,17658558.5449724
1182,BTC,2019-04-22,486686952,510918668,366183,684024,510918668,342014,405257898,10505,4.94363001211369,572820,43116692.570824,6353030562983.98,632.842105263159,1142223,17660233.5449724
1182,BTC,2019-04-23,487021108,511314488,395820,744630,511314488,311753,405569651,10726,7.26013187521717,572936,37351466.8173793,6353030562983.98,730.521739130435,1255767,17661683.5449724
1182,BTC,2019-04-24,487483376,511780238,465750,918384,511780238,404279,405973930,11380,5.02362381096048,573099,52151883.3015698,6353030562983.98,523.203703703704,1234416,17663721.0449724
1182,BTC,2019-04-25,487853087,512201116,420878,793482,512201116,384089,406358019,10895,4.40877965409522,573242,45513089.1649164,6353030562983.98,599.521126760563,1219515,17665508.5449724
1182,BTC,2019-04-26,488225973,512615665,414549,808788,512615665,381209,406739228,11867,3.92161577303511,573393,48288211.1228846,6353030562983.98,565.066666666667,1255490,17667396.0449724
1182,BTC,2019-04-27,488537345,512960137,344472,653097,512960137,359008,407098236,5813,1.97531932007958,573530,44280221.4163431,6353030562983.98,616.213235294118,1170310,17669108.5449724
1182,BTC,2019-04-28,488843148,513297765,337628,637889,513297765,383291,407481527,6925,2.25055578006029,573693,51737417.504597,6353030562983.98,527.395061728395,977574,17671146.0449724
1182,BTC,2019-04-29,489233489,513703746,405981,828573,513703746,363207,407844734,9225,3.15275866939569,573856,51317569.4156722,6353030562983.98,531.70987654321,1203267,17673183.5449724
1182,BTC,2019-04-30,489657556,514127261,423515,865426,514127261,346486,408191220,10443,5.40275759147677,573996,44324020.7469077,6353030562983.98,615.604316546763,1295070,17674933.5449724
1182,BTC,2019-05-01,490059787,514550395,423134,802691,514550395,439549,408630769,8548,2.64486486613395,574167,55254674.7438451,6353030562983.98,493.823529411765,1126911,17677071.0449724
1182,BTC,2019-05-02,490483234,514983856,433461,828841,514983856,452646,409083415,9243,2.17954774638263,574351,59148182.3862114,6353030562983.98,461.31693989071,1100861,17679371.0449724
1182,BTC,2019-05-03,490884203,515417619,433763,837488,515417619,383032,409466447,10699,3.31043853137218,574503,48248666.0023914,6353030562983.98,565.529801324503,1228199,17681271.0449724
1182,BTC,2019-05-04,491220057,515793639,376020,694252,515793639,355910,409822357,8251,2.49092515232744,574635,42813568.6355585,6554050172254.85,657.488549618321,1187771,17682921.0449724
1182,BTC,2019-05-05,491533888,516136805,343166,652096,516136805,330732,410153089,6673,2.30620266670658,574764,43464314.3913795,6702169884349.17,662.28125,1196308,17684533.5449724
1182,BTC,2019-05-06,491924027,516550725,413920,801591,516550725,378476,410531565,7535,3.06538021521264,574915,50382022.2378401,6702169884349.17,571.346666666666,1222187,17686421.0449724
1182,BTC,2019-05-07,492272781,516958324,407599,785306,516958324,329943,410861508,8584,4.68664695849947,575042,43922468.2254743,6702169884349.17,655.373015873016,1267977,17688008.5449724
1182,BTC,2019-05-08,492693988,517415392,457068,872619,517415392,393081,411254589,10839,3.26350201431618,575194,50752249.6648088,6702169884349.17,567.17880794702,1243073,17689908.5449724
1182,BTC,2019-05-09,493096404,517857711,442319,856022,517857711,361569,411616158,11282,3.47922067303209,575344,51265233.187056,6702169884349.17,561.503355704698,1258699,17691783.5449724
1182,BTC,2019-05-10,493418431,518273980,416269,808103,518273980,322963,411939121,10955,4.21532026623214,575469,41910276.8378259,6702169884349.17,686.838709677419,1259484,17693346.0449724
1182,BTC,2019-05-11,493808239,518693521,419541,802405,518693521,344957,412284078,12240,3.65193089997852,575599,43313882.4935151,6702169884349.17,664.581395348837,1240594,17694971.0449724
1182,BTC,2019-05-12,494263065,519094494,400973,855440,519094494,338571,412622649,8504,2.8123005120627,575757,52373847.1791167,6702169884349.17,549.617834394905,1234789,17696946.0449724
1182,BTC,2019-05-13,494699274,519557683,463189,905136,519557683,390428,413013077,12831,4.29873025955001,575924,56324595.1327325,6702169884349.17,511.066265060241,1203409,17699033.5449724
1182,BTC,2019-05-14,495112430,520029947,472264,928465,520029947,367370,413380447,16596,4.49792690883758,576076,50903812.7896203,6702169884349.17,565.490066225165,1230687,17700933.5449724
1182,BTC,2019-05-15,495488691,520496844,466897,906193,520496844,368901,413749348,20887,5.87855891840646,576225,49463240.0893572,6702169884349.17,581.95945945946,1237726,17702796.0449724
1182,BTC,2019-05-16,495874035,520967519,470675,912985,520967519,375062,414124410,15557,3.83529470595838,576371,49172532.397533,6702169884349.17,585.4,1245267,17704621.0449724
1182,BTC,2019-05-17,496288923,521412160,444641,934336,521412160,361654,414486064,15569,3.77868301414244,576522,50537700.6698117,6702169884349.17,569.586666666667,1261404,17706508.5449724
1182,BTC,2019-05-18,496747638,521834937,422777,887987,521834937,359704,414845768,9298,2.31527678109159,576675,51230432.0672059,6703779555093.12,562.019736842105,1242334,17708421.0449724
1182,BTC,2019-05-19,497137539,522212479,377542,786670,522212479,346859,415192627,11032,2.57409371788395,576838,55570548.6957266,6704632680587.42,518.191358024691,1124021,17710458.5449724
1182,BTC,2019-05-20,497531135,522644324,431845,869875,522644324,381582,415574209,15061,3.20031617833991,576999,53956371.2237885,6704632680587.42,533.69375,1177317,17712471.0449724
1182,BTC,2019-05-21,497959535,523100962,456638,919192,523100962,380889,415955098,15118,2.80861641500484,577152,51161491.361051,6704632680587.42,562.848684210526,1258643,17714383.5449724
1182,BTC,2019-05-22,498392392,523550739,449777,912107,523550739,394887,416349985,15245,2.97036703948464,577319,58728721.5733275,6704632680587.42,490.325301204819,1201243,17716471.0449724
1182,BTC,2019-05-23,498792842,523990649,439910,870437,523990649,389343,416739328,16637,3.13732672533748,577477,52581995.3580609,6704632680587.42,547.643312101911,1226995,17718446.0449724
1182,BTC,2019-05-24,499204475,524414798,424149,897989,524414798,373882,417113210,16702,3.66891399918006,577630,50759817.5856662,6704632680587.42,567.302631578947,1254131,17720358.5449724
1182,BTC,2019-05-25,499560938,524775214,360416,749293,524775214,338398,417451608,13304,2.34413596015387,577770,46689242.4493105,6704632680587.42,616.762589928058,1177713,17722108.5449724
1182,BTC,2019-05-26,499903827,525124194,348980,705386,525124194,374072,417825680,13525,2.27336225028337,577935,55527021.8406794,6704632680587.42,518.59756097561,1001356,17724171.0449724
1182,BTC,2019-05-27,500326564,525567102,442908,920997,525567102,399584,418225264,16792,3.03549104527676,578102,56120379.4890571,6704632680587.42,513.114457831325,1190717,17726258.5449724
1182,BTC,2019-05-28,500782193,526028456,461354,985719,526028456,390427,418615691,17422,3.39244958462875,578266,54761553.4336095,6704632680587.42,525.846625766871,1262846,17728308.5449724
1182,BTC,2019-05-29,501200624,526497767,469311,932901,526497767,405155,419020846,16845,3.52075777204571,578440,58350576.3962135,6704632680587.42,493.50289017341,1224251,17730483.5449724
1182,BTC,2019-05-30,501593706,526930597,432830,887741,526930597,376874,419397720,19974,3.2501867283983,578600,53906405.0275397,6747104132834.88,537.572327044025,1213646,17732483.5449724
1182,BTC,2019-05-31,501884388,527305488,374891,791688,527305488,298997,419696717,21243,6.85480202934685,578717,43611051.7374605,7459680720542.3,734.655172413793,1291766,17733946.0449724
1182,BTC,2019-06-01,502332260,527704818,399330,881660,527704818,332092,420028809,15624,3.61314857171805,578868,56691628.2498895,7459680720542.3,565.146666666667,1244086,17735833.5449724
1182,BTC,2019-06-02,502679851,528052065,347247,731098,528052065,301003,420329812,13286,4.03603905549167,578999,49111309.1220627,7459680720542.3,652.376923076923,1200579,17737471.0449724
1182,BTC,2019-06-03,502997705,528417942,365877,758320,528417942,294009,420623821,16363,5.76255542246054,579118,44452685.5250335,7459680720542.3,720.745762711864,1256748,17738958.5449724
1182,BTC,2019-06-04,503412777,528882106,464164,939577,528882106,374763,420998584,19173,4.64614988082247,579272,57001092.6323824,7459680720542.3,562.078431372549,1253258,17740883.5449724
1182,BTC,2019-06-05,503851536,529314650,432544,908415,529314650,372948,421371532,17213,5.37112833406153,579432,60792325.1739276,7459680720542.3,527.025157232705,1239725,17742883.5449724
1182,BTC,2019-06-06,504253730,529732173,417523,852883,529732173,364526,421736058,13095,5.49008669424123,579589,58149865.2550216,7459680720542.3,550.974358974359,1158709,17744846.0449724
1182,BTC,2019-06-07,504673483,530138235,406062,888602,530138235,350011,422086069,16204,4.15573539411464,579747,58874696.3076493,7459680720542.3,544.191082802548,1187780,17746821.0449724
1182,BTC,2019-06-08,504978870,530468537,330302,661535,530468537,294369,422380438,14778,3.16246169266706,579871,45733470.531162,7459680720542.3,700.560975609756,1143843,17748371.0449724
1182,BTC,2019-06-09,505248714,530775005,306468,610433,530775005,300917,422681355,10781,3.01750956097492,580018,54430542.2574886,7459680720542.3,588.623287671232,927426,17750208.5449724
1182,BTC,2019-06-10,505621438,531184048,409043,833904,531184048,353629,423034984,17229,4.12443599037341,580175,58205394.4148086,7459680720542.3,550.448717948718,1150810,17752171.0449724
1182,BTC,2019-06-11,506018415,531601118,417070,869309,531601118,340449,423375433,20079,6.37532858357087,580318,53869516.6909358,7459680720542.3,594.75352112676,1258056,17753958.5449724
1182,BTC,2019-06-12,506388879,532007148,406030,824197,532007148,328464,423703897,19559,3.9921740649684,580449,49327092.2491415,7459680720542.3,649.523076923077,1260088,17755596.0449724
1182,BTC,2019-06-13,506821480,532464659,457511,926412,532464659,364373,424068270,16503,3.37054892932454,580600,55798426.8945376,7459680720542.3,574.193333333334,1264188,17757483.5449724
1182,BTC,2019-06-14,507347225,532956856,492197,1060602,532956856,364383,424432653,15881,3.47850174823996,580769,63024892.3875831,7411481913588.27,505.071428571428,1290370,17759596.0449724
1182,BTC,2019-06-15,507785583,533384811,427955,893180,533384811,330954,424763607,12063,3.08523960996057,580915,53642174.3689122,7409399249090.25,593.248275862069,1233728,17761421.0449724
1182,BTC,2019-06-16,508120689,533745733,360922,723849,533745733,295254,425058861,15733,4.59052049953586,581045,49377349.2832798,7409399249090.25,644.488372093023,1175121,17763046.0449724
1182,BTC,2019-06-17,508452896,534157305,411572,823860,534157305,321072,425379933,19497,8.44463078801471,581178,48751831.6749007,7409399249090.25,652.757575757576,1233756,17764708.5449724
1182,BTC,2019-06-18,508933561,534648887,491582,982557,534648887,394843,425774776,20004,7.2684565623502,581341,60584138.1081114,7409399249090.25,525.271604938272,1236012,17766746.0449724
1182,BTC,2019-06-19,509390788,535118210,469323,940654,535118210,401032,426175808,21006,4.17219231089389,581518,65300281.3606175,7409399249090.25,487.335227272728,1159557,17768958.5449724
1182,BTC,2019-06-20,509750202,535535397,417187,851976,535535397,330103,426505911,19794,10.2843588104939,581662,52859881.8268381,7409399249090.25,602.027972027972,1245132,17770758.5449724
1182,BTC,2019-06-21,510127551,535970968,435571,867237,535970968,337741,426843652,22072,5.06543954784726,581795,49669545.7649831,7409399249090.25,640.69696969697,1265748,17772421.0449724
1182,BTC,2019-06-22,510512423,536417340,446372,875146,536417340,354075,427197727,17663,5.51369014157769,581936,53130258.7096648,7409399249090.25,598.964285714286,1209288,17774183.5449724
1182,BTC,2019-06-23,510984975,536842500,425160,932668,536842500,380088,427577815,14343,2.63840677561199,582117,66786714.6536345,7409399249090.25,476.488888888889,1179403,17776446.0449724
1182,BTC,2019-06-24,511486646,537294189,451689,1002172,537294189,388342,427966157,24001,4.30348175738934,582294,65184004.8482558,7409399249090.25,488.204545454545,1215810,17778658.5449724
1182,BTC,2019-06-25,511895463,537757867,463678,942990,537757867,361385,428327542,27302,5.41317724330509,582440,53604784.8118422,7409399249090.25,593.662068965517,1245764,17780483.5449724
1182,BTC,2019-06-26,512353185,538288697,530830,1067038,538288697,399624,428727166,28897,4.66965892232591,582605,61018728.9180219,7409399249090.25,521.530487804878,1240848,17782546.0449724
1182,BTC,2019-06-27,512717985,538762482,473785,921095,538762482,361050,429088216,24234,4.63231139957446,582747,55718282.2987781,7868124124773.38,606.503546099291,1233317,17784321.0449724
1182,BTC,2019-06-28,513216779,539262511,500029,1039984,539262511,407094,429495310,23708,3.60514231514466,582910,64901570.2415244,7934713219630.61,525.092592592592,1255488,17786358.5449724
1182,BTC,2019-06-29,513664308,539663046,400535,892393,539663046,356682,429851992,15506,3.86886240043086,583084,68814995.5551941,7934713219630.61,495.231213872832,1148651,17788533.5449724
1182,BTC,2019-06-30,513999739,540008282,345236,710855,540008282,330731,430182723,17572,5.77731043755557,583236,60110261.7832155,7934713219630.61,566.94701986755,1003498,17790433.5449724
1182,BTC,2019-07-01,514369032,540419811,411529,862809,540419811,336862,430519585,23132,6.23565864973016,583379,56273145.2272923,7934713219630.61,605.605633802817,1263033,17792221.0449724
1182,BTC,2019-07-02,514798268,540876644,456833,925034,540876644,373409,430892994,21854,3.93726580974864,583537,62143782.7090991,7934713219630.61,548.394904458598,1239986,17794196.0449724
1182,BTC,2019-07-03,515245832,541326523,449879,928004,541326523,397554,431290548,23943,4.28657764653433,583709,67513538.1979025,7934713219630.61,504.777777777778,1186933,17796346.0449724
1182,BTC,2019-07-04,515652566,541740677,414154,853837,541740677,370704,431661252,22403,3.38256160249603,583876,65753514.8974974,7934713219630.61,518.289156626506,1139688,17798433.5449724
1182,BTC,2019-07-05,516020384,542140654,399977,854082,542140654,378453,432039705,18578,4.13273243532671,584065,74252077.404365,7934713219630.61,458.968085106383,1027819,17800796.0449724
1182,BTC,2019-07-06,516335725,542516427,375773,711108,542516427,348674,432388379,13093,2.02319773300725,584243,70499077.6199371,7934713219630.61,483.401129943503,897182,17803021.0449724
1182,BTC,2019-07-07,516629355,542826806,310379,637489,542826806,313273,432701652,13038,2.2926687106953,584396,61324968.1514017,7934713219630.61,555.717105263158,956807,17804933.5449724
1182,BTC,2019-07-08,517020406,543252783,425977,863272,543252783,378966,433080618,21770,7.02619374664287,584574,71689688.4909505,7934713219630.61,475.372881355932,1064795,17807158.5449723
1182,BTC,2019-07-09,517403164,543678784,426001,846357,543678784,365588,433446206,23570,6.67904232901671,584728,65549233.1271835,8587445349569.64,562.673202614379,1155262,17809083.5449724
1182,BTC,2019-07-10,517740367,544078965,400181,820440,544078965,315664,433761870,24048,7.29463549250244,584857,58039910.5784534,9064159826491.41,670.75,1270236,17810696.0449724
1182,BTC,2019-07-11,518081903,544468651,389686,804123,544468651,325776,434087646,21955,9.08483644552361,584986,58764057.6738095,9064159826491.41,662.484375,1253025,17812308.5449724
1182,BTC,2019-07-12,518519479,544892472,423821,940406,544892472,360899,434448545,16860,6.76167267185675,585150,73998111.0308687,9064159826491.41,526.098159509202,1232422,17814358.5449724
1182,BTC,2019-07-13,518840541,545217126,324654,687624,545217126,304545,434753090,13097,5.16461157822302,585291,65350573.1758953,9064159826491.41,595.714285714286,1048582,17816121.0449724
1182,BTC,2019-07-14,519128653,545514533,297407,625446,545514533,303287,435056377,12148,5.14981956028946,585436,65850969.4817594,9064159826491.41,591.1875,952888,17817933.5449724
1182,BTC,2019-07-15,519480798,545909711,395178,791104,545909711,349111,435405488,19098,5.24912647198364,585582,66187758.2835653,9064159826491.41,588.179310344828,1136103,17819758.5449724
1182,BTC,2019-07-16,519858325,546321310,411599,819215,546321310,363337,435768825,22327,6.76908144274159,585744,74123956.0219036,9064159826491.41,525.204968944099,1098875,17821783.5449724
1182,BTC,2019-07-17,520199727,546706018,384708,768199,546706018,324892,436093717,25129,5.84289824585588,585877,60776029.7411764,9064159826491.41,640.55303030303,1153724,17823446.0449724
1182,BTC,2019-07-18,520495027,547071693,365675,764256,547071693,315745,436409462,25108,15.8651965393482,585998,55156348.4670207,9064159826491.41,705.816666666667,1261034,17824958.5449723
1182,BTC,2019-07-19,520832384,547441898,370205,763382,547441898,299891,436709353,18642,4.37908089783081,586116,53381011.7828849,9064159826491.41,729.290598290598,1262904,17826433.5449724
1182,BTC,2019-07-20,521200435,547783589,341691,750063,547783589,323002,437032355,15640,2.76246874793785,586293,79611079.1100632,9064159826491.41,489.005681818182,1047570,17828646.0449724
1182,BTC,2019-07-21,521464474,548064017,280428,569001,548064017,283934,437316289,11821,3.76482044027228,586442,66768025.1585702,9064159826491.41,583.067567567567,887190,17830508.5449724
1182,BTC,2019-07-22,521789462,548419215,355198,731341,548419215,319399,437635688,18549,18.8891289734976,586600,71413326.7110441,9064159826491.41,545.140127388535,1004485,17832483.5449723
1182,BTC,2019-07-23,522141118,548791614,372399,737011,548791614,320352,437956040,13650,3.77304464565902,586743,63978547.1178075,9033161130737.73,606.408450704226,1103765,17834271.0449724
1182,BTC,2019-07-24,522526209,549130400,338786,741865,549130400,295589,438251629,16115,5.11924688135178,586882,62732151.8494772,9013786945891.68,617.130434782609,1107293,17836008.5449724
1182,BTC,2019-07-25,522926766,549533294,402894,802462,549533294,336536,438588165,16794,5.88727840735351,587032,66954999.8457599,9013786945891.68,578.208053691275,1133330,17837883.5449724
1182,BTC,2019-07-26,523285900,549923833,390539,777937,549923833,319612,438907777,14100,3.07484634061769,587198,74715443.2895868,9013786945891.68,518.151515151515,957042,17839958.5449724
1182,BTC,2019-07-27,523569246,550235419,311586,610543,550235419,283892,439191669,12357,2.14487661715881,587350,68570848.0974428,9013786945891.68,564.582781456953,858096,17841858.5449724
1182,BTC,2019-07-28,523831928,550510205,274786,556661,550510205,272974,439464643,10484,1.76828553878908,587525,79127722.044316,9013786945891.68,489.258620689655,703646,17844046.0449724
1182,BTC,2019-07-29,524205210,550876717,366512,753702,550876717,333619,439798262,13864,7.87517540595781,587693,76047151.88123,9013786945891.68,509.077844311377,960283,17846146.0449723
1182,BTC,2019-07-30,524574142,551260213,383496,770270,551260213,328375,440126637,17294,6.41349986324787,587835,63780601.0462818,9013786945891.68,606.985815602837,1168352,17847921.0449724
1182,BTC,2019-07-31,524972323,551663414,403201,804228,551663414,361337,440487974,19101,4.34416837001962,588006,76712160.9545278,9013786945891.68,504.664705882353,1007365,17850058.5449724
1182,BTC,2019-08-01,525359542,552054279,390865,784671,552054279,335943,440823917,19021,2.99715761620474,588148,63665299.0499886,9013786945891.68,608.085106382979,1150850,17851833.5449724
1182,BTC,2019-08-02,525742677,552446320,392041,803424,552446320,349556,441173473,15757,2.24119342214655,588317,75891932.1409611,9013786945891.68,510.119047619048,1033215,17853946.0449723
1182,BTC,2019-08-03,526055304,552783063,336743,653484,552783063,327588,441501061,12234,1.6963111607133,588490,77318156.3951515,9013786945891.68,500.709302325581,847532,17856108.5449724
1182,BTC,2019-08-04,526350189,553082569,299506,609533,553082569,298805,441799866,12432,1.91308313839166,588657,74480045.7111773,9013786945891.68,519.789156626506,825016,17858196.0449724
1182,BTC,2019-08-05,526736359,553490364,407795,820648,553490364,339136,442139002,21232,6.01134568632319,588800,70406155.1631253,9890230141833.33,603.330985915493,1179503,17859983.5449724
1182,BTC,2019-08-06,527170173,553927858,437494,885062,553927858,368348,442507350,20142,4.57726619860705,588961,80524307.9435208,9985348008059.55,532.59375,1145295,17861996.0449723
1182,BTC,2019-08-07,527567834,554333750,405892,871200,554333750,370909,442878259,16852,2.31498396234694,589114,76207446.2980684,9985348008059.55,562.763157894737,1134389,17863908.5449723
1182,BTC,2019-08-08,528012160,554736370,402620,846611,554736370,336181,443214440,17843,4.29537712526716,589256,70667649.665362,9985348008059.55,606.879432624113,1239356,17865683.5449724
1182,BTC,2019-08-09,528376219,555120639,384269,773649,555120639,341125,443555565,19862,3.95317355175528,589403,72912856.8812474,9985348008059.55,588.191780821918,1156579,17867521.0449723
1182,BTC,2019-08-10,528682838,555440430,319791,639080,555440430,304138,443859703,18122,5.74196148763897,589554,75358887.9525471,9985348008059.55,569.1,910549,17869408.5449724
1182,BTC,2019-08-11,528953192,555734183,293753,573508,555734183,273280,444132983,14170,2.13118345129914,589707,75713546.8458823,9985348008059.55,566.434210526316,791410,17871321.0449723
1182,BTC,2019-08-12,529259864,556053037,318854,683471,556053037,297446,444430429,16224,3.73509109886931,589840,66489512.7394338,9985348008059.55,645.015151515152,1035999,17872983.5449724
1182,BTC,2019-08-13,529740425,556454477,401440,916637,556454477,370747,444801176,19992,3.45990217675444,589997,79390679.2238367,9985348008059.55,540.198717948718,1189568,17874946.0449724
1182,BTC,2019-08-14,530137909,556842146,387669,787817,556842146,359997,445161173,24419,3.97442079789398,590149,76056399.7510508,9985348008059.55,563.880794701987,1139712,17876846.0449724
1182,BTC,2019-08-15,530498505,557219028,376882,740777,557219028,355644,445516817,25645,4.22392618995698,590306,77744836.7773162,9985348008059.55,551.634615384615,1066146,17878808.5449724
1182,BTC,2019-08-16,530821922,557577334,358306,716590,557577334,323625,445840442,16660,3.05680407053163,590453,72875517.8949489,9985348008059.55,588.493150684931,1035984,17880646.0449724
1182,BTC,2019-08-17,531095540,557886130,308796,597735,557886130,288256,446128698,16386,5.56605163562046,590581,64501271.6182931,9985348008059.55,664.897637795275,996770,17882246.0449724
1182,BTC,2019-08-18,531350960,558174094,287964,559206,558174094,276365,446405063,14673,3.49604047379303,590707,64014474.1476737,10016798869143.8,672.064,949509,17883821.0449724
1182,BTC,2019-08-19,531702270,558540525,366431,727138,558540525,330473,446735536,13817,2.64225780168198,590870,82939429.5225332,10183488432890.0,527.345679012345,938905,17885858.5449724
1182,BTC,2019-08-20,532062277,558915244,374719,776189,558915244,333304,447068840,15813,29.2484497555512,591023,77959332.1332298,10183488432890.0,561.032894736842,1077213,17887771.0449724
1182,BTC,2019-08-21,532386808,559292248,377004,791958,559292248,308808,447377648,19509,79.4301648631782,591159,69036996.3063754,10183488432890.0,633.54074074074,1188414,17889471.0449724
1182,BTC,2019-08-22,532751230,559672648,380400,848259,559672648,322453,447700101,12927,36.3470530473266,591300,71428562.7345725,10183488432890.0,612.328571428571,1241886,17891233.5449724
1182,BTC,2019-08-23,533140175,560067918,395270,815080,560067918,340220,448040321,13388,2.00033232679851,591453,77458847.5360656,10183488432890.0,564.657894736842,1095520,17893146.0449724
1182,BTC,2019-08-24,533538114,560385650,317732,726337,560385650,304481,448344802,11505,1.49041369102279,591613,80883729.9198018,10183488432890.0,540.748427672956,977127,17895146.0449724
1182,BTC,2019-08-25,533786615,560666300,280650,546990,560666300,288934,448633736,8136,2.04057134393689,591768,79060207.8252776,10183488432890.0,553.220779220779,804201,17897083.5449724
1182,BTC,2019-08-26,534157487,561045695,379395,771525,561045695,318219,448951955,14086,3.26273889633429,591905,69518307.3671493,10183488432890.0,629.154411764706,1170414,17898796.0449724
1182,BTC,2019-08-27,534533951,561429444,383749,753395,561429444,325984,449277939,15127,2.75737063406087,592040,68075900.1348915,10183488432890.0,642.485074626866,1159739,17900483.5449724
1182,BTC,2019-08-28,534894954,561801133,371689,738073,561801133,341200,449619139,14594,2.60784583843285,592191,77137074.5751837,10183488432890.0,567.013333333333,1038467,17902371.0449724
1182,BTC,2019-08-29,535269431,562183834,382701,761717,562183834,346734,449965873,18062,2.57116889501229,592356,83309999.578013,10183488432890.0,525.0,995517,17904433.5449724
1182,BTC,2019-08-30,535638639,562560077,376243,756677,562560077,349200,450315073,19255,2.40365236531503,592516,81060031.4105586,10183488432890.0,539.572327044025,1005411,17906433.5449724
1182,BTC,2019-08-31,535938056,562888582,328505,636292,562888582,342195,450657268,13938,2.28419673374526,592682,84203307.9766338,10183488432890.0,519.430303030303,874326,17908508.5449724
1182,BTC,2019-09-01,536215744,563184422,295840,591637,563184422,285468,450942736,15616,3.02551265257454,592825,76182714.3246345,10685572378039.8,602.422535211268,885620,17910296.0449724
1182,BTC,2019-09-02,536581668,563556087,371665,750534,563556087,327248,451269984,13377,2.83894133350056,592974,81865057.3367487,10771996663680.4,565.141891891892,1055764,17912158.5449724
1182,BTC,2019-09-03,536979272,563981704,425617,825786,563981704,370631,451640615,18247,2.80743577744188,593138,88011388.9414708,10771996663680.4,525.674846625767,1088154,17914208.5449724
1182,BTC,2019-09-04,537363727,564369508,387804,770403,564369508,324741,451965356,15114,3.72064409929316,593274,72608146.9260104,10771996663680.4,637.192592592592,1177994,17915908.5449724
1182,BTC,2019-09-05,537739068,564764009,394501,762227,564764009,352410,452317766,17529,3.52610706547981,593439,89440680.3346936,10771996663680.4,517.274390243902,1020782,17917971.0449724
1182,BTC,2019-09-06,538128264,565179870,415861,816899,565179870,365531,452683297,21378,3.22462853720658,593597,84683745.9037839,10771996663680.4,546.331210191083,1091438,17919946.0449724
1182,BTC,2019-09-07,538435804,565518635,338765,643202,565518635,314429,452997726,15773,2.00204440466449,593747,80513205.2567874,10771996663680.4,574.630872483221,925035,17921821.0449724
1182,BTC,2019-09-08,538713590,565832997,314362,593894,565832997,288507,453286233,13054,2.4341182521456,593924,95660362.4890521,10771996663680.4,483.642045454545,707172,17924033.5449724
1182,BTC,2019-09-09,539120117,566210747,377750,790664,566210747,316852,453603085,14490,2.76879397566359,594070,78908430.6548605,10771996663680.4,586.31724137931,1089865,17925858.5449724
1182,BTC,2019-09-10,539547701,566610485,399738,832883,566610485,339858,453942943,17729,3.59538263517175,594252,97500583.1190546,10771996663680.4,474.513812154696,957443,17928133.5449724
1182,BTC,2019-09-11,539976675,567010287,399802,821400,567010287,338276,454281219,18412,3.32112351916917,594436,99129638.9035406,10771996663680.4,466.715846994535,953451,17930433.5449724
1182,BTC,2019-09-12,540352215,567418460,408173,775111,567418460,335868,454617087,14212,2.46686748873531,594594,84550671.3051154,10771996663680.4,547.191082802548,979857,17932408.5449724
1182,BTC,2019-09-13,540737249,567800612,382152,783394,567800612,308856,454925943,12794,2.27280713615241,594744,81591237.8868079,10958429712866.3,576.852348993289,1069618,17934283.5449724
1182,BTC,2019-09-14,541070039,568157596,356984,682788,568157596,299894,455225837,13208,2.04909659255827,594899,91520659.3154465,11890594958795.8,558.012987012987,903661,17936221.0449724
1182,BTC,2019-09-15,541346532,568460380,302784,587576,568460380,274146,455499983,12629,1.81863102118667,595046,89313735.7999772,11890594958795.8,571.801369863014,867850,17938058.5449724
1182,BTC,2019-09-16,541748360,568861719,401339,801535,568861719,347341,455847324,15748,2.85924734837353,595209,96690166.1828745,11890594958795.8,528.179012345679,1054939,17940096.0449724
1182,BTC,2019-09-17,542158855,569269889,408170,808713,569269889,343778,456191102,17791,3.33747620268886,595357,88154630.3695103,11890594958795.8,579.319727891157,1157712,17941946.0449724
1182,BTC,2019-09-18,542648538,569688770,418881,887035,569688770,363185,456554287,17868,2.38281614697757,595531,105326001.10506,11890594958795.8,484.872832369942,1069905,17944121.0449724
1182,BTC,2019-09-19,543009070,570081962,393192,758469,570081962,346110,456900397,16800,2.19057429070128,595679,87209417.9137287,11890594958795.8,585.598639455783,1104391,17945971.0449724
1182,BTC,2019-09-20,543369220,570473839,391877,758288,570473839,340929,457241326,17876,2.56381913474853,595830,89560379.1673666,11890594958795.8,570.226666666667,1040262,17947858.5449724
1182,BTC,2019-09-21,543703651,570836090,362251,673285,570836090,336013,457577339,18377,2.16230515216581,595996,97703119.2040406,11890594958795.8,522.703030303031,884734,17949933.5449724
1182,BTC,2019-09-22,543980343,571157002,320912,625449,571157002,318713,457896052,14157,5.36967429446439,596162,99646459.7094709,11890594958795.8,512.509090909091,850795,17952008.5449724
1182,BTC,2019-09-23,544317695,571523526,366524,745122,571523526,288149,458184201,13216,5.15878840122832,596276,67031523.9745291,11890594958795.8,761.876106194691,1243719,17953433.5449724
1182,BTC,2019-09-24,544757417,571941807,418281,863866,571941807,353263,458537464,20310,3.69816753165126,596433,93199454.5117054,11890594958795.8,547.961538461538,1163618,17955396.0449724
1182,BTC,2019-09-25,545173711,572335134,393327,825103,572335134,347747,458885211,24561,4.7366639892628,596589,93207178.566199,11890594958795.8,547.916129032258,1104534,17957346.0449724
1182,BTC,2019-09-26,545562821,572728890,393756,773419,572728890,355775,459240986,16578,3.17634854463998,596760,101934669.238474,12017674556107.6,506.358823529412,970737,17959483.5449724
1182,BTC,2019-09-27,545896949,573089094,360204,721178,573089094,303903,459544889,15406,3.03525956167619,596892,83660912.9487263,12759819404408.8,655.06106870229,1095423,17961133.5449724
1182,BTC,2019-09-28,546216504,573426910,337816,652682,573426910,314433,459859322,11033,2.14158990424253,597051,101229586.180001,12759819404408.8,541.373417721519,887235,17963121.0449724
1182,BTC,2019-09-29,546491808,573736514,309604,581939,573736514,285542,460144864,10541,2.12442875546529,597187,86832693.109964,12759819404408.8,631.133333333333,899054,17964821.0449724
1182,BTC,2019-09-30,546857970,574110494,373980,759048,574110494,311396,460456260,16110,3.55645142266558,597317,83523403.3786944,12759819404408.8,656.139534883721,1150525,17966446.0449724
1182,BTC,2019-10-01,547247604,574513702,403208,792546,574513702,337244,460793504,15387,3.43590993863574,597460,90484477.470372,12759819404408.8,605.661971830986,1120068,17968233.5449724
1182,BTC,2019-10-02,547604512,574895744,382042,734492,574895744,326557,461120061,12289,2.58917588500593,597608,93847324.5682287,12759819404408.8,583.959183673469,1005967,17970083.5449724
1182,BTC,2019-10-03,547956967,575269612,373868,723661,575269612,326514,461446575,16161,2.47314476484705,597755,93578459.5691506,12759819404408.8,585.63698630137,1038093,17971921.0449724
1182,BTC,2019-10-04,548302189,575652621,383009,733685,575652621,337222,461783797,13232,2.13623392775887,597902,94825004.1899179,12759819404408.8,577.938356164384,1086928,17973758.5449724
1182,BTC,2019-10-05,548621165,576000183,347562,658270,576000183,326683,462110480,9951,1.53000561210516,598060,100564203.301081,12759819404408.8,544.955414012739,885488,17975733.5449724
1182,BTC,2019-10-06,548894948,576312609,312426,584930,576312609,277613,462388093,12260,1.92925289216715,598209,94266114.71875,12759819404408.8,581.364864864865,813034,17977596.0449724
1182,BTC,2019-10-07,549279213,576698285,385676,760241,576698285,328803,462716896,12378,2.12325635866461,598364,98334573.2633409,12759819404408.8,557.311688311688,1005810,17979533.5449724
1182,BTC,2019-10-08,549649338,577082084,383799,743943,577082084,336354,463053250,14956,2.5368639184046,598526,102923047.980369,12759819404408.8,532.465838509317,966500,17981558.5449724
1182,BTC,2019-10-09,549990231,577453368,371284,720117,577453368,311049,463364299,18470,2.86163716724256,598664,87425470.3144874,12759819404408.8,626.85401459854,1032391,17983283.5449724
1182,BTC,2019-10-10,550363879,577849029,395661,756672,577849029,345048,463709347,17299,2.34559409512442,598826,103887749.259995,12874760266706.5,532.273291925466,968209,17985308.5449724
1182,BTC,2019-10-11,550727504,578238506,389477,751493,578238506,345425,464054772,12993,2.16793615178479,598982,101167619.400187,13008091666971.9,552.245161290322,1017074,17987258.5449724
1182,BTC,2019-10-12,551014401,578566480,327974,614227,578566480,301693,464356465,7884,1.58135132971736,599115,86725049.7986489,13008091666971.9,644.212121212121,971500,17988921.0449723
1182,BTC,2019-10-13,551273596,578870860,304380,564137,578870860,279487,464635952,6258,1.50969528844866,599257,92032049.2700014,13008091666971.9,607.063829787234,817165,17990696.0449724
1182,BTC,2019-10-14,551620603,579239811,368951,714529,579239811,304466,464940418,9389,2.69721221564552,599392,87485567.9442814,13008091666971.9,638.611940298507,1059371,17992383.5449724
1182,BTC,2019-10-15,551977910,579623375,383564,732096,579623375,339698,465280116,14052,2.19791908471151,599545,99704576.5740104,13008091666971.9,560.348684210527,995947,17994296.0449724
1182,BTC,2019-10-16,552355994,580012500,389125,763139,580012500,338473,465618589,16042,3.08639906168722,599688,92162551.7548361,13008091666971.9,606.204225352113,1116763,17996083.5449724
1182,BTC,2019-10-17,552747749,580393652,381152,751155,580393652,334105,465952694,16163,3.05768920160222,599838,97226464.7939634,13008091666971.9,574.630872483221,1098597,17997958.5449724
1182,BTC,2019-10-18,553087813,580768194,374542,699255,580768194,339390,466292084,14380,3.01016009309741,599998,106046810.779774,13008091666971.9,526.836477987422,942360,17999958.5449724
1182,BTC,2019-10-19,553397979,581127771,359577,654735,581127771,304736,466596820,8758,2.7799527121011,600140,92460889.0869028,13008091666971.9,604.248226950355,968948,18001733.5449724
1182,BTC,2019-10-20,553681841,581449232,321461,593306,581449232,289796,466886616,8686,2.58683417682187,600286,96851568.5821707,13008091666971.9,576.855172413794,845296,18003558.5449724
1182,BTC,2019-10-21,554054648,581846763,397531,763038,581846763,351791,467238407,9541,2.55499316607983,600445,103077534.158858,13008091666971.9,542.012658227848,1009093,18005546.0449724
1182,BTC,2019-10-22,554426216,582240899,394136,749792,582240899,341464,467579871,11122,3.34244670452455,600614,110785113.289501,13008091666971.9,504.303571428571,959074,18007658.5449724
1182,BTC,2019-10-23,554807193,582630484,389585,768722,582630484,349320,467929191,14589,3.82035250349519,600782,109865482.762909,13069108485875.7,510.910179640719,978411,18009758.5449724
1182,BTC,2019-10-24,555164515,582994236,363752,732414,582994236,303843,468233034,14553,3.29369794578835,600915,90352561.8438353,13691480038694.5,650.833333333333,1091473,18011421.0449724
1182,BTC,2019-10-25,555562565,583396473,402237,806794,583396473,328598,468561632,15610,4.10519978258699,601053,94164115.282614,13691480038694.5,624.489051094891,1190200,18013146.0449724
1182,BTC,2019-10-26,555941754,583774165,377692,783057,583774165,305722,468867354,16370,3.28667912650205,601193,96811794.3977744,13691480038694.5,607.410071942446,1225023,18014896.0449724
1182,BTC,2019-10-27,556219717,584083421,309256,608889,584083421,256253,469123607,13766,2.66923918792939,601308,77787286.2149381,13691480038694.5,755.964912280702,1102331,18016333.5449724
1182,BTC,2019-10-28,556599481,584467180,383759,770522,584467180,309611,469433218,10918,6.27921420720378,601442,91443656.42835,13691480038694.5,643.067669172932,1200985,18018008.5449724
1182,BTC,2019-10-29,556962925,584844019,376839,745317,584844019,307953,469741171,11977,4.87662373983553,601575,94180744.3520091,13691480038694.5,624.378787878788,1159250,18019671.0449724
1182,BTC,2019-10-30,557323041,585229386,385367,745381,585229386,314163,470055334,10958,6.44210619848722,601709,91293152.0970703,13691480038694.5,644.127819548872,1099223,18021346.0449724
1182,BTC,2019-10-31,557673823,585586617,357231,721479,585586617,293779,470349113,11468,4.81953821913084,601841,89242170.1691829,13691480038694.5,658.931297709923,1080918,18022996.0449724
1182,BTC,2019-11-01,558079688,585988006,401389,811229,585988006,316187,470665300,15575,3.96395700948458,601971,88631294.2352176,13691480038694.5,663.472868217054,1241092,18024621.0449724
1182,BTC,2019-11-02,558387614,586328000,339994,649866,586328000,284443,470949743,13165,2.97389681427137,602105,93625343.2334221,13691480038694.5,628.082706766918,989604,18026296.0449724
1182,BTC,2019-11-03,558706001,586671976,343976,650360,586671976,294367,471244110,15261,2.80998336314794,602243,94340545.5003693,13691480038694.5,623.321167883212,969651,18028021.0449724
1182,BTC,2019-11-04,559071762,587066649,394673,760820,587066649,310979,471555089,16051,3.05350556279572,602375,89896187.8472186,13691480038694.5,654.137404580153,1165071,18029671.0449724
1182,BTC,2019-11-05,559488060,587490599,423950,811465,587490599,332839,471887928,17715,3.48921048551594,602519,98819409.3307976,13691480038694.5,595.06993006993,1137513,18031471.0449724
1182,BTC,2019-11-06,559931940,587883227,392628,854864,587883227,314698,472202626,12481,4.47847262735743,602651,90672851.6326168,13691480038694.5,648.534351145038,1273832,18033121.0449724
1182,BTC,2019-11-07,560347890,588283722,400495,803598,588283722,324487,472527113,15065,4.2346034193147,602786,91399245.6759976,13669891710443.3,642.365671641791,1178781,18034808.5449724
1182,BTC,2019-11-08,560705302,588668091,384369,740142,588668091,311441,472838554,18543,4.28225773017127,602914,83929269.3884638,12720005267390.5,650.929133858268,1165534,18036408.5449724
1182,BTC,2019-11-09,561086244,589050652,382561,747618,589050652,306163,473144717,15943,3.42312151722537,603058,92677908.179033,12720005267390.5,589.482517482517,1062813,18038208.5449724
1182,BTC,2019-11-10,561375348,589365689,315037,608540,589365689,299712,473444429,9401,2.28656564004868,603224,104578879.457102,12720005267390.5,522.4,829142,18040283.5449724
1182,BTC,2019-11-11,561722681,589731569,365880,721190,589731569,326707,473771136,9095,2.44021886745286,603375,98694491.2113221,12720005267390.5,553.546666666667,1003629,18042171.0449724
1182,BTC,2019-11-12,562046226,590085355,353786,697597,590085355,301382,474072518,10832,3.38408769418661,603510,85118350.9081256,12720005267390.5,641.835820895523,1034111,18043858.5449724
1182,BTC,2019-11-13,562429255,590478855,393500,778776,590478855,318945,474391463,11830,4.17350266998646,603645,87730707.5103871,12720005267390.5,622.723880597015,1155403,18045546.0449724
1182,BTC,2019-11-14,562822073,590867270,388415,770964,590867270,350023,474741486,12701,3.47674343491922,603814,108297075.086366,12720005267390.5,504.464285714286,981337,18047658.5449724
1182,BTC,2019-11-15,563187742,591282867,415597,783649,591282867,325145,475066631,12721,3.93821188393858,603972,100186011.945116,12720005267390.5,545.305732484077,1113353,18049633.5449724
1182,BTC,2019-11-16,563521644,591643008,360141,703108,591643008,283468,475350099,9431,2.45206668861293,604120,93080645.0512098,12720005267390.5,586.931972789115,1171504,18051483.5449724
1182,BTC,2019-11-17,563820191,591955228,312220,618290,591955228,264370,475614469,8283,2.39108622379502,604274,97336761.0003454,12720005267390.5,561.267973856209,1108507,18053408.5449724
1182,BTC,2019-11-18,564154662,592322179,366951,706583,592322179,304671,475919140,12223,4.36758770088669,604414,89153749.5021685,12720005267390.5,612.78417266187,1019047,18055158.5449724
1182,BTC,2019-11-19,564612174,592728527,406348,850199,592728527,327630,476246770,11283,2.92045051839325,604561,92807793.0715923,12720005267390.5,588.657534246575,1143817,18056996.0449724
1182,BTC,2019-11-20,564955451,593105173,376646,721713,593105173,321086,476567856,8689,2.49328811635014,604703,90657921.5314172,12720005267390.5,602.617021276595,1025924,18058771.0449724
1182,BTC,2019-11-21,565341953,593499512,394339,810934,593499512,323954,476891810,16221,4.99000910115242,604840,87754423.1776282,12795789637885.3,626.264705882353,1214479,18060483.5449724
1182,BTC,2019-11-22,565709618,593893896,394384,823718,593893896,310539,477202349,15285,5.06636807288312,604972,86493474.0839243,12973235968799.8,644.206106870229,1250728,18062133.5449724
1182,BTC,2019-11-23,566065426,594277263,383367,692979,594277263,306424,477508773,13180,3.29882838564094,605145,113177710.695653,12973235968799.8,492.31976744186,841518,18064296.0449724
1182,BTC,2019-11-24,566328972,594596317,319054,579123,594596317,267368,477776141,7281,3.08347833147411,605276,84584363.6186131,12973235968799.8,658.746153846154,875593,18065933.5449724
1182,BTC,2019-11-25,566640619,594941840,345523,682392,594941840,279470,478055611,12286,4.71079473168362,605401,81423998.6088204,12973235968799.8,684.314516129032,1076081,18067496.0449724
1182,BTC,2019-11-26,567039972,595357366,415526,799457,595357366,321310,478376921,11103,3.65008919875587,605523,78729442.3995001,12973235968799.8,707.735537190083,1254087,18069021.0449724
1182,BTC,2019-11-27,567493380,595767060,409694,845211,595767060,317597,478694518,10164,3.19449528071978,605662,89385614.9549132,12973235968799.8,623.36231884058,1185653,18070758.5449724
1182,BTC,2019-11-28,567843913,596152282,385222,722124,596152282,309623,479004141,9055,2.47038497385149,605825,108075563.294313,12973235968799.8,515.561728395062,873442,18072796.0449724
1182,BTC,2019-11-29,568198419,596536237,383955,750134,596536237,311290,479315431,13651,3.18522314775255,605961,87613553.720807,12973235968799.8,635.97037037037,1055517,18074496.0449724
1182,BTC,2019-11-30,568528377,596885002,348765,693647,596885002,277458,479592889,10903,2.70619412616367,606087,83818150.406286,12973235968799.8,664.768,1070562,18076071.0449724
1182,BTC,2019-12-01,568829648,597235694,350692,626684,597235694,274621,479867510,8012,2.47717657874649,606226,93308919.6413103,12973235968799.8,597.152173913043,870622,18077808.5449724
1182,BTC,2019-12-02,569203718,597637678,401984,754563,597637678,314730,480182240,7233,2.75070339587796,606371,94385604.8905077,12973235968799.8,590.340277777778,1019306,18079621.0449724
1182,BTC,2019-12-03,569595256,598057514,419836,772416,598057514,336512,480518752,7633,2.53959119378498,606529,103049569.457986,12973235968799.8,540.707006369427,961583,18081596.0449724
1182,BTC,2019-12-04,569981559,598473283,415769,782018,598473283,337284,480856036,10074,6.90687350026037,606696,107880491.949211,12973235968799.8,516.493975903614,934351,18083683.5449724
1182,BTC,2019-12-05,570371626,598870331,397048,750875,598870331,311468,481167504,9747,2.88312461468767,606841,94309777.077793,12955951549096.0,590.027777777778,1018665,18085496.0449724
1182,BTC,2019-12-06,570780783,599268338,398007,764220,599268338,315386,481482890,10541,7.25771186349242,606986,92427420.1095076,12876842089682.5,598.368055555556,1059103,18087308.5449724
1182,BTC,2019-12-07,571141480,599619167,350829,680070,599619167,285284,481768174,7787,3.35474423988688,607141,99834311.8230161,12876842089682.5,553.974025974026,865809,18089246.0449724
1182,BTC,2019-12-08,571450484,599946998,327831,610741,599946998,278853,482047027,6484,2.62210054491976,607289,94650679.9158096,12876842089682.5,584.312925170068,835227,18091096.0449724
1182,BTC,2019-12-09,571872954,600337703,390705,802840,600337703,313629,482360656,9847,3.79542963096359,607437,94501051.9666227,12876842089682.5,585.238095238095,1089033,18092946.0449724
1182,BTC,2019-12-10,572325382,600743442,405739,821791,600743442,320064,482680720,10986,3.58982793263632,607585,95070168.9842549,12876842089682.5,581.734693877551,1106342,18094796.0449724
1182,BTC,2019-12-11,572772082,601123169,379727,808846,601123169,291248,482971968,10775,4.14753293650923,607717,84473464.7390427,12876842089682.5,654.709923664122,1195490,18096446.0449724
1182,BTC,2019-12-12,573156802,601519904,396735,741807,601519904,311795,483283763,11316,2.68038320510794,607850,85375121.5184883,12876842089682.5,647.795454545454,1095938,18098108.5449724
1182,BTC,2019-12-13,573548044,601932472,412568,749138,601932472,322888,483606651,9655,2.23086412107331,608002,97721105.5979162,12876842089682.5,565.953642384106,990434,18100008.5449724
1182,BTC,2019-12-14,573880333,602286703,354231,650993,602286703,293496,483900147,9010,2.48890261179348,608153,98337411.2165738,12876842089682.5,562.406666666667,902877,18101896.0449724
1182,BTC,2019-12-15,574244195,602611629,324926,661886,602611629,263441,484163588,8631,2.469095432566,608277,80190860.840103,12876842089682.5,689.674796747967,1120130,18103446.0449724
1182,BTC,2019-12-16,574679023,603012446,400817,811549,603012446,327085,484490673,7027,2.34696210701142,608434,102482283.981458,12876842089682.5,539.660256410256,1038496,18105408.5449724
1182,BTC,2019-12-17,575218456,603423564,411118,907264,603423564,319254,484809927,9166,5.56735765561807,608575,90307520.4825393,12876842089682.5,612.414285714286,1314409,18107171.0449724
1182,BTC,2019-12-18,575595152,603827067,403503,759545,603827067,314249,485124176,12329,3.70643319400625,608709,85579538.1272511,12876842089682.5,646.248120300752,1152717,18108846.0449724
1182,BTC,2019-12-19,575979611,604223217,396150,747228,604223217,319555,485443731,11282,3.14305705907769,608866,102286399.275997,12892837609391.0,541.365384615385,1013370,18110808.5449724
1182,BTC,2019-12-20,576343784,604628724,405507,731570,604628724,332657,485776388,11552,3.02448231915601,609022,100295958.174057,12948593420946.4,554.496774193548,961809,18112758.5449724
1182,BTC,2019-12-21,576658728,604988410,359686,645839,604988410,311118,486087506,6976,2.17700955621722,609198,113307244.075593,12948593420946.4,490.822857142857,756153,18114958.5449723
1182,BTC,2019-12-22,576964119,605312145,323735,608464,605312145,281070,486368576,9223,2.70071242764753,609367,108785086.343802,12948593420946.4,511.22619047619,740650,18117071.0449724
1182,BTC,2019-12-23,577333396,605690387,378242,724032,605690387,304845,486673421,11562,3.11469504106201,609510,91641997.6866282,12948593420946.4,606.859154929577,1037491,18118858.5449724
1182,BTC,2019-12-24,577675294,606049052,358665,684733,606049052,290436,486963857,8350,2.51608277655621,609635,81049648.8658226,12948593420946.4,686.16935483871,1111658,18120421.0449724
1182,BTC,2019-12-25,577954661,606338959,289907,560851,606338959,244666,487208523,7409,2.43907320284629,609763,82362930.3538612,12948593420946.4,675.228346456693,889324,18122021.0449724
1182,BTC,2019-12-26,578291548,606690851,351892,659669,606690851,296063,487504586,9442,2.37019267370448,609930,107915980.165049,12948593420946.4,515.343373493976,837857,18124108.5449724
1182,BTC,2019-12-27,578662674,607088969,398118,725751,607088969,322204,487826790,8023,2.69468286361994,610075,93481639.3424829,12948593420946.4,594.916666666667,1017240,18125921.0449724
1182,BTC,2019-12-28,578977887,607447448,358479,651017,607447448,298287,488125077,6750,2.29857581249937,610224,97053783.5353271,12948593420946.4,573.02027027027,889533,18127783.5449724
1182,BTC,2019-12-29,579274931,607778929,331481,606660,607778929,279925,488405002,5305,2.00881287795795,610379,101897952.788977,12948593420946.4,545.779220779221,787269,18129721.0449724
1182,BTC,2019-12-30,579662616,608179457,400528,750636,608179457,324497,488729499,9037,3.04686763712185,610545,108164865.975615,12948593420946.4,514.157575757576,944622,18131796.0449724
1182,BTC,2019-12-31,580022119,608537222,357765,686605,608537222,293447,489022946,9099,2.46996697832508,610690,98435107.9709407,12948593420946.4,564.979166666667,982280,18133608.5449724
1182,BTC,2020-01-01,580286790,608826445,289223,543325,608826445,251735,489274681,5006,1.77009703053695,610864,112382825.815777,13031658000898.6,498.034682080925,643639,18135783.5449724
1182,BTC,2020-01-02,580655331,609173295,346850,696061,609173295,295567,489570248,8494,2.35284499566995,611005,97321512.3679073,13798783827516.4,608.964285714286,1012365,18137546.0449724
1182,BTC,2020-01-03,581046938,609565290,391995,733099,609565290,316517,489886765,10439,3.21887532290585,611174,115510866.447528,13798783827516.4,513.071428571429,910629,18139658.5449724
1182,BTC,2020-01-04,581372842,609918451,353161,638070,609918451,287215,490173980,10804,2.29660719015125,611342,115893551.745285,13798783827516.4,511.377245508982,794683,18141758.5449724
1182,BTC,2020-01-05,581674222,610259246,340795,617940,610259246,287779,490461759,9251,1.9643425749285,611505,112677010.289275,13798783827516.4,525.975308641976,790838,18143796.0449724
1182,BTC,2020-01-06,582051204,610634194,374948,738884,610634194,299146,490760905,10566,3.66924951727725,611640,92867375.1428802,13798783827516.4,638.171641791044,1127610,18145483.5449724
1182,BTC,2020-01-07,582458105,611058603,424409,793752,611058603,344079,491104984,11790,2.28683123647107,611816,120234545.80521,13798783827516.4,492.914285714286,948405,18147683.5449724
1182,BTC,2020-01-08,582828333,611461037,402434,762152,611461037,318019,491423003,12869,2.83378302746066,611958,98295682.5684271,13798783827516.4,602.929078014184,1063490,18149458.5449724
1182,BTC,2020-01-09,583245940,611864702,403665,798148,611864702,322057,491745060,11001,3.75601698166514,612115,108785940.686764,13798783827516.4,544.788461538462,1044869,18151421.0449724
1182,BTC,2020-01-10,583648564,612309011,444309,804292,612309011,330734,492075794,17076,2.74235886957213,612264,102306737.493859,13798783827516.4,579.290540540541,1120475,18153283.5449724
1182,BTC,2020-01-11,583976448,612693938,384927,679792,612693938,309070,492384864,13617,1.92813740139962,612427,111583541.865446,13798783827516.4,531.12962962963,843840,18155321.0449724
1182,BTC,2020-01-12,584278826,613034500,340562,614378,613034500,283136,492668000,9156,1.77210054573491,612578,103706195.559589,13798783827516.4,571.473333333333,825020,18157208.5449724
1182,BTC,2020-01-13,584630442,613402515,368015,700552,613402515,291597,492959597,9893,2.36474309405344,612721,98356488.0550407,13798783827516.4,602.556338028169,981562,18158996.0449723
1182,BTC,2020-01-14,585081167,613854659,452144,867310,613854659,346953,493306550,14423,3.60251730209005,612866,99439388.9248117,13819009697340.7,596.868055555556,1219665,18160808.5449724
1182,BTC,2020-01-15,585473826,614277485,422826,787490,614277485,332658,493639208,13179,4.8141998770785,613017,110496469.048307,14776367535688.6,574.353333333333,1065171,18162696.0449724
1182,BTC,2020-01-16,585855561,614688391,410906,761525,614688391,325947,493965155,11523,2.72483839692895,613176,117264816.050456,14776367535688.6,541.202531645569,983502,18164683.5449724
1182,BTC,2020-01-17,586254145,615105705,417314,774012,615105705,323992,494289147,12579,3.44660339446104,613335,116880726.655179,14776367535688.6,542.981012658228,968857,18166671.0449724
1182,BTC,2020-01-18,586561943,615467216,361511,652540,615467216,287237,494576384,10273,1.7604056155144,613467,96767572.6805459,14776367535688.6,655.839694656489,955057,18168321.0449724
1182,BTC,2020-01-19,586891243,615823636,356420,653912,615823636,283960,494860344,10640,2.22606242896288,613617,110276951.131784,14776367535688.6,575.496644295302,874760,18170196.0449724
1182,BTC,2020-01-20,587275580,616215046,391410,753896,616215046,313661,495174005,8754,3.12225141651908,613769,112522207.374284,14776367535688.6,564.013245033112,991580,18172096.0449724
1182,BTC,2020-01-21,587680185,616616058,401012,771496,616616058,315210,495489215,10539,2.11959902543771,613922,113069569.578125,14776367535688.6,561.282894736842,999786,18174008.5449724
1182,BTC,2020-01-22,588099048,617019697,403639,801211,617019697,328586,495817801,8824,2.7313044950018,614078,115127128.581482,14776367535688.6,551.251612903226,1058771,18175958.5449724
1182,BTC,2020-01-23,588511860,617416626,396929,785637,617416626,329918,496147719,9314,2.62934483805082,614237,116799040.43604,14776367535688.6,543.360759493671,1039634,18177946.0449724
1182,BTC,2020-01-24,588902973,617816103,399477,747701,617816103,313887,496461606,12272,2.20745630876666,614389,112870762.084241,14776367535688.6,562.271523178808,1032869,18179846.0449724
1182,BTC,2020-01-25,589261746,618163199,347096,667450,618163199,285584,496747190,9685,1.7105081121413,614553,120241706.540262,14776367535688.6,527.803680981595,853311,18181896.0449724
1182,BTC,2020-01-26,589562454,618485107,321908,589726,618485107,261247,497008437,9094,2.21106251249212,614696,106599126.749032,14776367535688.6,595.352112676057,825554,18183683.5449723
1182,BTC,2020-01-27,589928879,618849949,364842,714325,618849949,279240,497287677,11715,5.4041430194851,614825,96593228.943159,14776367535688.6,657.0234375,1055952,18185296.0449724
1182,BTC,2020-01-28,590376436,619284302,434353,836582,619284302,340052,497627729,11297,3.0890280166791,614967,109105205.863742,15203806713070.4,598.503546099291,1204786,18187071.0449723
1182,BTC,2020-01-29,590785740,619710836,426534,792832,619710836,340562,497968291,11252,2.62420954369985,615127,123384024.378924,15466098935554.7,538.37106918239,1004575,18189071.0449724
1182,BTC,2020-01-30,591189123,620132694,421858,779424,620132694,332558,498300849,11751,4.37629665513589,615283,120173329.065685,15466098935554.7,552.754838709678,1007421,18191021.0449723
1182,BTC,2020-01-31,591602178,620556012,423318,788227,620556012,334434,498635283,16096,3.60093975161697,615427,111298272.286803,15466098935554.7,596.832167832168,1109039,18192821.0449724
1182,BTC,2020-02-01,591976547,620942891,386879,735593,620942891,303724,498939007,12788,2.69425311159441,615578,116736864.924153,15466098935554.7,569.026666666667,962483,18194708.5449724
1182,BTC,2020-02-02,592377566,621318818,375927,742165,621318818,290879,499229886,15112,2.37889765708917,615721,110338966.81059,15466098935554.7,602.021126760563,1012892,18196496.0449724
1182,BTC,2020-02-03,592857611,621742872,424054,880626,621742872,331012,499560898,10554,4.83258013026546,615869,113792861.070975,15466098935554.7,583.748299319728,1190776,18198346.0449724
1182,BTC,2020-02-04,593256433,622152404,409532,781460,622152404,309190,499870088,10915,2.90206775182739,616001,101932281.921575,15466098935554.7,651.671755725191,1194789,18199996.0449724
1182,BTC,2020-02-05,593704461,622610597,458193,854413,622610597,368604,500238692,11733,2.3023324316528,616160,122651008.890108,15466098935554.7,541.588607594937,1084759,18201983.5449723
1182,BTC,2020-02-06,594079040,623012391,401794,762755,623012391,315370,500554062,14802,4.97676534425548,616295,104092246.032576,15466098935554.7,638.149253731343,1136838,18203671.0449723
1182,BTC,2020-02-07,594545798,623453889,441498,881461,623453889,334938,500889000,13696,4.95980215665407,616434,107751389.369693,15466098935554.7,616.478260869565,1283195,18205408.5449724
1182,BTC,2020-02-08,594917523,623843995,390106,741496,623843995,318363,501207363,11851,2.46551328420938,616573,106371019.276814,15466098935554.7,624.478260869565,1116522,18207146.0449724
1182,BTC,2020-02-09,595267420,624224075,380080,705457,624224075,317070,501524433,11070,1.80435280222017,616726,117087555.193325,15466098935554.7,567.322368421052,951914,18209058.5449724
1182,BTC,2020-02-10,595602855,624602257,378182,721478,624602257,298104,501822537,15990,3.509977988085,616848,93983852.9029574,15466098935554.7,706.785123966942,1199867,18210583.5449723
1182,BTC,2020-02-11,596079008,625074291,472034,906170,625074291,365583,502188120,13596,2.79170122945394,616996,114443186.713447,15521134947902.3,582.496598639456,1258712,18212433.5449723
1182,BTC,2020-02-12,596490549,625517832,443541,826232,625517832,344615,502532735,16998,3.19270429110729,617138,110226070.499639,15546745765529.4,605.780141843972,1147974,18214208.5449724
1182,BTC,2020-02-13,596929138,625961948,444116,842953,625961948,340081,502872816,16492,3.14464365664568,617279,108973550.395231,15546745765529.4,612.742857142857,1229481,18215971.0449724
1182,BTC,2020-02-14,597294232,626374842,412894,743762,626374842,326078,503198894,17897,3.21327315881988,617414,103863749.862113,15546745765529.4,642.888059701492,1090330,18217658.5449724
1182,BTC,2020-02-15,597679525,626788244,413402,771499,626788244,322721,503521615,15151,2.69443614064951,617556,110946969.263807,15546745765529.4,601.843971631206,1099610,18219433.5449724
1182,BTC,2020-02-16,598018233,627140803,352559,659491,627140803,292236,503813851,11595,3.29653574183211,617698,113171456.530997,15546745765529.4,590.014184397163,934766,18221208.5449724
1182,BTC,2020-02-17,598423484,627566073,425270,793229,627566073,341491,504155342,13597,3.81041256461728,617855,121021369.098654,15546745765529.4,551.743589743589,1024710,18223171.0449724
1182,BTC,2020-02-18,598835902,627985112,419039,797723,627985112,331050,504486392,12021,3.17262834526591,618005,115660798.985167,15546745765529.4,577.315436241611,1122872,18225046.0449724
1182,BTC,2020-02-19,599251533,628408468,423356,806844,628408468,334805,504821197,15308,4.10220780879712,618146,109345752.200259,15546745765529.4,610.657142857143,1166272,18226808.5449723
1182,BTC,2020-02-20,599653318,628816996,408528,780227,628816996,316626,505137823,14869,3.29717687941035,618272,97668978.6535127,15546745765529.4,683.664,1248826,18228383.5449723
1182,BTC,2020-02-21,600060614,629240640,423644,788126,629240640,338484,505476307,12736,2.44189306278805,618426,119682676.950748,15546745765529.4,557.915032679738,1067097,18230308.5449723
1182,BTC,2020-02-22,600399902,629633447,392807,693755,629633447,304597,505780904,10514,1.89875660911818,618574,114684259.469315,15546745765529.4,582.231292517006,944377,18232158.5449724
1182,BTC,2020-02-23,600710442,629979593,346146,626125,629979593,285579,506066483,12815,2.34219819581181,618716,111340584.339247,15546745765529.4,599.716312056737,909322,18233933.5449724
1182,BTC,2020-02-24,601109528,630391603,412010,776140,630391603,328890,506395373,14152,2.4756408748037,618857,110377328.080296,15546745765529.4,604.95,1141280,18235696.0449723
1182,BTC,2020-02-25,601483176,630807529,415926,753553,630807529,334593,506729966,12678,2.61379481303207,619001,114989955.611362,15509350562256.6,579.286713286713,1064563,18237496.0449723
1182,BTC,2020-02-26,601874701,631228566,421037,787332,631228566,329967,507059933,14088,2.66815296667546,619137,106619859.775774,15486913440292.9,623.859259259259,1163531,18239196.0449724
1182,BTC,2020-02-27,602287204,631651546,422980,795263,631651546,338781,507398714,12889,2.91411008284502,619284,119944480.508095,15486913440292.9,554.554794520548,1102625,18241033.5449723
1182,BTC,2020-02-28,602713000,632107373,455827,818281,632107373,368590,507767304,11127,2.75472715882723,619442,122313197.841394,15486913440292.9,543.815286624204,1082665,18243008.5449723
1182,BTC,2020-02-29,603050032,632491121,383748,691341,632491121,307527,508074831,9251,2.08087649472303,619581,106969719.154906,15486913440292.9,621.81884057971,989318,18244746.0449724
1182,BTC,2020-03-01,603401019,632875365,384244,693012,632875365,309849,508384680,7423,1.82824842084406,619758,137443832.892271,15486913440292.9,483.948863636364,829612,18246958.5449716
1182,BTC,2020-03-02,603830024,633318993,443628,838460,633318993,342821,508727501,13943,2.40310660207624,619907,114950215.294512,15486913440292.9,578.648648648648,1116271,18248821.0449716
1182,BTC,2020-03-03,604276640,633756635,437642,854329,633756635,342324,509069825,13604,2.31134816389567,620060,117867047.31738,15486913440292.9,564.328947368421,1144225,18250733.5449716
1182,BTC,2020-03-04,604716927,634217958,461323,891259,634217958,358745,509428570,15945,2.84117139228608,620227,128437234.342365,15486913440292.9,517.885542168675,1226066,18252821.0449716
1182,BTC,2020-03-05,605128030,634662580,444622,806481,634662580,349529,509778099,13612,2.4495885095726,620390,125586320.274709,15486913440292.9,529.641975308642,999121,18254858.5449716
1182,BTC,2020-03-06,605550374,635103917,441337,818398,635103917,338383,510116482,14787,2.80520880829451,620545,118979617.142592,15486913440292.9,559.051948051948,1073488,18256796.0449716
1182,BTC,2020-03-07,605889880,635491980,388063,695748,635491980,313312,510429794,15031,1.95607611545482,620702,124095132.948543,15486913440292.9,536.006410256411,909622,18258758.5449716
1182,BTC,2020-03-08,606207821,635856376,364396,660606,635856376,302694,510732488,10675,2.03969526579232,620860,121478008.96285,15486913440292.9,547.554140127388,869396,18260733.5449717
1182,BTC,2020-03-09,606620769,636287755,431379,826066,636287755,348211,511080699,14777,3.52317221586076,621010,121434942.90677,16076772598590.7,568.610738255033,1147879,18262608.5449716
1182,BTC,2020-03-10,607037645,636715897,428142,826647,636715897,329698,511410397,14105,3.26198496161466,621142,108776661.595771,16552923967337.2,653.580152671756,1299547,18264258.5449716
1182,BTC,2020-03-11,607386728,637092950,377053,727804,637092950,287492,511697889,11890,5.89429215159382,621261,98759473.9768177,16552923967337.2,719.872881355933,1208308,18265746.0449716
1182,BTC,2020-03-12,607833141,637548060,455110,928287,637548060,349978,512047867,13692,6.71809832636117,621412,123956946.495254,16552923967337.2,573.54,1235116,18267633.5449716
1182,BTC,2020-03-13,608180602,637926969,378909,790528,637926969,276798,512324665,12088,8.48622029418027,621537,103397714.280062,16552923967337.2,687.580645161291,1296698,18269196.0449716
1182,BTC,2020-03-14,608568840,638288260,361291,778463,638288260,279828,512604493,7468,4.0772760921098,621665,107562029.982569,16552923967337.2,660.96062992126,1274480,18270796.0449716
1182,BTC,2020-03-15,608903850,638584275,296015,655029,638584275,223230,512827723,6140,3.86579236414389,621784,99926429.2754372,16552923967337.2,711.466101694916,1113644,18272283.5449716
1182,BTC,2020-03-16,609237861,638957553,373278,738358,638957553,270399,513098122,9177,5.93449134444133,621903,97574043.2552983,16552923967337.2,728.618644067797,1193453,18273771.0449716
1182,BTC,2020-03-17,609602027,639339761,382208,767792,639339761,278326,513376448,9222,5.3817134900951,622026,100659191.86385,16552923967337.2,706.286885245902,1231597,18275308.5449716
1182,BTC,2020-03-18,609873023,639671662,331901,637093,639671662,231254,513607702,7867,4.96410568288756,622126,83563850.5728081,16552923967337.2,850.777777777778,1164992,18276558.5449716
1182,BTC,2020-03-19,610189130,640039363,367701,721003,640039363,265689,513873391,9670,4.96871349906669,622233,90535480.3316529,16552923967337.2,785.264150943396,1306641,18277896.0449716
1182,BTC,2020-03-20,610511242,640435656,396293,741538,640435656,284594,514157985,10682,4.73652428153967,622342,92807871.7549666,16552923967337.2,766.037037037037,1264478,18279258.5449716
1182,BTC,2020-03-21,610831423,640771922,336266,668556,640771922,245896,514403881,5849,2.8636084693505,622466,102765149.335729,16552923967337.2,691.813008130081,1108333,18280808.5449716
1182,BTC,2020-03-22,611085487,641061303,289381,564483,641061303,209154,514613035,5516,3.85516110030356,622593,104998917.571605,16552923967337.2,677.095238095238,843088,18282396.0449716
1182,BTC,2020-03-23,611398077,641418642,357339,689405,641418642,259816,514872851,8840,4.02135381391446,622705,94802605.0541267,16552923967337.2,749.918918918919,1160538,18283796.0449716
1182,BTC,2020-03-24,611755043,641797407,378765,742260,641797407,278131,515150982,8590,5.01964834184276,622837,108784284.97037,16552923967337.2,653.534351145038,1170288,18285446.0449716
1182,BTC,2020-03-25,611989895,642114639,317232,598712,642114639,218176,515369158,8809,4.09955557463319,622929,75434661.4599693,16552923967337.2,942.461538461538,1125291,18286596.0449716
1182,BTC,2020-03-26,612484645,642506486,391847,893980,642506486,292828,515661986,8493,2.99398205238502,623089,112264004.670682,14143559041805.1,541.100628930817,1135452,18288596.0449716
1182,BTC,2020-03-27,612952021,642887066,380580,850337,642887066,276546,515938532,7911,3.79013070830643,623244,106723078.405497,13912524048945.9,559.896103896103,1110375,18290533.5449716
1182,BTC,2020-03-28,613233873,643218267,331201,637889,643218267,240627,516179159,5563,2.9308636507003,623379,92961048.570639,13912524048945.9,642.783582089552,910426,18292221.0449716
1182,BTC,2020-03-29,613504392,643529538,311271,592536,643529538,232820,516411979,5363,2.7787385829881,623530,104135834.0121,13912524048945.9,573.806666666666,769856,18294108.5449716
1182,BTC,2020-03-30,613902798,643913051,383513,788798,643913051,276828,516688807,7993,3.66255912995401,623677,101671911.359057,13912524048945.9,587.712328767123,1055633,18295946.0449716
1182,BTC,2020-03-31,614338015,644308122,395071,834050,644308122,290227,516979034,7349,3.61916195602125,623836,110180025.856779,13912524048945.9,542.32911392405,1025871,18297933.5449716
1182,BTC,2020-04-01,614758844,644699633,391511,819464,644699633,281855,517260889,7921,3.610397553564,623989,105459373.006891,13912524048945.9,566.605263157895,1113694,18299846.0449716
1182,BTC,2020-04-02,615162487,645110598,410965,815117,645110598,299176,517560065,8777,3.38222298012952,624142,105730685.084869,13912524048945.9,565.151315789474,1115204,18301758.5449716
1182,BTC,2020-04-03,615530099,645503043,392445,764473,645503043,278763,517838828,7809,3.50291371439545,624274,93208612.5331889,13912524048945.9,641.076335877863,1148502,18303408.5449716
1182,BTC,2020-04-04,615842035,645843859,340816,666600,645843859,253274,518092102,6352,3.38626868610596,624431,109321180.091308,13912524048945.9,546.589743589743,1077272,18305371.0449716
1182,BTC,2020-04-05,616119139,646174111,330252,608720,646174111,240259,518332361,5090,2.30275142354609,624606,123368978.823834,13912524048945.9,484.350574712644,769681,18307558.5449716
1182,BTC,2020-04-06,616492380,646569303,395192,780520,646569303,280470,518612831,8623,3.88495915448155,624734,92144409.6551549,13912524048945.9,648.48031496063,1164635,18309158.5449716
1182,BTC,2020-04-07,617027276,647003372,434069,956984,647003372,312770,518925601,9325,3.76031155884842,624902,116247181.773153,13912524048945.9,514.023952095808,1137403,18311258.5449716
1182,BTC,2020-04-08,617414052,647401370,397998,787342,647401370,286563,519212164,8083,2.65404738885233,625046,102833475.019852,14397482597687.7,601.328671328671,1116311,18313058.5449716
1182,BTC,2020-04-09,617765471,647794761,393391,734627,647794761,286706,519498870,7596,3.84850159401418,625200,114367930.940938,14715214060656.5,552.614379084968,1069383,18314983.5449716
1182,BTC,2020-04-10,618131426,648194391,399630,750288,648194391,288585,519787455,7489,3.77359703285562,625363,119318729.146754,14715214060656.5,529.685185185185,900077,18317021.0449716
1182,BTC,2020-04-11,618430208,648534523,340132,643484,648534523,247852,520035307,5755,2.45677003147616,625522,117662904.472559,14715214060656.5,537.139240506329,784763,18319008.5449716
1182,BTC,2020-04-12,618726217,648854831,320308,616567,648854831,228529,520263836,5177,2.16267104069199,625675,112651795.887662,14715214060656.5,561.032894736842,800401,18320921.0449716
1182,BTC,2020-04-13,619129410,649253687,398856,790180,649253687,288113,520551949,7724,3.42083353435253,625846,125952261.728724,14715214060656.5,501.788235294118,929310,18323058.5449716
1182,BTC,2020-04-14,619564136,649683132,429445,836310,649683132,299391,520851340,7705,2.58200466184852,626014,122871101.805292,14715214060656.5,514.37125748503,988374,18325158.5449716
1182,BTC,2020-04-15,620088176,650134570,451438,945210,650134570,310253,521161593,8317,2.82923850709134,626183,124445669.978302,14715214060656.5,507.863095238095,1176886,18327271.0449716
1182,BTC,2020-04-16,620528701,650605762,471192,880877,650605762,322903,521484496,8920,3.43507383830348,626337,111955362.398189,14715214060656.5,564.522875816994,1111490,18329196.044971
1182,BTC,2020-04-17,620961002,651030209,424447,856386,651030209,284222,521768718,8049,3.32810274745526,626464,92533863.4676681,14715214060656.5,683.007936507937,1286230,18330783.544971
1182,BTC,2020-04-18,621437825,651439819,409610,875649,651439819,289134,522057852,6285,2.12109023100051,626622,115182351.255795,14715214060656.5,548.707006369427,1150726,18332758.544971
1182,BTC,2020-04-19,621809765,651796896,357077,721017,651796896,251984,522309836,5688,2.1731320589143,626774,112779553.707965,14715214060656.5,560.397350993377,975852,18334658.544971
1182,BTC,2020-04-20,622239560,652247506,450610,861163,652247506,310810,522620646,8164,2.7019098751176,626935,117656440.632779,14715214060656.5,537.16875,1049269,18336671.044971
1182,BTC,2020-04-21,622647556,652697383,449877,826820,652697383,310851,522931497,7896,2.60597660467851,627084,116944887.221935,15624843397592.7,573.844594594595,1068249,18338533.544971
1182,BTC,2020-04-22,622979368,653116781,419398,756886,653116781,278755,523210252,7849,3.10924773538889,627215,103286762.094521,15958652328578.4,663.607692307693,1031391,18340171.044971
1182,BTC,2020-04-23,623450459,653607997,491216,949362,653607997,329045,523539297,9048,2.8097446780906,627357,112017321.936187,15958652328578.4,611.886524822695,1287894,18341946.044971
1182,BTC,2020-04-24,623880179,654079579,471582,903172,654079579,320055,523859352,9540,3.95370581722716,627501,114858970.493296,15958652328578.4,596.748251748252,1273850,18343746.044971
1182,BTC,2020-04-25,624274586,654480739,401160,835211,654480739,280805,524140157,6992,2.18234438426869,627637,108060997.189382,15958652328578.4,634.288888888889,1239612,18345446.044971
1182,BTC,2020-04-26,624607453,654848221,367482,716591,654848221,252833,524392990,5986,2.07183657934146,627774,108354027.875963,15958652328578.4,632.573529411765,1072414,18347158.544971
1182,BTC,2020-04-27,625034177,655309318,461097,883071,655309318,311217,524704207,9643,3.32634536130221,627915,112785046.926188,15958652328578.4,607.721428571429,1179406,18348921.044971
1182,BTC,2020-04-28,625526084,655786404,477086,943523,655786404,323475,525027682,9357,2.72438509625198,628069,122035878.480214,15958652328578.4,561.653594771242,1215701,18350846.044971
1182,BTC,2020-04-29,625925604,656277154,490750,919164,656277154,331401,525359083,11840,5.42295949073992,628214,117023928.01789,15958652328578.4,585.708333333333,1195938,18352658.544971
1182,BTC,2020-04-30,626340762,656771888,494734,955268,656771888,321972,525681055,13180,6.28111945743978,628349,107926031.873775,15958652328578.4,635.082089552239,1268807,18354346.044971
1182,BTC,2020-05-01,626786359,657268791,496903,950575,657268791,340574,526021629,11218,3.16030693677471,628490,111950820.480978,15958652328578.4,612.25,1250539,18356108.544971
1182,BTC,2020-05-02,627324363,657681831,413040,995598,657681831,286773,526308402,8069,1.92258561157518,628638,117070328.314685,15958652328578.4,585.476190476191,1341512,18357958.544971
1182,BTC,2020-05-03,627813712,658086612,404781,915872,658086612,281752,526590154,7880,2.59067678858017,628806,133295629.62972,15958652328578.4,514.209580838323,1196455,18360058.544971
1182,BTC,2020-05-04,628242705,658561545,474933,903205,658561545,326098,526916252,9863,2.80329281213537,628964,125392706.799172,15958652328578.4,546.617834394904,1086099,18362033.544971
1182,BTC,2020-05-05,628742722,659042333,480788,981599,659042333,329075,527245327,10127,3.31605165604306,629122,125928121.968959,16079831604278.3,548.426751592357,1204144,18364008.544971
1182,BTC,2020-05-06,629231206,659532322,489989,983514,659532322,333395,527578722,11335,3.05722642295742,629276,123668735.999823,16104807485529.4,559.313725490196,1210363,18365933.544971
1182,BTC,2020-05-07,629726273,660035830,503508,1018694,660035830,341986,527920708,13816,3.85828834274543,629423,117827562.572616,16104807485529.4,587.041095890411,1313992,18367771.044971
1182,BTC,2020-05-08,630167151,660520456,484626,958464,660520456,323625,528244333,12419,4.09942977089916,629560,109479994.394956,16104807485529.4,631.801470588236,1274328,18369483.544971
1182,BTC,2020-05-09,630606360,660976869,456413,919601,660976869,312399,528556732,10179,3.75061719243122,629696,108663612.736843,16104807485529.4,636.548148148148,1292073,18371183.544971
1182,BTC,2020-05-10,631056684,661388868,411999,884533,661388868,286789,528843521,9786,2.80736105765755,629866,135872632.05854,16104807485529.4,509.076923076923,1246688,18373308.544971
1182,BTC,2020-05-11,631556829,661853115,464247,1001130,661853115,305839,529149360,12304,3.81009265052992,630023,125480689.67894,16104807485529.4,551.23717948718,1283646,18375121.044971
1182,BTC,2020-05-12,632032123,662362517,509402,966723,662362517,345215,529494575,11513,3.49224948264742,630169,116506692.278827,16104807485529.4,593.696551724138,1279955,18376033.544971
1182,BTC,2020-05-13,632426641,662818030,455513,860632,662818030,296796,529791371,10472,3.74512413327969,630288,94618897.4534501,16104807485529.4,731.033898305085,1296750,18376777.294971
1182,BTC,2020-05-14,632837761,663249588,431558,885249,663249588,268750,530060121,10603,4.23666006780268,630402,94923213.2427666,16104807485529.4,728.690265486726,1323246,18377489.794971
1182,BTC,2020-05-15,633252207,663724419,474831,901217,663724419,310642,530370763,10445,3.2342498280106,630527,100021376.304714,16104807485529.4,691.548387096774,1272443,18378271.044971
1182,BTC,2020-05-16,633698066,664155100,430681,884995,664155100,296555,530667318,8402,1.98439087412261,630653,102079109.837435,16104807485529.4,677.608,1262686,18379058.544971
1182,BTC,2020-05-17,634086882,664514455,359355,775036,664514455,236808,530904126,7805,2.48217296325133,630755,81279455.5953462,16104807485529.4,851.009900990099,1327792,18379696.044971
1182,BTC,2020-05-18,634578101,664942842,428387,969202,664942842,273723,531177849,10733,3.88348365278464,630883,101921845.308079,16104807485529.4,678.653543307086,1352731,18380496.044971
1182,BTC,2020-05-19,635029562,665372901,430059,893883,665372901,274897,531452746,9712,4.28108193602491,630998,94782518.5265117,16104807485529.4,729.771929824561,1333283,18381214.794971
1182,BTC,2020-05-20,635447871,665811867,438966,880458,665811867,280037,531732783,10105,3.87590075108868,631113,87062046.6017161,15213703057048.3,750.526315789474,1327850,18381933.544971
1182,BTC,2020-05-21,635905690,666262391,450524,927079,666262391,298483,532031266,9742,3.2869808031176,631244,97992697.0032126,15138043247082.9,663.492307692308,1295657,18382752.294971
1182,BTC,2020-05-22,636271175,666684516,422125,802123,666684516,278784,532310050,9876,3.54069107126636,631355,83588481.5965452,15138043247082.9,777.827272727273,1297051,18383446.044971
1182,BTC,2020-05-23,636695146,667087358,402842,853635,667087358,269230,532579280,7597,2.06526303999588,631474,89778869.3377245,15138043247082.9,724.194915254237,1278850,18384189.794971
1182,BTC,2020-05-24,637144308,667423481,336123,814572,667423481,214530,532793810,5915,2.77786423260006,631590,90859391.8879148,15138043247082.9,715.582608695652,1412773,18384914.794971
1182,BTC,2020-05-25,637569700,667825637,402156,831210,667825637,265875,533059685,9306,4.13599755035889,631715,97904692.1355383,15138043247082.9,664.08870967742,1279331,18385696.044971
1182,BTC,2020-05-26,638006988,668275940,450303,876092,668275940,295782,533355467,8937,3.2211614688405,631839,92842103.6559611,15138043247082.9,700.30081300813,1307555,18386471.044971
1182,BTC,2020-05-27,638490703,668722321,446381,914536,668722321,292927,533648394,9134,3.77796547606868,631977,106384768.440864,15138043247082.9,611.153284671533,1343527,18387333.544971
1182,BTC,2020-05-28,638913591,669178394,456073,874348,669178394,299910,533948304,9398,2.79864132861218,632108,100128676.372582,15138043247082.9,649.338461538461,1281801,18388152.294971
1182,BTC,2020-05-29,639332270,669613284,434890,858638,669613284,280960,534229264,8914,3.72891329909685,632235,95712128.2903599,15138043247082.9,679.301587301587,1270912,18388946.044971
1182,BTC,2020-05-30,639827705,670022429,409145,915981,670022429,286046,534515310,6910,2.053656213758,632391,121923358.305585,15138043247082.9,533.264516129032,1245524,18389921.044971
1182,BTC,2020-05-31,640276444,670393060,370631,806377,670393060,258427,534773737,6627,2.91374511572661,632541,114330812.081203,15138043247082.9,568.677852348993,1051905,18390858.544971
1182,BTC,2020-06-01,640720388,670848590,455530,889872,670848590,308312,535082049,9633,4.06567430435053,632675,104189530.692203,15138043247082.9,624.03007518797,1269376,18391696.044971
1182,BTC,2020-06-02,641132508,671311611,463021,902307,671311611,304114,535386163,12283,5.15026537208504,632804,97487639.0873732,15138043247082.9,666.9296875,1283667,18392502.294971
1182,BTC,2020-06-03,641607986,671785399,473788,961251,671785399,314000,535700163,9937,3.59621863821175,632943,104327821.360995,15138043247082.9,623.202898550725,1282827,18393371.044971
1182,BTC,2020-06-04,642077892,672254501,469102,912565,672254501,318285,536018448,10142,3.6214346956111,633094,108405709.889195,14477089134396.9,573.573333333333,1236471,18394314.794971
1182,BTC,2020-06-05,642558811,672738245,483744,927188,672738245,327082,536345530,9100,3.24489457468271,633273,122768676.10293,13732352106018.3,480.415730337079,1042586,18395433.544971
1182,BTC,2020-06-06,642950716,673145354,407109,791428,673145354,284873,536630403,6827,1.75205463420598,633469,133434276.826872,13732352106018.3,442.015384615384,793185,18396658.544971
1182,BTC,2020-06-07,643298794,673513157,367803,700237,673513157,252368,536882771,6139,1.79169027615264,633628,109484004.234408,13732352106018.3,538.708860759494,861702,18397652.294971
1182,BTC,2020-06-08,643837217,673981888,468731,980377,673981888,317275,537200046,8945,3.10120474103544,633790,110638616.216265,13732352106018.3,533.086956521739,1151651,18398664.794971
1182,BTC,2020-06-09,644333040,674463561,481673,940560,674463561,327074,537527120,10413,2.68802832350434,633950,109371266.547804,13732352106018.3,539.264150943396,1176594,18399664.794971
1182,BTC,2020-06-10,644783246,674940406,476845,918863,674940406,325163,537852283,9588,3.67808797828855,634114,112661461.807019,13732352106018.3,523.515337423313,1080857,18400689.794971
1182,BTC,2020-06-11,645315406,675441567,501161,1051109,675441567,332490,538184773,10009,3.01251552123748,634299,126273467.151729,13732352106018.3,467.081521739131,1382471,18401846.044971
1182,BTC,2020-06-12,645773170,675917235,475668,929963,675917235,318274,538503047,10053,2.60861353344678,634462,113518760.080147,13732352106018.3,519.561728395062,1355473,18402864.794971
1182,BTC,2020-06-13,646201698,676316369,399134,822890,676316369,280181,538783228,6436,2.07798416626798,634620,108400085.4714,13732352106018.3,544.095541401274,1067535,18403852.294971
1182,BTC,2020-06-14,646547431,676699534,383165,703360,676699534,275723,539058951,5666,1.74005747694712,634790,116325936.717745,13732352106018.3,507.023668639053,825322,18404914.794971
1182,BTC,2020-06-15,646953580,677144633,445099,874857,677144633,294468,539353419,9887,3.4317145627709,634928,94136031.9373369,13732352106018.3,626.540145985402,1129341,18405777.294971
1182,BTC,2020-06-16,647446090,677649812,505179,992090,677649812,340517,539693936,10233,3.97675055665993,635078,108335155.918408,14265974077877.7,565.577181208054,1223100,18406714.794971
1182,BTC,2020-06-17,647892872,678148882,499070,933528,678148882,333547,540027483,9849,2.80588781369489,635216,108720804.38471,15784744305477.4,623.569343065694,1271521,18407577.294971
1182,BTC,2020-06-18,648305710,678573167,424285,856951,678573167,280603,540308086,8444,2.76822494452928,635339,101051756.151758,15784744305477.4,670.893442622951,1249316,18408346.044971
1182,BTC,2020-06-19,648790757,679081962,508795,960310,679081962,347436,540655522,9558,4.19512256523754,635482,115505056.038924,15784744305477.4,586.943661971832,1285095,18409239.794971
1182,BTC,2020-06-20,649166447,679488418,406456,780726,679488418,284123,540939645,6210,1.9173468423959,635619,108741872.615713,15784744305477.4,623.448529411764,1107477,18410096.044971
1182,BTC,2020-06-21,649540147,679846392,357974,726175,679846392,259440,541199085,5504,1.83410379150351,635765,116044779.099803,15784744305477.4,584.213793103448,981158,18411008.544971
1182,BTC,2020-06-22,649924368,680291014,444622,846995,680291014,301396,541500481,8821,3.19386178430182,635908,112407136.609182,15784744305477.4,603.119718309859,1103866,18411902.294971
1182,BTC,2020-06-23,650466839,680818069,527055,1044734,680818069,355256,541855737,10965,3.80940544691282,636066,123910741.791364,15784744305477.4,547.127388535032,1304964,18412889.794971
1182,BTC,2020-06-24,650945231,681281197,463128,936111,681281197,312321,542168058,10532,4.20051867072141,636205,109182095.232167,15784744305477.4,620.934782608695,1288159,18413758.544971
1182,BTC,2020-06-25,651374215,681748386,467189,898830,681748386,312183,542480241,12069,3.8050924296266,636346,111747742.149699,15784744305477.4,606.678571428571,1253759,18414639.794971
1182,BTC,2020-06-26,651873159,682233848,485462,945633,682233848,330381,542810622,12367,3.70430235434677,636510,130752867.213428,15784744305477.4,518.496932515337,1186091,18415664.794971
1182,BTC,2020-06-27,652258753,682633940,400092,784452,682633940,275489,543086111,6924,2.10025648472799,636648,109411115.53518,15784744305477.4,619.63503649635,1105369,18416527.294971
1182,BTC,2020-06-28,652590846,683010231,376291,699408,683010231,264909,543351020,6357,2.58013395493551,636798,117736623.944828,15784744305477.4,575.818791946309,901781,18417464.794971
1182,BTC,2020-06-29,653084401,683474742,464511,950697,683474742,315424,543666444,9446,3.21335080573247,636943,114717677.106412,15784744305477.4,590.972222222222,1248924,18418371.044971
1182,BTC,2020-06-30,653544336,683936311,461569,938812,683936311,299733,543966177,9668,3.66236040591003,637090,116853815.605979,15784618886622.8,580.164383561644,1189839,18419289.794971
1182,BTC,2020-07-01,654102387,684503410,567099,1091883,684503410,382570,544348747,11287,2.83690870375225,637252,127523681.814665,15784217546288.2,531.608695652174,1295763,18420302.294971
1182,BTC,2020-07-02,654596007,685006162,502752,968985,685006162,339469,544688216,9542,3.03715960547384,637416,130216943.190477,15784217546288.2,520.613496932515,1133437,18421327.294971
1182,BTC,2020-07-03,655080910,685499940,493778,954683,685499940,331009,545019225,9382,2.93562789832008,637579,128401266.20434,15784217546288.2,527.975308641976,1198966,18422346.044971
1182,BTC,2020-07-04,655495157,685909822,409882,817057,685909822,288647,545307872,7032,2.34352189253289,637736,124633616.707098,15784217546288.2,543.935897435897,1037606,18423327.294971
1182,BTC,2020-07-05,655910542,686291454,381632,776789,686291454,274104,545581976,6747,2.18994600985666,637899,128461342.593338,15784217546288.2,527.728395061729,921691,18424346.044971
1182,BTC,2020-07-06,656424985,686795072,503618,1002538,686795072,338767,545920743,9855,3.42278126286746,638053,121441082.046614,15784217546288.2,558.235294117648,1227644,18425308.544971
1182,BTC,2020-07-07,656891509,687315597,520525,978928,687315597,345975,546266718,10620,2.86807701929902,638214,126430264.761474,15784217546288.2,536.20625,1103862,18426314.794971
1182,BTC,2020-07-08,657392933,687831590,515993,1024774,687831590,347455,546614173,11501,3.1333806592985,638365,118812271.850476,15784217546288.2,570.586666666666,1247866,18427258.544971
1182,BTC,2020-07-09,657931274,688359473,527883,1051240,688359473,362718,546976891,10935,2.6914005320063,638529,132217500.22906,15784217546288.2,512.736196319019,1267096,18428283.544971
1182,BTC,2020-07-10,658437206,688866218,506745,994020,688866218,345996,547322887,11503,2.80240048925086,638690,126054128.516091,15784217546288.2,537.80625,1208174,18429289.794971
1182,BTC,2020-07-11,658896970,689304443,438225,890511,689304443,306771,547629658,6529,2.00144317571325,638846,122388019.776021,15784217546288.2,553.916129032258,1091070,18430264.794971
1182,BTC,2020-07-12,659275720,689699398,394955,755307,689699398,282364,547912022,6695,2.40297624151078,638998,124886509.62928,15784217546288.2,542.834437086093,979820,18431214.794971
1182,BTC,2020-07-13,659700846,690167587,468189,913626,690167587,310227,548222249,9847,3.94520993354389,639145,120843386.76509,16570395220715.8,588.938356164384,1143550,18432133.544971
1182,BTC,2020-07-14,660165314,690713858,546271,1008030,690713858,359847,548582096,10477,2.53048521949529,639289,124614472.546588,17345948872516.1,597.846153846153,1259092,18433033.544971
1182,BTC,2020-07-15,660619780,691206997,493139,972945,691206997,316064,548898160,9775,2.6379477580541,639427,119755699.866237,17345948872516.1,622.102189781022,1313624,18433896.044971
1182,BTC,2020-07-16,661069482,691730911,523914,974469,691730911,345849,549244009,12476,2.8469826908384,639563,117107439.44609,17345948872516.1,636.17037037037,1276772,18434746.044971
1182,BTC,2020-07-17,661439202,692193232,462321,858601,692193232,293907,549537916,10821,2.88795481624674,639681,102244324.188156,17345948872516.1,728.649572649573,1264411,18435483.544971
1182,BTC,2020-07-18,661857641,692654529,461297,894991,692654529,311022,549848938,7670,2.12323715800484,639811,113562136.919167,17345948872516.1,656.031007751938,1276202,18436296.044971
1182,BTC,2020-07-19,662326684,693062215,407686,883750,693062215,277093,550126031,7934,2.35073997041697,639942,115748650.177725,17345948872516.1,643.638461538462,1332783,18437114.794971
1182,BTC,2020-07-20,662776273,693533797,471582,945876,693533797,309747,550435778,11532,2.93605166227198,640083,122244695.181447,17345948872516.1,609.435714285715,1287877,18437996.044971
1182,BTC,2020-07-21,663187056,694017067,483270,928809,694017067,312871,550748649,10893,2.84618756488952,640208,108837699.637926,17345948872516.1,684.508064516129,1290345,18438777.294971
1182,BTC,2020-07-22,663660039,694568938,551871,1024306,694568938,364792,551113441,11503,2.61737530647133,640352,125301865.22415,17345948872516.1,594.566433566433,1260738,18439677.294971
1182,BTC,2020-07-23,664124874,695085084,516146,988083,695085084,336245,551449686,11562,3.02238600770245,640488,116590214.016838,17345948872516.1,638.992592592593,1293743,18440527.294971
1182,BTC,2020-07-24,664663347,695630578,545494,1086693,695630578,369432,551819118,12021,2.80264431051606,640649,140057871.176472,17345948872516.1,531.925,1314238,18441533.544971
1182,BTC,2020-07-25,665156212,696072915,442337,979174,696072915,293883,552113001,10922,2.69493416890133,640791,121938800.648919,17345948872516.1,610.964539007092,1370815,18442421.044971
1182,BTC,2020-07-26,665718431,696521947,449032,1005933,696521947,298580,552411581,9343,2.44563184696658,640949,137713335.657222,17345948872516.1,540.980891719745,1343587,18443408.544971
1182,BTC,2020-07-27,666189647,697021025,499078,1027493,697021025,326769,552738350,15710,3.79269072204022,641098,129471926.706265,17309155182109.2,574.195945945946,1285135,18444339.794971
1182,BTC,2020-07-28,666673390,697564927,543902,1060050,697564927,354742,553093092,15547,3.58004058896449,641243,123810888.485002,16847561611550.3,584.4375,1280557,18445246.044971
1182,BTC,2020-07-29,667157667,698086740,521813,1048886,698086740,346521,553439613,14897,3.26674409151073,641391,127381679.230051,16847561611550.3,568.054421768707,1283028,18446171.044971
1182,BTC,2020-07-30,667593278,698587753,501013,972959,698587753,327789,553767402,15660,3.18989137477868,641526,115698199.44419,16847561611550.3,625.417910447761,1287137,18447014.794971
1182,BTC,2020-07-31,668110148,699125387,537634,1065584,699125387,356906,554124308,14365,2.8421831044162,641679,129019781.966978,16847561611550.3,560.842105263158,1299889,18447971.044971
1182,BTC,2020-08-01,668584528,699586509,461122,962645,699586509,296705,554421013,13218,2.91490471820512,641816,116629011.767258,16847561611550.3,620.426470588236,1287825,18448827.294971
1182,BTC,2020-08-02,669087651,700037968,451459,961511,700037968,287869,554708882,10754,2.75776844221469,641957,117988349.03101,16847561611550.3,613.278571428571,1353125,18449708.544971
1182,BTC,2020-08-03,669651690,700558519,520551,1087285,700558519,333753,555042635,12616,3.38997950638832,642119,136241985.152107,16847561611550.3,531.111801242236,1326875,18450721.044971
1182,BTC,2020-08-04,670124390,701077657,519138,1001974,701077657,329032,555371667,12812,3.01898618141898,642264,121600211.975975,16847561611550.3,595.0625,1310942,18451627.294971
1182,BTC,2020-08-05,670562334,701555961,478304,960098,701555961,291814,555663481,13494,3.40471583378539,642393,109033220.075883,16847561611550.3,663.6484375,1267972,18452433.544971
1182,BTC,2020-08-06,671123805,702112868,556907,1130815,702112868,356612,556020093,14340,3.35002536670432,642549,131674347.267343,16847561611550.3,549.535483870968,1277008,18453408.544971
1182,BTC,2020-08-07,671650461,702628280,515412,1056177,702628280,326499,556346592,13469,3.13275022994744,642701,127195160.1474,16847561611550.3,568.887417218543,1301960,18454358.544971
1182,BTC,2020-08-08,672142200,703077141,448861,956982,703077141,283631,556630223,10376,2.84031648727093,642843,119930428.173693,16847561611550.3,603.347517730497,1327259,18455246.044971
1182,BTC,2020-08-09,672635608,703495857,418716,913883,703495857,268402,556898625,9858,2.60235248809606,642999,133823619.514829,16847561611550.3,540.709677419355,1250962,18456221.044971
1182,BTC,2020-08-10,673075586,703988482,492625,977807,703988482,308367,557206992,16263,3.32243253964776,643136,115178600.108067,16871707187018.0,629.139705882353,1249095,18457077.294971
1182,BTC,2020-08-11,673598703,704531396,542914,1091961,704531396,349952,557556944,14165,2.97975361926884,643290,130876188.786604,16947802333946.6,556.176470588236,1285126,18458039.794971
1182,BTC,2020-08-12,674138815,705067087,535691,1064980,705067087,346405,557903349,14020,2.8183024417319,643447,131566946.923648,16947802333946.6,553.25641025641,1300253,18459021.044971
1182,BTC,2020-08-13,674573402,705571751,504664,954330,705571751,325346,558228695,14219,2.79021941617377,643594,124601393.903841,16947802333946.6,584.184931506849,1207145,18459939.794971
1182,BTC,2020-08-14,675116292,706133832,562081,1099122,706133832,365679,558594374,14874,3.93799827549977,643761,140462924.564307,16947802333946.6,518.216867469879,1264694,18460983.544971
1182,BTC,2020-08-15,675607051,706622035,488203,987359,706622035,313760,558908134,11684,4.56456441711496,643917,133953361.728696,16947802333946.6,543.4,1229856,18461958.544971
1182,BTC,2020-08-16,676095633,707047610,425575,897723,707047610,285069,559193203,10209,6.38199987246779,644069,129324964.951987,16947802333946.6,562.847682119205,1147488,18462908.544971
1182,BTC,2020-08-17,676466599,707519123,471513,890289,707519123,292944,559486147,15008,10.031296465444,644194,107049573.493267,16947802333946.6,679.967741935483,1268331,18463689.794971
1182,BTC,2020-08-18,676914843,708061873,542750,1021120,708061873,346036,559832183,15964,6.00215898883058,644334,117306995.746239,16947802333946.6,620.510791366906,1245246,18464564.794971
1182,BTC,2020-08-19,677351685,708572670,510797,984468,708572670,333879,560166062,13574,5.65262824184405,644472,117105843.118302,16947802333946.6,621.576642335766,1294059,18465427.294971
1182,BTC,2020-08-20,677819404,709090259,517589,1004719,709090259,333683,560499745,13942,5.53266690761097,644618,127666677.520945,16947802333946.6,570.158620689655,1265249,18466339.794971
1182,BTC,2020-08-21,678396902,709582842,492583,1098887,709582842,314297,560814042,14380,4.75891832505376,644773,134077692.289542,16947802333946.6,542.896103896104,1344396,18467308.544971
1182,BTC,2020-08-22,678859054,710054691,471849,963973,710054691,311699,561125741,9837,4.3576506174065,644909,115192008.429031,16947802333946.6,631.903703703703,1318342,18468158.544971
1182,BTC,2020-08-23,679370123,710480612,425921,926956,710480612,288728,561414469,8492,4.74980819536813,645066,132164157.162483,16947802333946.6,550.75641025641,1251878,18469139.794971
1182,BTC,2020-08-24,679797976,710975255,494643,943490,710975255,329133,561743602,12787,5.66405182873073,645215,131835062.118917,17340945336075.4,564.939189189189,1166158,18470071.044971
1182,BTC,2020-08-25,680222625,711466519,491264,959916,711466519,304409,562048011,13417,5.31124370174903,645343,112154365.643774,17557993035167.3,672.385826771653,1318086,18470871.044971
1182,BTC,2020-08-26,680715884,711970546,504027,1039702,711970546,324184,562372195,12315,6.00883024136975,645485,125893343.921276,17557993035167.3,599.007092198582,1302465,18471758.544971
1182,BTC,2020-08-27,681118987,712475648,505102,958992,712475648,328157,562700352,14863,6.13551575805319,645614,112414794.578625,17557993035167.3,670.828125,1268826,18472668.0
1182,BTC,2020-08-28,681668086,713001303,525655,1089313,713001303,352722,563053074,13694,6.1397161722814,645777,145171092.543928,17557993035167.3,519.462962962963,1302147,18473706.0
1182,BTC,2020-08-29,682189619,713448159,446856,985094,713448159,292783,563345857,10619,5.98237691683861,645923,127782403.719309,17557993035167.3,590.151724137931,1328303,18474575.0
1182,BTC,2020-08-30,682612892,713854640,406481,839662,713854640,269114,563614971,10272,6.51511145624787,646050,110406297.08291,17557993035167.3,683.031746031746,1310540,18475375.0
1182,BTC,2020-08-31,683022289,714330729,476089,931549,714330729,302920,563917891,14970,8.90639599336851,646200,130555276.529907,17557993035167.3,577.61744966443,1171316,18476306.0
1182,BTC,2020-09-01,683487265,714902982,572253,1089210,714902982,376508,564294399,15913,7.04751250716997,646354,137021363.316005,17557993035167.3,550.359477124183,1273975,18477300.0
1182,BTC,2020-09-02,683934680,715414767,511785,1034209,715414767,317449,564611848,15629,7.26519625834228,646498,125863977.2092,17557993035167.3,599.146853146853,1293518,18478181.0
1182,BTC,2020-09-03,684360424,715907495,492728,985739,715907495,310922,564922770,13791,8.81724010774053,646627,115068172.892834,17557993035167.3,655.359375,1295405,18478968.0
1182,BTC,2020-09-04,684834695,716386576,479081,1013330,716386576,298286,565221056,14095,8.90021354798019,646762,118094086.416708,17557993035167.3,638.567164179104,1300009,18479825.0
1182,BTC,2020-09-05,685281618,716864706,478130,987399,716864706,325523,565546579,12114,7.46044134310021,646903,123720214.94037,17557993035167.3,609.528571428571,1276079,18480650.0
1182,BTC,2020-09-06,685846641,717270738,406032,1002063,717270738,262820,565809399,8734,8.73104273675991,647053,133951335.485694,17557993035167.3,562.973154362416,1421785,18481593.0
1182,BTC,2020-09-07,686447493,717757689,486951,1099514,717757689,327662,566137061,10918,9.11282938037368,647228,151623204.327115,17445332713343.6,494.166666666667,1280486,18482687.0
1182,BTC,2020-09-08,686916975,718264704,507015,990830,718264704,332668,566469729,11768,8.12568067818783,647383,134004648.225408,17345997805929.1,555.954545454545,1249473,18483681.0
1182,BTC,2020-09-09,687357841,718754998,490294,973331,718754998,314864,566784593,11775,10.1272791737593,647532,128846894.622928,17345997805929.1,578.20945945946,1194565,18484606.0
1182,BTC,2020-09-10,687920112,719300541,545543,1105281,719300541,345981,567130574,12058,10.0968557144596,647690,136702945.781932,17345997805929.1,544.980891719745,1333325,18485593.0
1182,BTC,2020-09-11,688373082,719793953,493412,968474,719793953,308323,567438897,12304,10.1526154811116,647828,120203125.403476,17345997805929.1,619.788321167883,1328602,18486537.0
1182,BTC,2020-09-12,688835593,720243404,449451,910805,720243404,300152,567739049,8780,8.64141079451321,647998,147477344.904233,17345997805929.1,505.165680473372,1060539,18487562.0
1182,BTC,2020-09-13,689229321,720640082,396678,801618,720640082,255110,567994159,8149,10.2704287842981,648160,140875696.41856,17345997805929.1,528.83850931677,938489,18488600.0
1182,BTC,2020-09-14,689745956,721170888,530806,1033414,721170888,354020,568348179,13140,7.80285380347839,648336,151494147.411885,17345997805929.1,491.771428571428,1160497,18489662.0
1182,BTC,2020-09-15,690170921,721693568,522680,976363,721693568,332957,568681136,13801,8.58988372546578,648492,134898442.330877,17345997805929.1,552.270967741936,1172355,18490631.0
1182,BTC,2020-09-16,690675401,722233465,539897,1075646,722233465,342609,569023745,13168,8.90414137781602,648647,135201639.980612,17345997805929.1,551.032467532467,1309139,18491606.0
1182,BTC,2020-09-17,691267407,722777376,543911,1118361,722777376,348581,569372326,13089,11.8868115780182,648825,153627160.399053,17345997805929.1,484.943502824859,1268264,18492706.0
1182,BTC,2020-09-18,691723497,723279557,502181,980147,723279557,325157,569697483,12784,11.6470038050969,648990,144751986.2102,17345997805929.1,514.676829268293,1153905,18493756.0
1182,BTC,2020-09-19,692166374,723738085,458528,910164,723738085,296357,569993840,9805,9.65369427560952,649139,129278957.513361,17345997805929.1,576.277027027027,1249747,18494668.0
1182,BTC,2020-09-20,692581114,724135035,396950,816881,724135035,259095,570252935,8845,9.10866118330033,649281,137239137.49871,19148290888758.9,599.255319148936,1093970,18495568.0
1182,BTC,2020-09-21,693016888,724598126,463091,952266,724598126,297605,570550540,12146,11.6128606182331,649426,141668596.587168,19314656404097.0,585.5625,1206441,18496475.0
1182,BTC,2020-09-22,693457528,725093033,494907,975383,725093033,312989,570863529,12717,8.88857139003403,649555,123175507.817428,19314656404097.0,673.4765625,1286297,18497306.0
1182,BTC,2020-09-23,693909498,725617515,524482,1021138,725617515,349938,571213467,12648,7.58103813056324,649697,137004629.927489,19314656404097.0,605.496453900709,1287952,18498168.0
1182,BTC,2020-09-24,694334708,726113221,495706,950734,726113221,316552,571530019,12662,7.61077664975518,649834,133371058.293601,19314656404097.0,621.992647058824,1258397,18499050.0
1182,BTC,2020-09-25,694938812,726653997,540776,1154509,726653997,353070,571883089,13374,8.03870765811635,650003,162395009.904151,19314656404097.0,510.827380952381,1348089,18500093.0
1182,BTC,2020-09-26,695459441,727093739,439742,959416,727093739,276162,572159251,9742,8.63887568284913,650153,144372093.917794,19314656404097.0,574.597315436242,1312045,18500987.0
1182,BTC,2020-09-27,695851617,727493454,399715,795760,727493454,259382,572418633,8209,7.98927191303066,650305,147325239.11732,19314656404097.0,563.079470198676,1015670,18501981.0
1182,BTC,2020-09-28,696234009,727949053,455599,878745,727949053,295476,572714109,12465,7.76268977814692,650434,126429936.553728,19314656404097.0,656.140625,1244179,18502775.0
1182,BTC,2020-09-29,696673684,728488499,539446,1009336,728488499,347696,573061805,13549,7.43914782733077,650575,135710281.409595,19314656404097.0,611.271428571428,1274256,18503637.0
1182,BTC,2020-09-30,697230991,729026061,537562,1124558,729026061,351417,573413222,12829,6.79606491240572,650731,149940548.379761,19314656404097.0,553.258064516129,1324411,18504656.0
1182,BTC,2020-10-01,697640655,729521976,495915,934982,729521976,304757,573717979,13640,6.48932266486561,650855,118997569.139739,19314656404097.0,697.121951219512,1300792,18505406.0
1182,BTC,2020-10-02,698091404,730015958,493982,991524,730015958,315443,574033422,13730,8.58673927872135,650991,132191923.493531,19314656404097.0,627.540740740741,1291145,18506200.0
1182,BTC,2020-10-03,698628336,730487313,471355,1019376,730487313,310855,574344277,10152,6.99441780417593,651142,146556417.623945,19314656404097.0,566.033333333333,1324275,18507150.0
1182,BTC,2020-10-04,699130781,730907982,420669,926183,730907982,268019,574612296,8890,7.00183048134882,651300,151827559.735041,19300708897945.3,545.987261146497,1219977,18508600.0
1182,BTC,2020-10-05,699577046,731369630,461648,951108,731369630,294986,574907282,12107,6.92252110345938,651440,137159265.382208,19298087186262.6,604.294964028777,1199752,18509012.0
1182,BTC,2020-10-06,700014066,731868972,499342,982298,731868972,317922,575225204,12564,6.84539815792959,651570,124208548.603724,19298087186262.6,667.302325581395,1300707,18509825.0
1182,BTC,2020-10-07,700517463,732416854,547882,1068933,732416854,370554,575595758,12543,5.69601697954042,651721,147141227.30402,19298087186262.6,563.3,1278854,18510775.0
1182,BTC,2020-10-08,701030823,732931858,515004,1045186,732931858,330227,575925985,12822,6.12522907441324,651883,155164172.78432,19298087186262.6,534.173913043478,1223705,18511781.0
1182,BTC,2020-10-09,701510047,733449228,517370,1011644,733449228,339343,576265328,12973,8.13026915421152,652025,135939701.302664,19298087186262.6,609.716312056737,1313543,18512668.0
1182,BTC,2020-10-10,701966704,733918534,469306,921691,733918534,298486,576563814,9619,6.25108689651585,652168,137071225.462416,19298087186262.6,604.68309859155,1298188,18513568.0
1182,BTC,2020-10-11,702360590,734324818,406284,802894,734324818,256096,576819910,7972,8.33179413587822,652308,133997450.706676,19298087186262.6,618.553956834532,1066880,18514425.0
1182,BTC,2020-10-12,702816157,734802388,477570,947074,734802388,314174,577134084,11640,6.91445727840681,652457,147522382.768781,19298087186262.6,561.844594594594,1184181,18515362.0
1182,BTC,2020-10-13,703341014,735338303,535915,1065009,735338303,333215,577467299,12287,6.85631847344075,652623,159150571.984016,19298087186262.6,520.793939393939,1257751,18516393.0
1182,BTC,2020-10-14,703768255,735827263,488960,944126,735827263,314541,577781840,12248,7.62620957777314,652772,147378819.885773,19298087186262.6,562.391891891892,1136457,18517331.0
1182,BTC,2020-10-15,704265601,736364448,537185,1046621,736364448,340993,578122833,13603,7.71472204321669,652923,147932582.143107,19298087186262.6,560.286666666667,1261410,18518275.0
1182,BTC,2020-10-16,704728455,736879451,515003,994310,736879451,324647,578447480,12004,7.26630091678743,653078,150676243.485824,19298087186262.6,550.084415584416,1215635,18519256.0
1182,BTC,2020-10-17,705141297,737313494,434043,854061,737313494,275069,578722549,7897,8.80972013850347,653235,152536373.373914,19529685517635.5,549.897435897436,1029741,18520225.0
1182,BTC,2020-10-18,705480700,737690554,377060,735424,737690554,231557,578954106,8033,9.18749303763276,653355,123329197.546717,19997335994446.1,696.411764705882,1083029,18520981.0
1182,BTC,2020-10-19,705880735,738183913,493359,937659,738183913,303929,579258035,13393,11.2250715862229,653480,124604838.001257,19997335994446.1,689.282258064516,1275570,18521768.0
1182,BTC,2020-10-20,706328669,738707248,523335,1017603,738707248,330563,579588598,13194,12.7034856545656,653624,142826894.208386,19997335994446.1,601.342657342658,1226298,18522650.0
1182,BTC,2020-10-21,706777309,739199733,492485,1014122,739199733,311292,579899890,15114,12.2475174543904,653754,133820562.230618,19997335994446.1,641.813953488372,1297150,18522937.0
1182,BTC,2020-10-22,707225086,739740777,541044,1051445,739740777,339087,580238977,14786,11.9117893582372,653891,135616153.975278,19997335994446.1,633.316176470588,1283932,18522937.0
1182,BTC,2020-10-23,707656934,740253402,512625,989606,740253402,323869,580562846,12925,8.46410263375757,654022,129458735.184123,19997335994446.1,663.438461538462,1284365,18525156.0
1182,BTC,2020-10-24,708262964,740735840,482438,1102593,740735840,306774,580869620,9042,6.06406064803389,654174,151226967.660464,19997335994446.1,567.940397350993,1337988,18526093.0
1182,BTC,2020-10-25,708702073,741141049,405209,857717,741141049,242273,581111893,8806,6.7647158875003,654291,116523553.554061,19997335994446.1,737.086206896552,1373567,18526837.0
1182,BTC,2020-10-26,709050478,741561636,420587,828770,741561636,252494,581364387,12766,11.2273204595604,654401,109452276.282328,19997335994446.1,784.706422018348,1340452,18527525.0
1182,BTC,2020-10-27,709376124,741996589,434953,829584,741996589,251938,581616325,13580,9.93770919426129,654500,97644048.2374964,19997335994446.1,879.602040816327,1299469,18528125.0
1182,BTC,2020-10-28,709692153,742439112,442523,821377,742439112,261340,581877665,13746,10.1862186469379,654600,100107166.477003,19997335994446.1,857.959595959596,1287839,18528756.0
1182,BTC,2020-10-29,710040710,742904159,465047,892820,742904159,276070,582153735,13942,8.82832299018028,654708,106493994.380387,19997335994446.1,806.504672897196,1298560,18529412.0
1182,BTC,2020-10-30,710402422,743345380,441221,900409,743345380,268364,582422099,13402,8.75946276575122,654819,111689102.026974,19997335994446.1,768.990909090909,1294094,18530096.044971
1182,BTC,2020-10-31,710783111,743788104,442724,884817,743788104,275796,582697895,12326,6.13655581554805,654932,113018366.656087,19997335994446.1,759.946428571429,1279690,18530818.0
1182,BTC,2020-11-01,711192842,744214626,426522,894688,744214626,276280,582974175,10051,7.729779655231,655057,124626709.754791,19997335994446.1,689.161290322581,1246865,18531600.0
1182,BTC,2020-11-02,711513890,744598632,384006,782160,744598632,224609,583198784,12952,11.4259164538975,655152,94512689.7720418,19997335994446.1,908.744680851064,1326538,18532162.0
1182,BTC,2020-11-03,711979572,745129453,530821,1036673,745129453,331673,583530457,13754,9.67877408827215,655292,123512789.700312,17865273539019.3,621.237410071942,1282563,18533087.0
1182,BTC,2020-11-04,712615034,745640516,511063,1172973,745640516,320697,583851154,13737,6.37486951222974,655451,133719917.539109,16787779609932.7,539.208860759494,1342291,18534075.0
1182,BTC,2020-11-05,713107575,746158335,517819,1074285,746158335,318668,584169822,17238,9.80915991340656,655598,125050875.507579,16787779609932.7,576.58904109589,1281835,18534993.0
1182,BTC,2020-11-06,713622436,746702562,544227,1088848,746702562,340351,584510173,16797,9.07719929137726,655751,131465850.037326,16787779609932.7,548.453947368421,1272637,18535962.0
1182,BTC,2020-11-07,714204616,747148431,445869,1059747,747148431,270901,584781074,12407,5.95225864662486,655897,122996280.529657,16787779609932.7,586.220689655172,1359237,18536862.0
1182,BTC,2020-11-08,714687949,747561130,412699,932713,747561130,243047,585024121,11072,6.16848400881365,656035,117363172.293238,16787779609932.7,614.357664233576,1372073,18537725.0
1182,BTC,2020-11-09,715358417,748087625,526495,1209513,748087625,326383,585350504,14713,6.5686914564542,656220,153944597.923758,16787779609932.7,468.369565217391,1370687,18538368.0
1182,BTC,2020-11-10,715858654,748583697,496072,1028073,748583697,303270,585653774,14364,7.12324200314502,656367,122827255.991167,16787779609932.7,587.027397260274,1225739,18538368.0
1182,BTC,2020-11-11,716345223,749099058,515361,1024519,749099058,322277,585976051,15346,6.40301873393602,656514,123078565.689387,16787779609932.7,585.828767123288,1297173,18538368.0
1182,BTC,2020-11-12,716863790,749624382,525324,1057681,749624382,324855,586300906,14801,6.03743038655957,656674,133710885.690944,16787779609932.7,539.245283018868,1247600,18538368.0
1182,BTC,2020-11-13,717332734,750125468,501086,1007716,750125468,300040,586600946,15107,5.261650020284,656813,116059079.091167,16787779609932.7,621.260869565217,1276639,18538368.0
1182,BTC,2020-11-14,717783586,750581618,456150,923828,750581618,273511,586874457,11321,6.95627942680101,656955,120261163.514123,16787779609932.7,599.553191489361,1290196,18538368.0
1182,BTC,2020-11-15,718216563,750996734,415116,868441,750996734,252715,587127172,10365,6.32707075129367,657105,125701635.66254,16787779609932.7,573.604026845638,1205226,18538368.0
1182,BTC,2020-11-16,718719855,751494266,497532,1042566,751494266,311477,587438649,14257,11.6165996778597,657265,138269308.266567,17040598812944.8,529.320754716981,1208931,18538812.0
1182,BTC,2020-11-17,719250144,752057200,562934,1140199,752057200,347772,587786421,17092,8.71493829135134,657422,138880472.94452,17596801059571.4,544.192307692307,1282460,18546393.0
1182,BTC,2020-11-18,719816804,752642423,585223,1193670,752642423,362007,588148428,18512,8.09420666238291,657591,147839540.437486,17596801059571.4,511.214285714285,1262037,18547450.0
1182,BTC,2020-11-19,720317239,753161866,519443,1062290,753161866,311061,588459489,16102,7.64628079793587,657728,122470303.583478,17596801059571.4,617.110294117647,1330062,18548843.0
1182,BTC,2020-11-20,720913070,753725928,564062,1188355,753725928,348026,588807515,17818,7.06845440674473,657896,149283515.747075,17596801059571.4,506.269461077844,1285111,18549350.0
1182,BTC,2020-11-21,721439692,754220553,494625,1028346,754220553,311189,589118704,13628,6.12862440781037,658065,148286728.069291,17596801059571.4,509.672619047619,1150172,18550412.0
1182,BTC,2020-11-22,721865633,754659310,438757,876077,754659310,271125,589389829,12455,7.03846034073088,658239,152675060.617924,17596801059571.4,495.023121387283,929209,18551500.0
1182,BTC,2020-11-23,722324918,755148299,488989,1008161,755148299,297840,589687669,15857,7.54313735062201,658386,129230450.54168,17596801059571.4,584.828767123288,1229474,18552425.0
1182,BTC,2020-11-24,722755376,755693037,544738,1060309,755693037,333293,590020962,17908,7.04058683674179,658522,118259857.709971,17596801059571.4,639.081481481481,1271609,18553268.0
1182,BTC,2020-11-25,723243668,756274374,581337,1133404,756274374,361990,590382952,17320,6.1129444069263,658677,135492759.106669,17596801059571.4,557.798701298701,1233440,18554243.0
1182,BTC,2020-11-26,723781179,756802511,528137,1124058,756802511,323975,590706927,18053,7.05064291780335,658827,132051350.579241,17596801059571.4,572.335570469799,1296814,18555262.0
1182,BTC,2020-11-27,724342682,757319158,516647,1103114,757319158,322445,591029372,15805,5.76147075189828,658981,137731500.011397,17596801059571.4,548.732026143791,1285159,18556231.0
1182,BTC,2020-11-28,724910215,757797452,478294,1050540,757797452,293949,591323321,12108,4.41484270669786,659135,135453399.575448,17596801059571.4,557.960784313726,1320298,18557187.0
1182,BTC,2020-11-29,725350319,758237880,440428,890939,758237880,263573,591586894,11422,4.84115390435564,659285,135455041.370995,18158528379021.4,575.765100671141,1104827,18558100.0
1182,BTC,2020-11-30,725721497,758681443,443563,893156,758681443,256551,591843445,15965,8.78675087512078,659398,106744903.730206,19157154724710.1,770.803571428571,1318501,18558843.0
1182,BTC,2020-12-01,726232543,759297759,616316,1173783,759297759,378068,592221513,19825,5.55406548223148,659550,145832294.23186,19157154724710.1,564.205298013245,1277175,18559718.0
1182,BTC,2020-12-02,726649746,759838693,540934,1021217,759838693,327019,592548532,15409,5.12540649694067,659681,131246360.56732,19157154724710.1,626.907692307693,1256613,18560625.0
1182,BTC,2020-12-03,727211934,760395561,556868,1173566,760395561,346921,592895453,16227,4.38899293998524,659838,148845920.080462,19157154724710.1,552.782051282051,1310205,18561562.0
1182,BTC,2020-12-04,727728552,760918943,523382,1077785,760918943,318894,593214347,15108,5.97236864933793,659982,136252489.553084,19157154724710.1,603.874125874126,1321027,18562518.0
1182,BTC,2020-12-05,728312106,761391095,472152,1079825,761391095,282599,593496946,11482,5.3967998008901,660126,137229819.368864,19157154724710.1,599.573426573427,1342303,18563375.0
1182,BTC,2020-12-06,728786134,761825716,434621,917279,761825716,258624,593755570,11129,5.15165699010645,660262,129879829.503767,19157154724710.1,633.503703703704,1348579,18564237.0
1182,BTC,2020-12-07,729263226,762316958,491242,1021082,762316958,300906,594056476,15849,5.16499805518112,660412,141929931.244405,19157154724710.1,579.718120805369,1202576,18565193.0
1182,BTC,2020-12-08,729758306,762857375,540417,1066196,762857375,330970,594387446,16301,4.89174536006705,660556,137731015.754586,19157154724710.1,597.391608391608,1286537,18566037.0
1182,BTC,2020-12-09,730228600,763390482,533107,1062909,763390482,321079,594708525,16380,6.12680044491589,660695,132766047.937184,19157154724710.1,619.731884057971,1275817,18566893.0
1182,BTC,2020-12-10,730680659,763905005,514523,996607,763905005,313649,595022174,15047,6.26792305757107,660825,124191616.924921,19157154724710.1,662.519379844961,1306710,18567718.0
1182,BTC,2020-12-11,731201481,764415818,510813,1079199,764415818,304735,595326909,14860,4.66563085277976,660963,132051021.692124,19157154724710.1,623.087591240876,1325937,18568575.0
1182,BTC,2020-12-12,731678716,764901854,486036,968857,764901854,295410,595622319,12133,4.80674415288362,661095,129573784.294554,19157154724710.1,635.0,1296116,18569431.0
1182,BTC,2020-12-13,732160677,765356974,455120,950690,765356974,276160,595898479,12146,6.00418629250572,661251,150739053.708621,19144667899932.9,545.483870967742,1174223,18570325.0
1182,BTC,2020-12-14,732605137,765865231,508257,984095,765865231,314350,596212829,15197,6.60420067303588,661396,134421060.338004,18670168558399.6,596.541666666666,1171579,18571331.0
1182,BTC,2020-12-15,733091084,766390022,524791,1051653,766390022,320440,596533269,16593,6.74171526518893,661536,130266223.041344,18670168558399.6,615.568345323741,1292509,18572193.0
1182,BTC,2020-12-16,733554810,766913074,523052,1097514,766913074,315217,596848486,19041,8.59597546738659,661679,133288021.613468,18670168558399.6,601.612676056338,1309532,18573056.0
1182,BTC,2020-12-17,733970231,767447574,534500,1071652,767447574,309481,597157967,23131,8.08809533238697,661808,121567122.398753,18670168558399.6,659.6171875,1299902,18573900.0
1182,BTC,2020-12-18,734470052,768045872,598298,1197425,768045872,375549,597533516,22214,6.48632129290532,661965,146653978.822304,18670168558399.6,546.782051282052,1271535,18574837.0
1182,BTC,2020-12-19,735027722,768590672,544800,1169476,768590672,343536,597877052,17226,4.84702054331962,662123,148003560.331923,18670168558399.6,541.796178343949,1265624,18575868.0
1182,BTC,2020-12-20,735601767,769059566,468894,1083257,769059566,282043,598159095,14090,4.69091563881468,662274,140904415.273067,18670168558399.6,569.093333333333,1344026,18576800.0
1182,BTC,2020-12-21,736174052,769522582,463016,1128470,769522582,269834,598428929,18336,6.46166815226035,662410,126187206.30896,18670168558399.6,635.466666666667,1345368,18577656.0
1182,BTC,2020-12-22,736683049,770052719,530137,1102565,770052719,324163,598753092,18572,6.29558303692281,662553,132082061.019348,18670168558399.6,607.105633802817,1302079,18578543.0
1182,BTC,2020-12-23,737182891,770594863,542144,1136460,770594863,338463,599091555,19150,5.92680575567179,662707,146014564.832398,18670168558399.6,549.176470588236,1246276,18579506.0
1182,BTC,2020-12-24,737625321,771044050,449187,975658,771044050,269559,599361114,17239,7.84675139436131,662833,117032358.648192,18670168558399.6,685.176,1270105,18580300.0
1182,BTC,2020-12-25,738148486,771522499,478449,1030838,771522499,303901,599665015,14912,6.72414631828339,662977,136008186.001496,18670168558399.6,589.580419580419,1285844,18581200.0
1182,BTC,2020-12-26,738598345,771974755,452256,954584,771974755,273954,599938969,16465,7.34991010214014,663114,128678888.71035,18670168558399.6,623.161764705883,1384865,18582056.0
1182,BTC,2020-12-27,739110765,772481993,507238,1066022,772481993,309005,600247974,20289,8.13777996358926,663262,137488787.721032,18670168558399.6,583.231292517007,1303959,18582906.0
1182,BTC,2020-12-28,739671173,772996501,514508,1150942,772996501,308983,600556957,21431,6.41087699795963,663422,147717816.427482,18600034145237.6,540.805031446541,1296631,18583968.0
1182,BTC,2020-12-29,740223187,773559083,562582,1154890,773559083,336311,600893268,22140,5.4888091136226,663574,140478190.048268,18599593048299.5,568.662251655629,1276643,18584931.0
1182,BTC,2020-12-30,740783216,774129418,570335,1221423,774129418,338258,601231526,22841,5.15435214163171,663746,159036418.14669,18599593048299.5,502.304093567252,1256574,18585987.0
1182,BTC,2020-12-31,741363069,774701663,572245,1208524,774701663,344918,601576444,21864,5.64028845103271,663912,155538636.801704,18599593048299.5,513.6,1277365,18587056.0
1182,BTC,2021-01-01,741872402,775147152,445489,1003690,775147152,258080,601834524,15797,6.21278756087911,664061,137373667.171879,18599593048299.5,581.513513513513,1352232,18587962.0
1182,BTC,2021-01-02,742407823,775666875,519723,1144903,775666875,297111,602131635,22745,7.28499885814611,664212,139604774.145181,18599593048299.5,572.22,1395637,18588906.0
1182,BTC,2021-01-03,742964727,776267552,600677,1194185,776267552,359116,602490751,24479,6.15902739609335,664370,148896964.17315,18599593048299.5,536.509554140127,1288693,18589912.0
1182,BTC,2021-01-04,743569190,776884524,616972,1282625,776884524,373734,602864485,27457,5.14409050528344,664543,159433735.326268,18599593048299.5,501.052325581395,1318806,18590900.0
1182,BTC,2021-01-05,744113885,777486054,601530,1239169,777486054,354091,603218576,25699,6.24109114892991,664700,145480492.200318,18599593048299.5,549.108974358975,1292713,18592000.0
1182,BTC,2021-01-06,744728919,778144414,658360,1348484,778144414,397384,603615960,28639,5.36368535106927,664877,165943126.308318,18599593048299.5,481.397727272727,1293667,18593112.0
1182,BTC,2021-01-07,745265265,778829807,685393,1296053,778829807,401744,604017704,34806,6.84804800584793,665045,154599911.056023,18599593048299.5,516.718562874252,1269575,18594037.0
1182,BTC,2021-01-08,745759445,779467096,637289,1239827,779467096,358526,604376230,31884,7.02572560140793,665193,139558882.958015,18599593048299.5,572.408163265306,1295011,18594962.0
1182,BTC,2021-01-09,746242571,780027077,559981,1102951,780027077,321389,604697619,23013,5.98691479572966,665332,135740867.829055,19365166707094.9,612.731884057971,1260930,18595837.0
1182,BTC,2021-01-10,746804522,780593860,566783,1183261,780593860,331865,605029484,24315,5.43161009560484,665491,163023206.213822,20607418304385.6,542.917721518988,1282691,18596825.0
1182,BTC,2021-01-11,747336256,781168591,574731,1211336,781168591,333958,605363442,29222,7.30231926323891,665645,158899729.105937,20607418304385.6,557.006535947712,1337251,18597787.0
1182,BTC,2021-01-12,747901852,781739815,571224,1213667,781739815,336627,605700069,26485,6.56729633476468,665793,152161293.801981,20607418304385.6,581.673469387755,1324212,18598712.0
1182,BTC,2021-01-13,748436612,782277087,537272,1167752,782277087,319167,606019236,22701,5.58287210911228,665945,156075398.090874,20607418304385.6,567.086092715232,1264865,18599662.0
1182,BTC,2021-01-14,748945207,782851648,574561,1170717,782851648,338809,606358045,24992,5.71106599146965,666092,150610093.359595,20607418304385.6,587.664383561643,1296483,18600581.0
1182,BTC,2021-01-15,749523565,783425860,574212,1210431,783425860,344002,606702047,24089,5.04584120519764,666247,162947839.77547,20607418304385.6,543.168831168831,1315265,18601556.0
1182,BTC,2021-01-16,750058808,783965959,540099,1120297,783965959,308461,607010508,18872,5.50810940234581,666394,152326897.870614,20607418304385.6,581.041095890411,1319768,18602468.0
1182,BTC,2021-01-17,750558942,784436408,470449,1013712,784436408,271874,607282382,17525,5.24529548279008,666527,137960899.021625,20607418304385.6,641.545454545455,1324590,18603300.0
1182,BTC,2021-01-18,751071869,784956807,520399,1089185,784956807,313816,607596198,21187,5.70048874635203,666672,148425846.636333,20607418304385.6,596.3125,1342526,18604112.0
1182,BTC,2021-01-19,751559658,785500115,543308,1106821,785500115,325083,607921281,22889,6.49604357400922,666821,153253758.751253,20607418304385.6,577.527027027027,1278255,18605243.0
1182,BTC,2021-01-20,752028062,786035260,535145,1097715,786035260,314809,608236090,21859,6.42042687212341,666962,147331236.018809,20607418304385.6,600.742857142857,1277115,18606018.0
1182,BTC,2021-01-21,752497508,786549678,514418,1076271,786549678,290754,608526844,22955,7.60097643203426,667091,135865969.755085,20607418304385.6,651.4375,1313049,18606912.0
1182,BTC,2021-01-22,752986402,787095545,545867,1104253,787095545,323868,608850712,22112,6.17882691998904,667232,151725844.567345,20607418304385.6,583.342857142857,1283207,18607706.0
1182,BTC,2021-01-23,753557944,787620133,524588,1141674,787620133,308276,609158988,17664,5.30784243346251,667388,162699189.339284,20736254808568.4,547.4,1289854,18608693.0
1182,BTC,2021-01-24,754069189,788067621,447488,1006861,788067621,253971,609412959,15972,5.96800166470601,667527,143287605.277948,20823531150111.5,624.173913043478,1307027,18609556.0
1182,BTC,2021-01-25,754605807,788587042,519421,1124380,788587042,309102,609722061,22218,7.48475510401586,667667,145224554.670961,20823531150111.5,615.848920863309,1380525,18610425.0
1182,BTC,2021-01-26,755188627,789139653,552611,1187227,789139653,336935,610058996,21274,5.05701111881645,667828,168253849.478708,20823531150111.5,531.55625,1360394,18611475.0
1182,BTC,2021-01-27,755671390,789683721,544068,1108814,789683721,323553,610382549,20553,6.16702415776145,667970,146373664.574098,20823531150111.5,611.014184397163,1286615,18612318.0
1182,BTC,2021-01-28,756160740,790225148,541427,1104168,790225148,325146,610707695,20802,6.70978034055117,668115,154819795.156434,20823531150111.5,577.680555555555,1315946,18613231.0
1182,BTC,2021-01-29,756648975,790855085,629937,1217518,790855085,341036,611048731,28194,7.31090882075555,668267,156871309.654217,20823531150111.5,570.12582781457,1313147,18614175.0
1182,BTC,2021-01-30,757125547,791386048,530963,1089067,791386048,312313,611361044,20195,6.26676727094655,668403,142434786.858136,20823531150111.5,627.911111111111,1301743,18615025.0
1182,BTC,2021-01-31,757645202,791889510,503462,1080570,791889510,290753,611651797,18009,6.84860199423837,668547,149173652.471058,20823531150111.5,599.545454545455,1310972,18615925.0
1182,BTC,2021-02-01,758024762,792381085,491575,985275,792381085,277579,611929376,23057,6.74889688444385,668666,128856710.695621,20823531150111.5,694.07627118644,1312293,18616706.0
1182,BTC,2021-02-02,758535534,792982589,601504,1216327,792982589,367835,612297211,25218,5.37731109512855,668819,157998286.422739,20823531150111.5,566.059210526316,1301597,18617631.0
1182,BTC,2021-02-03,759031231,793557115,574526,1193560,793557115,344425,612641636,25674,5.99592264592457,668969,154522511.668228,20823531150111.5,578.791946308725,1301816,18618562.0
1182,BTC,2021-02-04,759542172,794156835,599720,1234340,794156835,367788,613009424,25704,5.93064305037195,669129,167960612.520376,20823531150111.5,532.48427672956,1286774,18619443.0
1182,BTC,2021-02-05,760126707,794750903,594068,1262356,794750903,360541,613369965,23057,5.43592606875556,669298,178526344.433187,20823531150111.5,500.970238095238,1303817,18620618.0
1182,BTC,2021-02-06,760663303,795311779,560876,1163858,795311779,333886,613703851,22476,6.45983652310064,669457,169264948.4051,21384451039675.4,542.613924050633,1286239,18621618.0
1182,BTC,2021-02-07,761215307,795827268,515489,1156729,795827268,286364,613990215,19136,7.1530551749068,669613,166003217.825493,21434395961348.9,554.567741935484,1393552,18622587.0
1182,BTC,2021-02-08,761761251,796398523,571255,1248710,796398523,335223,614325438,29643,6.75269562212655,669775,175172136.054281,21434395961348.9,525.540372670807,1386773,18623612.0
1182,BTC,2021-02-09,762188467,797032861,634338,1184738,797032861,360137,614685575,34668,9.4421296466899,669918,151829549.503114,21434395961348.9,606.338028169014,1278955,18624493.0
1182,BTC,2021-02-10,762627572,797610384,577523,1189875,797610384,340758,615026333,29930,6.34679787146306,670061,157561038.137814,21434395961348.9,584.281690140846,1290298,18625387.0
1182,BTC,2021-02-11,763019266,798164361,553977,1067369,798164361,304739,615331072,27489,7.81561453631593,670190,138302901.304301,21434395961348.9,665.640625,1271182,18626193.0
1182,BTC,2021-02-12,763454520,798752039,587678,1153262,798752039,343306,615674378,27026,6.24384313485785,670332,151423354.088805,21434395961348.9,607.964539007092,1272982,18627081.0
1182,BTC,2021-02-13,764041517,799305483,553444,1224606,799305483,336624,616011002,21918,4.5287810996273,670489,167526358.71856,21434395961348.9,549.525641025641,1319357,18628175.0
1182,BTC,2021-02-14,764594445,799792519,487036,1118974,799792519,295428,616306430,20304,6.38474522588252,670637,163714742.871919,21434395961348.9,562.319727891157,1323321,18628987.0
1182,BTC,2021-02-15,765116445,800329925,537406,1146720,800329925,311322,616617752,24925,7.62802109761886,670789,166939647.882667,21434395961348.9,551.456953642384,1322547,18629937.0
1182,BTC,2021-02-16,765494808,800842536,512611,996111,800842536,296388,616914140,26875,8.48654429001751,670910,129869316.745286,21434395961348.9,708.866666666667,1296827,18630737.0
1182,BTC,2021-02-17,765924828,801400538,558002,1142720,801400538,317666,617231806,30238,6.54050573936855,671048,147435519.310537,21434395961348.9,624.408759124088,1291019,18631556.0
1182,BTC,2021-02-18,766368084,801963918,563380,1142942,801963918,316952,617548758,28703,6.9503301740154,671185,147589490.09486,21434395961348.9,623.757352941176,1305050,18632493.0
1182,BTC,2021-02-19,766869800,802569931,606013,1251430,802569931,341586,617890344,31456,6.92649231744234,671338,164643584.365526,21455226865438.3,559.690789473684,1328641,18633375.0
1182,BTC,2021-02-20,767364245,803143966,574035,1194605,803143966,320475,618210819,29402,6.85064364021556,671484,157008925.526777,21724134900047.3,594.262068965518,1321612,18634225.0
1182,BTC,2021-02-21,767835695,803619252,475286,1046681,803619252,271645,618482464,24637,6.56950137276604,671625,156887652.68425,21724134900047.3,594.721428571428,1445759,18635162.0
1182,BTC,2021-02-22,768266253,804135577,516325,1099128,804135577,285383,618767847,29768,6.97743525692263,671758,149202118.292689,21724134900047.3,625.35606060606,1334959,18635993.0
1182,BTC,2021-02-23,768667220,804674797,539220,1062759,804674797,287884,619055731,31583,7.54989837842871,671885,137137197.908815,21724134900047.3,680.373015873016,1298336,18636787.0
1182,BTC,2021-02-24,769189112,805281300,606503,1242369,805281300,358092,619413823,29099,5.92423107085157,672044,172043961.008263,21724134900047.3,542.32911392405,1309937,18637700.0
1182,BTC,2021-02-25,769710726,805846903,565603,1220361,805846903,326116,619739939,27359,7.09388736740378,672200,168209981.554221,21724134900047.3,554.690322580645,1301001,18638756.0
1182,BTC,2021-02-26,770150945,806395584,548681,1125624,806395584,306416,620046355,26019,6.75260979436061,672339,150894914.536149,21724134900047.3,618.340579710145,1293684,18639625.0
1182,BTC,2021-02-27,770713045,806944819,549235,1206178,806944819,320784,620367139,19727,5.22958917732814,672496,169608870.318778,21724134900047.3,550.115384615385,1291870,18640606.0
1182,BTC,2021-02-28,771220456,807383519,438700,1033356,807383519,254316,620621455,19883,6.81250273157237,672627,142167376.092633,21724134900047.3,656.3,1364487,18641425.0
1182,BTC,2021-03-01,771661475,807893748,510229,1089780,807893748,280485,620901940,25209,6.36139202689737,672757,142388874.045235,21724134900047.3,655.279069767442,1347932,18642237.0
1182,BTC,2021-03-02,772147261,808460563,566815,1135141,808460563,338150,621240090,25592,5.58509061262375,672900,155858645.633382,21724134900047.3,598.647887323943,1309441,18643143.0
1182,BTC,2021-03-03,772626592,809034274,573711,1186311,809034274,333402,621573492,26889,5.62550796182926,673052,163390179.503055,21724134900047.3,571.05298013245,1301007,18644081.0
1182,BTC,2021-03-04,773028495,809546782,512508,1046922,809546782,289631,621863123,24879,5.24332122892239,673180,138868686.441563,21724134900047.3,671.889763779527,1287553,18644881.0
1182,BTC,2021-03-05,773527516,810090499,543717,1169154,810090499,317780,622180903,23833,5.60049330387252,673329,161704257.076713,21724134900047.3,577.006756756757,1323912,18645812.0
1182,BTC,2021-03-06,774101961,810562447,471948,1133078,810562447,287963,622468866,19018,5.32334950142084,673481,162497758.769467,21473685655440.1,567.569536423841,1352091,18646762.0
1182,BTC,2021-03-07,774606797,811021958,459511,1050974,811021958,260739,622729605,19357,8.17357949689429,673627,156730413.296509,21448277761059.7,587.758620689656,1369775,18647681.0
1182,BTC,2021-03-08,775148200,811516234,494276,1174988,811516234,291955,623021560,24576,6.71392745637311,673782,164845354.199427,21448277761059.7,558.824675324675,1410230,18648643.0
1182,BTC,2021-03-09,775582788,812049915,533681,1091867,812049915,299682,623321242,29046,6.50943248704397,673922,150609058.72757,21448277761059.7,611.647482014389,1311160,18649518.0
1182,BTC,2021-03-10,776063258,812628614,578699,1183231,812628614,344688,623665930,28627,4.95295295051232,674071,160735058.862932,21448277761059.7,573.114864864865,1299936,18650450.0
1182,BTC,2021-03-11,776467061,813137385,508771,1086818,813137385,291245,623957175,26392,5.78991751144535,674203,144155320.579182,21448277761059.7,639.030534351145,1284828,18651275.0
1182,BTC,2021-03-12,776968393,813691998,554613,1189158,813691998,320744,624277919,26825,4.37730474898336,674353,164241520.136795,21448277761059.7,560.879194630873,1314888,18652212.0
1182,BTC,2021-03-13,777441235,814189142,497144,1115013,814189142,277072,624554991,25530,4.3265599782161,674496,153216249.514818,21448277761059.7,601.239436619718,1407024,18653031.0
1182,BTC,2021-03-14,777987076,814705682,516540,1167862,814705682,308050,624863041,23124,4.25484499792972,674653,167677887.147939,21448277761059.7,549.384615384615,1316139,18654087.0
1182,BTC,2021-03-15,778469787,815229987,524305,1171129,815229987,292231,625155272,28327,4.46466310272226,674801,158233100.914624,21448277761059.7,582.1768707483,1356310,18655012.0
1182,BTC,2021-03-16,778959361,815794808,564821,1167303,815794808,319493,625474765,27469,4.57697467921908,674950,160125298.644799,21448277761059.7,575.297297297297,1324155,18655943.0
1182,BTC,2021-03-17,779367513,816341622,546814,1126915,816341622,296119,625770884,26649,4.93027926242673,675086,145214303.570787,21448277761059.7,634.370370370371,1292900,18656793.0
1182,BTC,2021-03-18,779845495,816946746,605124,1215730,816946746,331718,626102602,27045,3.93603976066276,675238,164353605.274775,21448277761059.7,560.496688741722,1261881,18657743.0
1182,BTC,2021-03-19,780322164,817514981,568235,1167778,817514981,316180,626418782,25886,3.88759048714346,675386,158225262.662361,21524403218194.0,584.272108843537,1323033,18658668.0
1182,BTC,2021-03-20,780838288,818021894,506913,1141770,818021894,286948,626705730,21712,3.97670735305014,675540,166846815.72598,21865558044610.5,562.862745098039,1335281,18659631.0
1182,BTC,2021-03-21,781384320,818450512,428618,1106157,818450512,234936,626940666,20242,4.7300935038041,675696,171247003.483574,21865558044610.5,548.4,1455319,18660606.0
1182,BTC,2021-03-22,781870239,818986310,535798,1151612,818986310,297410,627238076,26069,4.38125279841552,675847,165959148.76779,21865558044610.5,565.873333333333,1357444,18661568.0
1182,BTC,2021-03-23,782442598,819549233,562923,1241595,819549233,314234,627552310,26779,5.79198225744051,676008,174614152.764174,21865558044610.5,537.825,1352368,18662556.0
1182,BTC,2021-03-24,782945291,820082152,532919,1163145,820082152,305093,627857403,27133,5.38282575997712,676160,168424751.333427,21865558044610.5,557.58940397351,1353617,18663506.0
1182,BTC,2021-03-25,783461297,820648218,566066,1212522,820648218,318562,628175965,28094,5.38260470657913,676314,169013504.560307,21865558044610.5,555.64705882353,1316496,18664468.0
1182,BTC,2021-03-26,783908228,821186095,537877,1098753,821186095,293610,628469575,26288,4.95876424667505,676450,149430131.606649,21865558044610.5,628.466666666667,1318635,18665318.0
1182,BTC,2021-03-27,784430237,821679160,493065,1154917,821679160,288259,628757834,21147,4.28176144955148,676609,173186191.86295,21865558044610.5,542.259493670886,1298147,18666312.0
1182,BTC,2021-03-28,784967056,822112927,433767,1076860,822112927,248605,629006439,19932,3.70817755322825,676768,174106746.459236,21865558044610.5,539.392405063291,1315239,18667306.0
1182,BTC,2021-03-29,785419210,822640269,527342,1120831,822640269,303305,629309744,27066,5.30288071737973,676919,164390408.637533,21865558044610.5,571.273333333333,1282992,18668250.0
1182,BTC,2021-03-30,785885266,823200549,560280,1156120,823200549,321090,629630834,27942,4.66658692283786,677065,157977878.847371,21865558044610.5,594.462068965517,1312332,18669162.0
1182,BTC,2021-03-31,786389319,823803223,602674,1250492,823803223,332749,629963583,28663,4.09869458329257,677222,171097806.094262,21865558044610.5,548.878205128205,1345339,18670150.0
1182,BTC,2021-04-01,786837829,824353489,550266,1142123,824353489,311939,630275522,28573,4.38276510196894,677367,157355713.411485,21865558044610.5,596.8125,1336590,18671056.0
1182,BTC,2021-04-02,787273234,824882603,529114,1111019,824882603,305788,630581310,26500,4.52985447162544,677507,160855024.036115,23064760716651.4,615.848920863309,1314276,18671931.0
1182,BTC,2021-04-03,787718823,825360748,478145,1030471,825360748,281717,630863027,22694,4.76755715561677,677638,151656309.50046,23137439666472.1,655.261538461539,1312162,18672743.0
1182,BTC,2021-04-04,788225019,825780379,419631,1043036,825780379,246007,631109034,20264,4.70890166601292,677784,168974602.975048,23137439666472.1,588.103448275862,1370052,18673668.0
1182,BTC,2021-04-05,788799002,826295695,515316,1228669,826295695,289046,631398080,27275,6.0624156361668,677940,178571649.089395,23137439666472.1,556.496774193549,1408721,18674631.0
1182,BTC,2021-04-06,789278324,826869938,574243,1196411,826869938,309565,631707645,30139,6.82550094513059,678084,165680243.617725,23137439666472.1,599.797202797203,1343027,18675531.0
1182,BTC,2021-04-07,789808326,827440137,570199,1248811,827440137,321319,632028964,29782,5.29531993839745,678241,180763159.037145,23137439666472.1,549.75,1304126,18676512.0
1182,BTC,2021-04-08,790235885,827949886,509749,1099573,827949886,278534,632307498,24826,5.39301758332329,678375,158752909.271977,23137439666472.1,625.96992481203,1314213,18677306.0
1182,BTC,2021-04-09,790764182,828514464,564578,1230357,828514464,324720,632632218,25920,4.91378504556073,678527,175421516.819982,23137439666472.1,566.490066225165,1328603,18678306.0
1182,BTC,2021-04-10,791295162,829027268,512804,1167266,829027268,299086,632931304,23644,5.15221656109216,678684,180927713.574275,23137439666472.1,549.25,1351301,18679200.0
1182,BTC,2021-04-11,791790704,829476008,448740,1056340,829476008,253449,633184753,21505,5.40522090738705,678829,167308952.671771,23137439666472.1,593.958333333334,1377041,18680187.0
1182,BTC,2021-04-12,792260670,829991122,515114,1131851,829991122,291369,633476122,29047,5.75656641386218,678973,166759296.086837,23137439666472.1,595.916083916083,1345640,18681093.0
1182,BTC,2021-04-13,792700711,830557153,566031,1178675,830557153,310213,633786335,32499,6.15971380586429,679115,163880831.368123,23137439666472.1,606.382978723404,1337717,18681975.0
1182,BTC,2021-04-14,793106159,831112467,555314,1155927,831112467,297494,634083829,32244,6.13617280156013,679250,156880683.017517,23137439666472.1,633.440298507463,1288458,18682818.0
1182,BTC,2021-04-15,793679081,831743162,630695,1368446,831743162,359440,634443269,29233,5.13907071318112,679422,199064807.727985,23217560568175.2,500.93567251462,1317252,18683900.0
1182,BTC,2021-04-16,793943717,832221379,478217,938241,832221379,219704,634662973,26454,8.36657766105333,679525,120462116.646172,23581981443663.8,840.794117647059,1317298,18684537.0
1182,BTC,2021-04-17,794234954,832618432,397053,842490,832618432,194580,634857553,20615,5.86765387676174,679616,109966288.474285,23581981443663.8,921.044444444444,1355659,18685106.0
1182,BTC,2021-04-18,794632422,833117841,499409,1052011,833117841,274735,635132288,26335,6.02672667808193,679740,146563673.015012,23581981443663.8,691.056910569106,1294181,18685881.0
1182,BTC,2021-04-19,794921993,833562617,444776,890831,833562617,208413,635340701,24067,6.14061206554845,679837,121069947.46971,23581981443663.8,836.572916666667,1305400,18686487.0
1182,BTC,2021-04-20,795357760,834125304,562687,1126096,834125304,279977,635620678,28286,6.6772411432238,679965,150095655.2886,23581981443663.8,674.795275590551,1329866,18687287.0
1182,BTC,2021-04-21,795659792,834596998,471694,925510,834596998,226021,635846699,24989,8.54190269488671,680066,120088496.787346,23581981443663.8,843.41,1306862,18687918.0
1182,BTC,2021-04-22,796153867,835090200,493202,1124380,835090200,274610,636121309,28151,7.97319134706511,680209,171702364.393693,23581981443663.8,589.880281690141,1276191,18688825.0
1182,BTC,2021-04-23,796597541,835598046,507846,1121883,835598046,295731,636417040,28999,7.38805932516324,680344,157171049.148898,23581981443663.8,644.417910447761,1315820,18689656.0
1182,BTC,2021-04-24,797123354,836049458,451412,1129982,836049458,290690,636707730,18911,5.50875631010509,680489,170356166.36134,23581981443663.8,594.541666666666,1326225,18690562.0
1182,BTC,2021-04-25,797643644,836435426,385968,1033232,836435426,241041,636948771,18076,6.79228806585768,680630,168647789.228679,23581981443663.8,600.564285714286,1342451,18691543.0
1182,BTC,2021-04-26,798002181,836870179,434753,948650,836870179,240687,637189458,25114,8.94759067580655,680744,134191675.544583,23581981443663.8,754.769911504425,1314773,18692175.0
1182,BTC,2021-04-27,798493964,837367988,497809,1097458,837367988,298109,637487567,26455,7.67729589571798,680886,168059467.492392,23581981443663.8,602.666666666667,1316657,18693043.0
1182,BTC,2021-04-28,798988943,837835367,467379,1121374,837835367,277126,637764693,24669,7.23748087117585,681028,169892828.96101,23581981443663.8,596.163120567376,1311624,18693931.0
1182,BTC,2021-04-29,799374038,838290175,454808,997879,838290175,259465,638024158,24810,8.14574116824998,681150,142102484.005951,23581981443663.8,712.752066115702,1364329,18694693.0
1182,BTC,2021-04-30,799879991,838771837,481662,1119846,838771837,289389,638313547,26472,7.91699162089309,681295,172859800.730791,23581981443663.8,585.930555555555,1388769,18695600.0
1182,BTC,2021-05-01,800348995,839205504,433667,1051913,839205504,262991,638576538,21595,6.11840288121468,681434,161149664.886615,23004465874892.7,613.115942028986,1345956,18696468.0
1182,BTC,2021-05-02,801074841,839589867,384363,1248561,839589867,235214,638811752,19255,6.34399190880079,681619,193120622.70463,20608845737768.2,458.336956521739,1407752,18697631.0
1182,BTC,2021-05-03,801718461,840079109,489242,1271242,840079109,287007,639098759,27150,7.52780586691917,681796,181377576.522949,20608845737768.2,488.011363636364,1462600,18698731.0
1182,BTC,2021-05-04,802356557,840590609,511500,1295533,840590609,300824,639399583,27895,7.58425241591612,681977,185383241.661596,20608845737768.2,477.466666666667,1336464,18699756.0
1182,BTC,2021-05-05,802907680,841124029,533420,1216037,841124029,309774,639709357,27860,5.90580547414906,682134,161475257.311936,20608845737768.2,548.160256410256,1347644,18700850.0
1182,BTC,2021-05-06,803436866,841659238,535209,1242448,841659238,311380,640020737,27955,5.8102132493709,682304,174003650.366899,20608845737768.2,508.692307692308,1361765,18701912.0
1182,BTC,2021-05-07,803956252,842180902,521664,1195688,842180902,307988,640328725,27155,6.30091916657909,682476,176859017.729148,20608845737768.2,500.479532163743,1296296,18702987.0
1182,BTC,2021-05-08,804459043,842660386,479484,1177648,842660386,274691,640603416,23402,5.01390734934148,682647,175722091.470992,20608845737768.2,503.717647058824,1310903,18704050.0
1182,BTC,2021-05-09,805093717,843102904,442518,1241582,843102904,247866,640851282,22096,4.38550282605319,682833,193207977.365367,20608845737768.2,458.12972972973,1360895,18705212.0
1182,BTC,2021-05-10,805716823,843636868,533964,1317509,843636868,303297,641154579,30089,4.6623053183778,683013,184802741.038224,20608845737768.2,478.966480446927,1374446,18706343.0
1182,BTC,2021-05-11,806261092,844192448,555580,1250432,844192448,312115,641466694,27627,3.86178368003678,683185,176778459.201551,20608845737768.2,500.707602339181,1349528,18707500.0
1182,BTC,2021-05-12,806810350,844753468,561020,1266735,844753468,300452,641767146,26830,5.18589408233092,683357,175872608.762241,20608845737768.2,503.286549707602,1371222,18708593.0
1182,BTC,2021-05-13,807294315,845253146,499678,1192796,845253146,276472,642043618,28792,9.05162880045647,683518,188039107.938533,23227330060562.8,530.53125,1311555,18709568.0
1182,BTC,2021-05-14,807709134,845726775,473629,1072614,845726775,266055,642309673,25156,8.61417627321644,683652,173036154.461774,25046487590083.3,621.684210526315,1315543,18710418.0
1182,BTC,2021-05-15,808124267,846137694,410919,963546,846137694,232099,642541772,20343,8.28164338221651,683775,152846467.665698,25046487590083.3,703.803278688525,1347771,18711112.0
1182,BTC,2021-05-16,808585835,846523545,385851,979399,846523545,219435,642761207,19328,8.33025708235819,683907,163408361.708266,25046487590083.3,658.312977099236,1371701,18711925.0
1182,BTC,2021-05-17,808955146,846950309,426764,965712,846950309,250910,643012117,25917,10.3126758661978,684028,154093340.449659,25046487590083.3,698.108333333333,1334121,18712725.0
1182,BTC,2021-05-18,809258489,847341850,391541,857995,847341850,221018,643233135,23052,8.45548973087536,684128,125875359.464207,25046487590083.3,854.606060606061,1332186,18713306.0
1182,BTC,2021-05-19,809618356,847804724,462874,1027970,847804724,263419,643496554,31056,11.4965985235768,684253,161612309.358182,25046487590083.3,665.629032258064,1322285,18713700.0
1182,BTC,2021-05-20,809922835,848222314,417590,945687,848222314,228039,643724593,26705,12.5069777992873,684365,139455022.000579,25046487590083.3,771.387387387387,1304127,18713700.0
1182,BTC,2021-05-21,810229448,848646477,424163,950130,848646477,226351,643950944,22974,9.70081668881534,684475,139134370.971456,25046487590083.3,773.165137614679,1289615,18713700.0
1182,BTC,2021-05-22,810601931,849026694,380217,920089,849026694,223800,644174744,17580,10.5593195735357,684591,144881447.809314,25046487590083.3,742.495652173913,1289550,18713700.0
1182,BTC,2021-05-23,811067584,849365102,338408,966136,849365102,194320,644369064,17920,11.4771665292901,684710,149822528.407567,25046487590083.3,718.008474576271,1379971,18713700.0
1182,BTC,2021-05-24,811490533,849773477,408375,974827,849773477,234755,644603819,23312,11.1198007145614,684836,157862533.868099,25046487590083.3,681.44,1345942,18713700.0
1182,BTC,2021-05-25,811915676,850189274,415797,975706,850189274,233644,644837463,22772,9.80057102215233,684959,153547467.002614,25046487590083.3,700.590163934426,1359462,18718500.0
1182,BTC,2021-05-26,812284918,850591847,402573,942875,850591847,230753,645068216,21746,9.63100953659918,685081,154177497.833206,25046487590083.3,697.727272727273,1300155,18719212.0
1182,BTC,2021-05-27,812607377,850973932,382085,865305,850973932,214035,645282251,20029,9.26329278037092,685198,149709257.476401,25046487590083.3,718.551724137931,1262394,18719993.0
1182,BTC,2021-05-28,813035393,851361901,387969,971076,851361901,218311,645500562,20724,13.2702997455902,685317,149497859.111886,25046487590083.3,719.56779661017,1343872,18720737.0
1182,BTC,2021-05-29,813446676,851709527,347626,873487,851709527,198332,645698894,15473,10.2813741651822,685433,144283273.860742,25046487590083.3,745.573913043478,1322726,18721468.0
1182,BTC,2021-05-30,814012903,852018047,308520,997986,852018047,179795,645878689,13410,6.02102562417698,685577,152415992.63691,21214345448186.2,597.804195804196,1499183,18722362.0
1182,BTC,2021-05-31,814479294,852400398,382351,983731,852400398,226469,646105158,18428,4.97449766033298,685718,152948831.664586,21047730572451.6,591.042857142857,1440666,18723243.0
1182,BTC,2021-06-01,814878821,852805137,404739,921569,852805137,234561,646339719,19409,6.35630120907713,685860,148430297.172387,21047730572451.6,609.035460992908,1365650,18724200.0
1182,BTC,2021-06-02,815394899,853235018,429881,1088205,853235018,250589,646590308,19187,4.6022833683366,686026,175996588.671642,21047730572451.6,513.642424242424,1291096,18725168.0
1182,BTC,2021-06-03,815840354,853677575,442557,1021654,853677575,255621,646845929,19307,4.78444310600405,686173,155954813.500101,21047730572451.6,579.650684931507,1293653,18726087.0
1182,BTC,2021-06-04,816245900,854093778,416203,921892,854093778,236672,647082601,17955,4.34727071004948,686304,136385285.321304,21047730572451.6,662.823076923077,1290167,18726912.0
1182,BTC,2021-06-05,816563177,854436334,342556,779545,854436334,194580,647277181,13987,3.93304330058726,686435,136700992.000289,21047730572451.6,661.292307692308,1083916,18727725.0
1182,BTC,2021-06-06,816893207,854752401,316067,724487,854752401,185305,647462486,12441,9.6225618435284,686585,156766074.127293,21047730572451.6,576.65100671141,948718,18728662.0
1182,BTC,2021-06-07,817296536,855162306,409905,912797,855162306,235479,647697965,18848,9.16157509919029,686718,139378016.553464,21047730572451.6,648.590909090909,1250724,18729550.0
1182,BTC,2021-06-08,817718184,855550802,428306,1008748,855590612,246906,647944871,19365,10.2359580599706,686867,155487745.399291,21047730572451.6,581.391891891892,1286348,18730431.0
1182,BTC,2021-06-09,818014957,855926279,375477,820199,855966089,210911,648155782,17734,6.28497827483839,686993,131728268.260968,21047730572451.6,686.256,1067569,18731243.0
1182,BTC,2021-06-10,818368627,856357884,431605,945059,856397694,252983,648408765,20041,5.58154242804631,687111,123131153.138056,21047730572451.6,734.17094017094,1311452,18731987.0
1182,BTC,2021-06-11,818681312,856754541,396657,889352,856794351,216502,648625267,17678,6.76128165578461,687216,109672072.047789,21047730572451.6,824.269230769231,1401894,18732675.0
1182,BTC,2021-06-12,819193150,857132352,377811,1013404,857172162,222774,648848041,14167,4.53370096348479,687348,138646008.789479,21047730572451.6,652.015267175572,1489759,18733431.0
1182,BTC,2021-06-13,819582589,857456179,323827,806068,857495989,187098,649035139,12120,6.32460802594122,687480,137059266.390093,20836567779802.2,652.946564885496,1174923,18734256.0
1182,BTC,2021-06-14,820001686,857870372,414193,954988,857910182,242416,649277555,18981,6.13409295957424,687615,135220442.110055,19932791027262.7,633.119402985075,1263461,18735168.0
1182,BTC,2021-06-15,820399851,858318097,447725,988538,858357907,241861,649519416,18588,5.80414423264073,687746,129613457.310372,19932791027262.7,660.507692307692,1294162,18735925.0
1182,BTC,2021-06-16,820823417,858749390,431293,956251,858789200,252937,649772353,18531,6.3591198264099,687869,121227815.135007,19932791027262.7,706.196721311476,1354007,18736731.0
1182,BTC,2021-06-17,821202406,859150603,401213,873122,859190413,237725,650010078,18017,6.59862463314523,687999,128876086.026074,19932791027262.7,664.286821705427,1169748,18737500.0
1182,BTC,2021-06-18,821561797,859525324,374721,824328,859565134,222918,650232996,16648,6.98070163623871,688123,129488254.280589,19932791027262.7,661.146341463415,1164026,18738275.0
1182,BTC,2021-06-19,821833023,859841979,316655,699556,859881789,187042,650420038,13481,5.7716827428423,688226,102865943.328658,19932791027262.7,832.254901960785,1187639,18738918.0
1182,BTC,2021-06-20,822093505,860123314,281335,656232,860163124,167249,650587287,13011,7.63983519106871,688331,107062255.601476,19932791027262.7,799.634615384615,1262359,18739581.0
1182,BTC,2021-06-21,822422311,860470298,346984,827011,860510108,205050,650792337,18577,8.52830089900327,688436,105536855.771774,19932791027262.7,811.192307692308,1353235,18740231.0
1182,BTC,2021-06-22,822690985,860813338,343040,776294,860853148,196523,650988860,18211,9.85592860971555,688527,95066648.1863663,19932791027262.7,900.533333333333,1392932,18740850.0
1182,BTC,2021-06-23,823029230,861204703,391365,855569,861244513,232704,651221564,17922,7.83274917657247,688628,101140865.473561,19932791027262.7,846.45,1392618,18741381.0
1182,BTC,2021-06-24,823400814,861589978,385275,861032,861629788,233278,651454842,16644,7.9640186958318,688733,104323760.036674,19932791027262.7,820.625,1380862,18742168.0
1182,BTC,2021-06-25,823815964,861953914,363936,867884,861993724,218245,651673087,17735,10.8953220310733,688843,112607577.451253,19932791027262.7,760.256880733945,1395703,18742725.0
1182,BTC,2021-06-26,824117041,862274238,320324,721267,862314048,181628,651854715,13802,9.77390706442724,688932,87599594.5565036,19932791027262.7,977.295454545455,1420391,18743331.0
1182,BTC,2021-06-27,824266822,862498179,223941,507420,862537989,121538,651976253,11714,10.4997835765079,688990,62034362.7635033,19932791027262.7,1380.05263157895,1425327,18743737.0
1182,BTC,2021-06-28,824570761,862920577,382589,789301,862920578,221000,652197253,18003,7.54229155910543,689078,87110589.7577639,19932791027262.7,982.781609195402,1371275,18744243.0
1182,BTC,2021-06-29,824856123,863274025,353448,802064,863274026,205616,652402869,18281,6.69504902987608,689168,88855405.441732,19932791027262.7,963.483146067416,1401325,18744868.0
1182,BTC,2021-06-30,825131036,863630675,356650,776819,863630676,215304,652618173,16754,5.62666436002355,689256,91491372.41387,19932791027262.7,935.724137931035,1359425,18745356.0
1182,BTC,2021-07-01,825418855,864028542,397867,832632,864028543,233683,652851856,17548,7.15218192671354,689352,96928922.8563659,19932791027262.7,883.231578947369,1392400,18746025.0
1182,BTC,2021-07-02,825743977,864365007,336465,811147,864365008,188568,653040424,15952,9.18930834708864,689442,89312644.5197984,19932791027262.7,958.550561797753,1403917,18746518.0
1182,BTC,2021-07-03,826272430,864743793,378786,1025373,864743794,237463,653277887,14984,5.45933118628094,689569,98844086.0325738,15634861856766.1,679.36507936508,1420467,18747312.0
1182,BTC,2021-07-04,826708487,865035033,291240,853740,865035034,171850,653449737,14562,9.23482518251498,689684,83130581.9608194,14363025673660.0,742.070175438597,1441163,18748037.0
1182,BTC,2021-07-05,827197244,865390926,355893,927307,865390927,223760,653673497,16359,6.43886690156565,689816,93748599.7347723,14363025673660.0,658.022900763359,1327586,18748868.0
1182,BTC,2021-07-06,827570323,865769893,378967,844029,865769894,228279,653901776,17558,5.83910753875648,689958,100942453.795877,14363025673660.0,611.127659574468,1097025,18749687.0
1182,BTC,2021-07-07,827917353,866137360,367467,817306,866137361,221227,654123003,17652,5.99242630134626,690081,88093741.4069354,14363025673660.0,700.262295081967,1173740,18750512.0
1182,BTC,2021-07-08,828271651,866520048,382688,808253,866520049,230719,654353722,17135,14.0924796357709,690220,100892946.235549,14363025673660.0,611.427536231884,1030018,18751381.0
1182,BTC,2021-07-09,828667505,866896426,376378,850023,866896427,227511,654581233,16550,15.056863417787,690351,93491738.2102302,14363025673660.0,659.83076923077,1259713,18752200.0
1182,BTC,2021-07-10,828963299,867215817,319391,708313,867215818,187263,654768496,13476,9.90607108467225,690512,115451692.396908,14363025673660.0,534.325,840594,18753206.0
1182,BTC,2021-07-11,829318645,867506575,290758,719771,867506576,166144,654934640,11847,11.1863449766031,690637,94826905.2643244,14363025673660.0,650.540322580645,1110524,18753931.0
1182,BTC,2021-07-12,829688605,867870904,364329,827843,867870905,220269,655154909,16281,7.61298305079435,690763,89800634.6003476,14363025673660.0,686.952,1177102,18754700.0
1182,BTC,2021-07-13,830074374,868228340,357436,819404,868228341,229916,655384825,17606,6.5903692682334,690899,98824943.0152725,14363025673660.0,624.222222222222,1159622,18755525.0
1182,BTC,2021-07-14,830450765,868599923,371583,827355,868599924,236217,655621042,17390,6.36818091571593,691069,121450060.184018,14363025673660.0,507.934911242604,909874,18756581.0
1182,BTC,2021-07-15,830821333,868970855,370932,838706,868970856,226234,655847276,16826,8.17509205987734,691197,92008927.2167283,14363025673660.0,670.464566929134,1211309,18757487.0
1182,BTC,2021-07-16,831149652,869330528,359673,772846,869330529,223466,656070742,15726,8.18574781389844,691347,107904395.307241,14363025673660.0,571.697986577181,930522,18758425.0
1182,BTC,2021-07-17,831428132,869632385,301857,650785,869632386,182047,656252789,12789,10.2086506183117,691490,102935576.453194,14348541098817.0,598.69014084507,784945,18759318.0
1182,BTC,2021-07-18,831728271,869903663,271278,645619,869903664,161122,656413911,10710,7.27905822007957,691634,97464436.3468652,13672594272814.1,602.510489510489,803860,18760162.0
1182,BTC,2021-07-19,832145321,870265579,361916,851082,870265580,226803,656640714,14968,7.93175169208657,691804,115281579.655385,13672594272814.1,509.390532544379,913009,18761318.0
1182,BTC,2021-07-20,832512875,870635366,369787,829637,870635367,230509,656871223,17521,7.89785222997115,691926,84936404.3133133,13672594272814.1,691.380165289256,1286061,18762106.0
1182,BTC,2021-07-21,832875994,871007899,372533,817021,871007900,235680,657106903,17721,7.95800987368737,692071,100620677.254436,13672594272814.1,583.611111111111,1092054,18762950.0
1182,BTC,2021-07-22,833238074,871379097,371198,808746,871379098,230282,657337185,15275,7.85264727875518,692224,105400520.493216,13672594272814.1,557.144736842106,949214,18763918.0
1182,BTC,2021-07-23,833570845,871749432,370335,802628,871749433,231130,657568315,16069,7.58048578624004,692359,91224431.8150063,13672594272814.1,643.723880597015,1053501,18764756.0
1182,BTC,2021-07-24,833882063,872067715,318283,726848,872067716,198091,657766406,13378,7.58385176441681,692513,104094074.168916,13672594272814.1,564.137254901961,843060,18765718.0
1182,BTC,2021-07-25,834175226,872355312,287597,655409,872355313,174535,657940941,11869,8.38925238602876,692666,103962967.241908,13672594272814.1,564.848684210526,792788,18766687.0
1182,BTC,2021-07-26,834579998,872765397,410085,944619,872765398,261950,658202891,22416,8.7754286827924,692816,101445530.402301,13672594272814.1,578.865771812081,1147170,18767606.0
1182,BTC,2021-07-27,835021687,873166234,400837,920476,873166235,255221,658458112,19994,28.9865711854355,692986,116914005.393098,13672594272814.1,502.278106508876,1092558,18768675.0
1182,BTC,2021-07-28,835411181,873565186,398952,864677,873565187,251223,658709335,20171,16.2018929720565,693143,106532565.727824,13672594272814.1,551.224358974359,1011709,18769712.0
1182,BTC,2021-07-29,835819250,873975759,410573,890174,873975760,262612,658971947,17645,9.94800357236372,693303,109353179.697144,13672594272814.1,537.006289308176,1022161,18770650.0
1182,BTC,2021-07-30,836177400,874384121,408362,856797,874384122,255417,659227364,18354,7.09039611362674,693469,114251794.86104,13672594272814.1,513.981818181818,929335,18771687.0
1182,BTC,2021-07-31,836470552,874724270,340149,739461,874724271,207348,659434712,14863,9.86229354404817,693627,113154072.589501,14319158983942.9,543.509554140128,815583,18772800.0
1182,BTC,2021-08-01,836756878,875031715,307445,687296,875031716,185157,659619869,14321,17.7610902280891,693781,112030288.252307,14496442856349.1,555.75816993464,772602,18773637.0
1182,BTC,2021-08-02,837204368,875413966,382251,915849,875413967,239277,659859146,18942,11.3120557060862,693924,103824416.800447,14496442856349.1,599.683098591549,1267856,18774537.0
1182,BTC,2021-08-03,837565962,875806784,392818,830521,875806785,246198,660105344,18915,10.1063986403983,694093,122019197.191302,14496442856349.1,510.261904761905,948733,18775668.0
1182,BTC,2021-08-04,837946196,876187374,380590,852595,876187375,239596,660344940,19002,9.90509671748648,694229,98040847.4777222,14496442856349.1,635.059259259259,1179495,18776362.0
1182,BTC,2021-08-05,838302145,876583259,395885,853896,876583260,246175,660591115,18830,7.46239895778544,694389,116019758.438009,14496442856349.1,536.647798742138,962914,18777437.0
1182,BTC,2021-08-06,838700090,876995671,412412,905784,876995672,260810,660851925,19636,7.68462538620076,694548,115384732.986895,14496442856349.1,539.601265822785,1037619,18778612.0
1182,BTC,2021-08-07,839010616,877339761,344090,747230,877339762,212229,661064154,16103,8.89705136779931,694715,120153107.616625,14496442856349.1,518.186746987952,791597,18779512.0
1182,BTC,2021-08-08,839342628,877654199,314438,730498,877654200,191623,661255777,14612,9.16671246526607,694873,113321289.500201,14496442856349.1,549.426751592357,804929,18780462.0
1182,BTC,2021-08-09,839778986,878052575,398376,929034,878052576,252660,661508437,20109,7.60095881610833,695025,111215888.807216,14496442856349.1,559.827814569536,1125952,18781412.0
1182,BTC,2021-08-10,840176452,878463009,410434,895480,878463010,260968,661769405,21103,7.04200575284177,695190,120920936.82273,14496442856349.1,514.896341463415,989854,18782443.0
1182,BTC,2021-08-11,840540976,878874750,411741,873969,878874751,262437,662031842,21933,8.59815241521474,695337,105844174.103693,14496442856349.1,588.239726027398,1108843,18783375.0
1182,BTC,2021-08-12,840916306,879276969,402219,849471,879276970,250961,662282803,21381,7.53965994774993,695488,108536755.452867,14496442856349.1,573.646666666667,1030409,18784306.0
1182,BTC,2021-08-13,841295640,879690619,413650,937232,879690620,260624,662543427,21934,6.37915678727949,695630,108723488.63559,15324761487407.1,605.382978723404,1243908,18785193.0
1182,BTC,2021-08-14,841569374,880023775,333156,728140,880023776,209074,662752501,16026,8.3561185032686,695794,129161437.725252,15556093717702.6,517.282208588957,764561,18786218.0
1182,BTC,2021-08-15,841921315,880332634,308859,766285,880332635,186239,662938740,14363,9.52482039321066,695976,141642312.92088,15556093717702.6,471.701657458564,823579,18787362.0
1182,BTC,2021-08-16,842375401,880748338,415704,965998,880748339,263529,663202269,20625,8.88921709532416,696137,123951419.268204,15556093717702.6,539.025,1105397,18788362.0
1182,BTC,2021-08-17,842802874,881157997,409659,969682,881157998,257766,663460035,19660,9.3554971502626,696309,134179809.680299,15556093717702.6,497.93567251462,1141141,18789531.0
1182,BTC,2021-08-18,843180475,881559723,401726,881951,881559724,247333,663707368,20515,11.0386787720575,696444,104589087.105522,15556093717702.6,638.813432835821,1248408,18790287.0
1182,BTC,2021-08-19,843566572,881964532,404809,895377,881964533,253447,663960815,19911,10.1827050734894,696598,119600517.216011,15556093717702.6,558.633986928105,1114092,18791325.0
1182,BTC,2021-08-20,843985645,882397390,432858,986387,882397391,271837,664232652,20612,8.46389845034322,696758,124012155.651751,15556093717702.6,538.761006289309,1152746,18792318.0
1182,BTC,2021-08-21,844314833,882753419,356029,804867,882753420,219407,664452059,16941,11.0520441850799,696928,132419167.671002,15556093717702.6,504.556213017751,842739,18793312.0
1182,BTC,2021-08-22,844645787,883066058,312639,723240,883066059,190631,664642690,14067,9.48983052678017,697092,126276972.56218,15556093717702.6,529.098159509202,838214,18794331.0
1182,BTC,2021-08-23,845111562,883489904,423846,981745,883489905,270736,664913426,22497,11.712800835178,697289,155528344.744291,15556093717702.6,429.586734693878,928536,18795562.0
1182,BTC,2021-08-24,845563176,883907189,417285,955195,883907190,263984,665177410,21796,30.8806946780069,697443,119005981.594096,15556093717702.6,561.424836601307,1135454,18796525.0
1182,BTC,2021-08-25,845928051,884328205,421016,869269,884328206,263009,665440419,21902,16.0341065158518,697603,130412526.83362,16431142929372.5,541.138364779874,960131,18797593.0
1182,BTC,2021-08-26,846280517,884744407,416202,846598,884744408,258590,665699009,20772,18.1803174206765,697749,128284475.865251,17615033039278.9,589.751724137931,1019037,18798443.0
1182,BTC,2021-08-27,846641903,885152223,407816,864268,885152224,256813,665955822,20615,15.2649471205882,697895,127424686.310312,17615033039278.9,593.731034482758,1025525,18799356.0
1182,BTC,2021-08-28,846955412,885507491,355268,756327,885507492,218268,666174090,16052,16.0263234519857,698036,123654093.82809,17615033039278.9,611.835714285714,933237,18800231.0
1182,BTC,2021-08-29,847242715,885823775,316284,683619,885823776,191650,666365740,15310,19.0427453706137,698192,137609615.186614,17615033039278.9,549.787096774194,849401,18801156.0
1182,BTC,2021-08-30,847672989,886214297,390522,919072,886214298,250955,666616695,22114,16.0049590792739,698327,118240060.299775,17615033039278.9,639.850746268657,1178416,18802118.0
1182,BTC,2021-08-31,848076590,886642707,428410,935955,886642708,271163,666887858,21751,14.2299336483617,698471,130685591.441659,17615033039278.9,578.916083916084,1141913,18802887.0
1182,BTC,2021-09-01,848487104,887088113,445406,970432,887088114,280865,667168723,23751,14.7094732737183,698608,121001184.840723,17615033039278.9,625.25,1256872,18803806.0
1182,BTC,2021-09-02,848937992,887551025,462912,1027555,887551026,289900,667458623,22449,14.4655078550208,698757,131125710.155588,17615033039278.9,576.972972972973,1258125,18804800.0
1182,BTC,2021-09-03,849425279,888003818,452793,1032028,888003819,283991,667742614,23891,10.6318456442219,698905,129228801.42673,17615033039278.9,585.442176870748,1268494,18805662.0
1182,BTC,2021-09-04,849760254,888382882,379064,799676,888382883,227732,667970346,17405,12.2268684606071,699060,137507642.942712,17615033039278.9,550.194805194806,886053,18806718.0
1182,BTC,2021-09-05,850080244,888719128,336246,741843,888719129,205066,668175412,16605,10.5966432025925,699224,143886384.896401,17615033039278.9,525.803680981595,812051,18807656.0
1182,BTC,2021-09-06,850561730,889132960,413832,975521,889132961,268877,668444289,22822,13.2480698422133,699396,151677426.671328,17615033039278.9,498.795321637427,1087901,18808731.0
1182,BTC,2021-09-07,850968332,889561082,428122,942065,889561083,276624,668720913,24946,13.800643527952,699549,135405409.345477,17615033039278.9,558.736842105263,1140718,18809700.0
1182,BTC,2021-09-08,851355690,889985928,424846,913342,889985929,270483,668991396,25318,12.2739557652739,699691,131732372.496154,18403887482923.3,600.035460992907,1125560,18810518.0
1182,BTC,2021-09-09,851743811,890435302,449374,942426,890435303,274384,669265780,24162,14.0107044413876,699828,127342009.031296,18415156832118.2,621.10294117647,1192685,18811443.0
1182,BTC,2021-09-10,852142941,890852789,417487,909854,890852790,261371,669527151,22230,38.2222007817636,699964,129479015.419014,18415156832118.2,610.851851851851,1194476,18812281.0
1182,BTC,2021-09-11,852560184,891218733,365944,858711,891218734,218445,669745596,16794,25.5434743418699,700112,136380769.289097,18415156832118.2,579.938775510204,1082964,18813206.0
1182,BTC,2021-09-12,852861348,891552234,333501,714327,891552235,192691,669938287,15638,23.2811650939704,700259,134891298.113686,18415156832118.2,586.342465753425,835119,18814125.0
1182,BTC,2021-09-13,853308593,891952447,400213,929205,891952448,255970,670194257,22694,39.2211051849687,700418,146251602.444305,18415156832118.2,540.797468354431,1050338,18815281.0
1182,BTC,2021-09-14,853757238,892376047,423600,952672,892376048,268127,670462384,21508,41.9611908726104,700586,153629465.078138,18415156832118.2,514.826347305389,1037876,18816175.0
1182,BTC,2021-09-15,854213782,892803013,426966,984065,892803014,268957,670731341,24119,14.7678739389336,700728,129717140.285173,18415156832118.2,609.730496453901,1331678,18817150.0
1182,BTC,2021-09-16,854704156,893238941,435928,1039227,893238942,271223,671002564,23153,16.0090023272155,700864,123921950.332845,18415156832118.2,638.244444444444,1506390,18817912.0
1182,BTC,2021-09-17,855137723,893667096,428155,951976,893667097,271040,671273604,22644,12.8694005065244,701011,133961768.750814,18415156832118.2,590.41095890411,1224006,18818825.0
1182,BTC,2021-09-18,855519877,894044699,377603,834528,894044700,227661,671501265,16903,13.233097683142,701166,143448880.427246,18415156832118.2,551.363636363637,955009,18819793.0
1182,BTC,2021-09-19,855831242,894386075,341376,727219,894386076,200516,671701781,15690,12.5150777859112,701326,148324667.320879,18415156832118.2,533.238993710692,770383,18820793.0
1182,BTC,2021-09-20,856343947,894808472,422397,1021826,894808473,270233,671972014,24223,20.7243642327521,701490,152422847.970341,18415156832118.2,518.901840490797,1214339,18821825.0
1182,BTC,2021-09-21,856710523,895196524,388052,856395,895196525,244568,672216582,23069,45.9614877335685,701613,113249077.767893,18632996500114.0,706.655737704918,1220175,18822681.0
1182,BTC,2021-09-22,857118568,895624320,427796,916099,895624321,275235,672491817,21914,18.2700367610955,701747,127591441.998395,18997641161759.0,639.496240601504,1234503,18823356.0
1182,BTC,2021-09-23,857518301,896046378,422058,915784,896046379,268689,672760506,21743,16.2520249960174,701912,160759458.769414,18997641161759.0,507.554878048781,1016578,18824531.0
1182,BTC,2021-09-24,857969467,896490855,444477,979201,896490856,277565,673038071,24376,15.2929750022799,702060,139944397.036006,18997641161759.0,583.047619047619,1205603,18825450.0
1182,BTC,2021-09-25,858245826,896844563,353708,720157,896844564,212575,673250646,18245,24.5163989199751,702204,136190412.391139,18997641161759.0,599.118881118881,840459,18826281.0
1182,BTC,2021-09-26,858561454,897179268,334705,720222,897179269,195560,673446206,15760,15.4285438511789,702343,131830121.336845,18997641161759.0,618.934782608696,914658,18827150.0
1182,BTC,2021-09-27,858962756,897583403,404135,894905,897583404,255873,673702079,22010,16.6532949110866,702498,147008062.165526,18997641161759.0,555.032467532468,1051818,18828181.0
1182,BTC,2021-09-28,859434790,898001821,418418,943302,898001822,262292,673964371,20282,13.5375511536026,702650,142945184.832996,18997641161759.0,570.807947019867,1184401,18829112.0
1182,BTC,2021-09-29,859797725,898388472,386651,842156,898388473,241991,674206362,19136,16.4605892772709,702780,122675236.026688,18997641161759.0,665.124031007752,1151118,18830012.0
1182,BTC,2021-09-30,860322046,898856331,467859,1085666,898856332,293074,674499436,22692,14.9572164186838,702951,161948162.583656,18997641161759.0,503.829411764706,1253955,18830956.0
1182,BTC,2021-10-01,860706830,899302777,446446,962874,899302778,277042,674776478,23210,16.08498352035,703091,132636335.370953,18997641161759.0,615.172661870504,1237001,18831837.0
1182,BTC,2021-10-02,861184306,899728766,425989,978461,899728767,259961,675036439,18561,12.3491148004674,703279,181124681.340416,18997641161759.0,450.486631016043,942906,18833093.0
1182,BTC,2021-10-03,861553754,900102177,373411,815756,900102178,218112,675254551,17587,16.383710953748,703429,143711276.71364,18997641161759.0,567.765100671141,910321,18833937.0
1182,BTC,2021-10-04,862084293,900532767,430590,1040922,900532768,268955,675523506,22329,13.8202255756225,703585,152060158.58396,19009120698769.4,536.916129032258,1167222,18834831.0
1182,BTC,2021-10-05,862584703,901012918,480151,1058306,901012919,312538,675836044,26558,15.680721267384,703749,163468705.885815,19893045048575.1,522.668711656441,1274705,18835943.0
1182,BTC,2021-10-06,862919307,901436993,424075,902218,901436994,267749,676103793,26996,18.4188388603135,703880,130395242.215905,19893045048575.1,655.238461538461,1196702,18836831.0
1182,BTC,2021-10-07,863427510,901944752,507759,1147003,901944753,325875,676429668,28583,13.8416612644756,704021,140640285.313611,19893045048575.1,607.507142857143,1430095,18837643.0
1182,BTC,2021-10-08,863850154,902393198,448446,986355,902393199,280028,676709696,25022,14.2993739126624,704141,118481336.032311,19893045048575.1,721.126050420168,1460428,18838387.0
1182,BTC,2021-10-09,864373308,902800970,407772,1017910,902800971,246189,676955885,20336,12.9828930374904,704291,148563521.342046,19893045048575.1,575.107382550336,1289836,18839400.0
1182,BTC,2021-10-10,864734798,903158002,357032,803883,903158003,211506,677167391,18829,13.2683399644171,704450,160030306.183729,19893045048575.1,533.898734177215,881602,18840318.0
1182,BTC,2021-10-11,865216153,903597230,439228,1017932,903597231,280184,677447575,26252,15.578516960701,704596,146071908.737049,19893045048575.1,584.91724137931,1266067,18841237.0
1182,BTC,2021-10-12,865634931,904042163,444935,962449,904042166,274155,677721730,25968,12.809286354929,704730,132514513.321954,19893045048575.1,644.75939849624,1312661,18842187.0
1182,BTC,2021-10-13,866129327,904497070,454907,1004822,904497073,288916,678010646,24420,11.2713848572359,704899,167285313.063918,19893045048575.1,510.744047619048,1107308,18843225.0
1182,BTC,2021-10-14,866594016,904949500,452431,1002358,904949504,282383,678293029,27546,9.70691108859783,705036,135158388.714953,19893045048575.1,632.14705882353,1339773,18844050.0
1182,BTC,2021-10-15,867000124,905431719,482219,1032014,905431723,297746,678590775,30306,12.9277761884678,705177,140302112.534108,19893045048575.1,608.971428571429,1296617,18844943.0
1182,BTC,2021-10-16,867418219,905880782,449067,955334,905880790,270052,678860827,23402,10.8865838907334,705310,135125048.919247,19893045048575.1,632.30303030303,1295533,18845693.0
1182,BTC,2021-10-17,867813821,906257864,377082,839443,906257872,215883,679076710,19552,15.0073800884928,705470,160715460.987319,19893045048575.1,531.622641509434,903351,18846706.0
1182,BTC,2021-10-18,868264655,906716027,458163,992177,906716035,285368,679362078,26992,14.1198183802012,705618,147215835.021978,19917361849675.5,581.081632653061,1212650,18847618.0
1182,BTC,2021-10-19,868795469,907214068,498042,1087443,907214077,312018,679674096,28418,35.6639729962996,705773,156006770.420839,20082460130830.8,552.883116883117,1302747,18848587.0
1182,BTC,2021-10-20,869192730,907680466,466400,981559,907680477,291813,679965909,29608,16.8178082136092,705922,148546818.606883,20082460130830.8,580.648648648649,1179138,18849518.0
1182,BTC,2021-10-21,869756636,908190528,510068,1143093,908190545,320743,680286652,29632,13.5947786992163,706070,148321528.856711,20082460130830.8,581.530612244898,1512783,18850512.0
1182,BTC,2021-10-22,870217018,908649896,459368,984230,908649913,287550,680574202,25658,12.2621967125979,706228,160830900.475865,20082460130830.8,536.299363057325,1168189,18851437.0
1182,BTC,2021-10-23,870550083,909040486,390591,824852,909040504,223941,680798143,20503,11.996475816345,706373,144946964.241574,20082460130830.8,595.069444444445,1051342,18852337.0
1182,BTC,2021-10-24,870859696,909412325,371839,753932,909412343,211220,681009363,19520,13.1390014325505,706526,156049913.012458,20082460130830.8,552.730263157894,839270,18853293.0
1182,BTC,2021-10-25,871398896,909877725,465401,1076612,909877744,284680,681294043,26519,11.4147937125978,706708,185681147.69218,20082460130830.8,464.524861878453,1101719,18854431.0
1182,BTC,2021-10-26,871861349,910358752,481027,1000999,910358771,294029,681588072,26894,11.9500519452102,706858,150311375.460945,20082460130830.8,573.8322147651,1213371,18855368.0
1182,BTC,2021-10-27,872283336,910829369,470617,977381,910829388,292114,681880186,27204,9.99759428926642,707015,158172160.007549,20082460130830.8,545.314102564103,1107476,18856356.0
1182,BTC,2021-10-28,872770564,911326225,496856,1056342,911326244,295558,682175744,27150,10.0094158021164,707168,151949809.250384,20082460130830.8,567.644736842105,1250332,18857306.0
1182,BTC,2021-10-29,873213992,911831988,505763,1018114,911832007,305733,682481477,26617,10.1441500055547,707339,173203909.996388,20082460130830.8,497.988235294118,1067304,18858468.0
1182,BTC,2021-10-30,873585874,912265804,433816,912641,912265823,252061,682733538,21646,12.6420362030337,707494,155622940.468073,20082460130830.8,554.246753246753,986677,18859350.0
1182,BTC,2021-10-31,874006919,912640492,374689,883834,912640512,217435,682950973,20636,12.2147051380104,707633,145270210.231409,20286661027548.9,599.782608695652,1118622,18860212.0
1182,BTC,2021-11-01,874499930,913117941,477449,1080241,913117961,293282,683244255,28768,11.0675439839941,707781,159984652.108357,21659344833264.8,581.469387755102,1315084,18861137.0
1182,BTC,2021-11-02,874951866,913601304,483364,1039531,913601325,297402,683541657,26440,11.8580653538321,707939,171176366.010296,21659344833264.8,543.452229299363,1250437,18862131.0
1182,BTC,2021-11-03,875447085,914072283,470980,1058657,914072305,288746,683830403,26782,11.7847917207605,708100,175915239.733666,21659344833264.8,528.8125,1179844,18863131.0
1182,BTC,2021-11-04,875896055,914549102,476819,1017736,914549124,289141,684119544,27378,14.5679133525207,708243,155291512.68522,21659344833264.8,599.042253521127,1307600,18864112.0
1182,BTC,2021-11-05,876389664,915019796,470694,1050274,915019818,285946,684405490,27264,15.1542190651739,708398,168327670.343511,21659344833264.8,552.64935064935,1243942,18864993.0
1182,BTC,2021-11-06,876716748,915428149,408353,834639,915428171,236233,684641723,22462,18.4042351155962,708552,165325123.298415,21659344833264.8,562.686274509804,921042,18866056.0
1182,BTC,2021-11-07,877097026,915820159,392010,843882,915820181,226128,684867851,20969,15.2906907053073,708705,165287078.741434,21659344833264.8,562.815789473684,992480,18867012.0
1182,BTC,2021-11-08,877486817,916272836,452678,998089,916272859,285806,685153657,29362,20.486816039351,708840,144834928.75739,21659344833264.8,642.291044776119,1273153,18867825.0
1182,BTC,2021-11-09,878069134,916795206,522379,1195964,916795238,335411,685489068,32161,14.7254136730652,708992,164698294.439617,21659344833264.8,564.827814569536,1473930,18868706.0
1182,BTC,2021-11-10,878500345,917278036,482830,1039102,917278068,301025,685790093,31169,15.320660942598,709141,160487181.206294,21659344833264.8,579.648648648649,1362915,18869643.0
1182,BTC,2021-11-11,849970345,917753412,475396,1049695,917753464,293665,686083758,27343,13.184105136187,709299,170270354.186841,21659344833264.8,546.343949044586,1230431,18870637.0
1182,BTC,2021-11-12,850380459,918213859,460447,960989,918213911,282049,686365807,27172,14.3005357091215,709441,154763737.653463,21659344833264.8,601.085106382979,1262101,18871512.0
1182,BTC,2021-11-13,850710559,918624620,410781,845061,918624692,238634,686604441,21714,13.9006369691843,709594,165030508.656204,21659344833264.8,563.690789473684,968751,18872468.0
1182,BTC,2021-11-14,851051106,919016383,391763,820224,919016455,224016,686828457,20691,13.5359503684514,709751,175682873.694856,22434990744236.8,548.474358974359,880797,18873456.0
1182,BTC,2021-11-15,851550362,919481367,464985,1078080,919481440,288435,687116892,27538,15.1285893644159,709902,171034432.009889,22674148233453.1,569.386666666666,1350354,18874400.0
1182,BTC,2021-11-16,852001272,919965551,484184,1037312,919965624,301103,687417995,30680,40.2243612999964,710052,172229365.507101,22674148233453.1,565.436241610738,1259483,18875337.0
1182,BTC,2021-11-17,852436858,920433254,467703,1006223,920433327,290390,687708385,28322,21.283416340543,710201,169797713.545067,22674148233453.1,573.533783783784,1372129,18876268.0
1182,BTC,2021-11-18,882855842,920909797,476543,992178,920909870,293867,688002252,29400,18.7235118935301,710345,163489266.179963,22674148233453.1,595.664335664336,1267871,18877162.0
1182,BTC,2021-11-19,883267077,921376464,466667,974692,921376537,284719,688286971,28435,16.1736904432213,710482,154696287.067895,22674148233453.1,629.522058823529,1275837,18878062.0
1182,BTC,2021-11-20,883625794,921797616,421152,867447,921797689,249652,688536623,23123,14.0457197737654,710627,165251416.060812,22674148233453.1,589.3125,1049318,18878981.0
1182,BTC,2021-11-21,884022523,922184020,386404,861538,922184093,222949,688759572,20617,16.0821812370078,710759,150132969.987069,22674148233453.1,648.656488549618,1123991,18879750.0
1182,BTC,2021-11-22,884420472,922625812,441793,931794,922625886,279165,689038737,27021,15.5264125673674,710900,162458729.746994,22674148233453.1,599.442857142857,1195197,18880681.0
1182,BTC,2021-11-23,884728834,923353088,727276,986279,923353162,283401,689322138,26529,15.4616407611893,711032,149426056.405561,22674148233453.1,651.725190839694,1183716,18881462.0
1182,BTC,2021-11-24,885321646,924242468,907493,1092846,924260655,298909,689621047,26753,16.3748028584579,711189,176407263.436229,22674148233453.1,552.044871794872,1245540,18882437.0
1182,BTC,2021-11-25,885938706,924748103,752131,986642,925012786,287496,689908543,26412,18.3113672376341,711319,146646622.247175,22674148233453.1,664.077519379845,1244448,18883262.0
1182,BTC,2021-11-26,886486841,925349636,720169,1015247,925732955,292645,690201188,29714,17.1654791220066,711451,147797061.896048,22674148233453.1,658.908396946565,1342729,18884075.0
1182,BTC,2021-11-27,886911627,925803413,559894,802097,926292849,240759,690441947,21850,12.0524729214721,711594,161963797.192372,22674148233453.1,601.274647887324,922750,18884981.0
1182,BTC,2021-11-28,887341982,926244614,500960,817993,926793809,213768,690655715,20766,15.041375653546,711733,155120984.476757,22464723406485.9,622.0,967907,18885893.0
1182,BTC,2021-11-29,887806854,926873581,686838,993337,927480647,301297,690957012,28563,13.7882290407746,711876,161779904.342471,22335659268936.4,592.971830985915,1217180,18886731.0
1182,BTC,2021-11-30,888308741,927407324,643032,970183,928123679,293876,691250888,27505,14.5026767432096,712010,151177936.994556,22335659268936.4,634.556390977443,1244173,18887568.0
1182,BTC,2021-12-01,888821570,927970158,636752,1066896,928760431,288422,691539310,29231,13.0761171141337,712147,151586623.780039,22335659268936.4,632.845588235294,1406416,18888362.0
1182,BTC,2021-12-02,889459424,928573441,685763,1188324,929446194,313261,691852571,26779,12.1923669384433,712302,172988168.974378,22335659268936.4,554.551948051948,1500986,18889393.0
1182,BTC,2021-12-03,889992231,929095389,613874,1018511,930060068,290139,692142710,27241,12.0716643849048,712470,189548677.312932,22335659268936.4,506.101796407186,1085296,18890506.0
1182,BTC,2021-12-04,890409877,929643272,616471,973332,930676539,253674,692396384,27900,17.2369009281831,712625,176803688.678294,22335659268936.4,542.584415584416,1091812,18891412.0
1182,BTC,2021-12-05,890814492,930179894,639160,974421,931315699,215213,692611597,21029,13.5466034147495,712791,187887741.772478,22335659268936.4,510.575757575758,1222526,18892450.0
1182,BTC,2021-12-06,891543594,930551190,576989,1068510,931892688,284467,692896064,27246,19.154292013598,712963,190777433.095974,22335659268936.4,502.842105263158,1096122,18893562.0
1182,BTC,2021-12-07,892008829,931075850,588442,1009283,932481130,288343,693184407,26149,18.1299486418144,713117,176727934.552097,22335659268936.4,542.816993464052,1207005,18894562.0
1182,BTC,2021-12-08,892450709,931532214,525658,920483,933006788,266110,693450517,24561,16.2723279362741,713285,189253105.785067,22335659268936.4,506.892215568862,951603,18895537.0
1182,BTC,2021-12-09,893024658,932048993,570174,1118585,933576962,282775,693733292,26880,11.0661726986491,713448,183623721.286225,22335659268936.4,522.432098765432,1329413,18896556.0
1182,BTC,2021-12-10,893442616,932535247,549387,942604,934126349,271375,694004667,24471,11.0927776104682,713604,175364054.494882,22335659268936.4,547.038709677419,1028357,18897537.0
1182,BTC,2021-12-11,893818856,932937317,450986,818663,934577335,225733,694230400,18379,11.3867872315627,713755,175886791.103685,23468677477375.5,573.08,886237,18898487.0
1182,BTC,2021-12-12,894154841,933306171,400469,752829,934977804,214808,694445208,17484,10.4983205915586,713895,169083066.822399,24195286980613.6,614.597122302158,863115,18899931.0
1182,BTC,2021-12-13,894566462,933853777,547606,978610,935525410,278211,694723419,26321,10.9444275019482,714036,171209359.009942,24195286980613.6,606.964285714286,1197346,18900231.0
1182,BTC,2021-12-14,895035652,934321888,524491,970932,936049901,278275,695001694,23662,31.8489611452172,714184,182249144.537197,24195286980613.6,570.197278911565,1149542,18901162.0
1182,BTC,2021-12-15,895585564,934816069,536656,1059017,936586557,281103,695282797,22096,14.026102221034,714325,170561036.388542,24195286980613.6,609.271428571428,1396579,18902106.0
1182,BTC,2021-12-16,895595683,935440586,502854,883914,937089411,256206,695539003,22611,13.4987092314032,714440,141125609.431216,24195286980613.6,736.350877192982,1275047,18902756.0
1182,BTC,2021-12-17,894793762,934007605,686586,1056025,937775997,263495,695802498,22082,11.5319198388756,714589,181419746.532142,24195286980613.6,572.804054054054,1243847,18903687.0
1182,BTC,2021-12-18,895286778,934124639,386449,877278,938162446,239170,696041668,17650,11.702250729884,714717,155534650.748729,24195286980613.6,668.133858267717,1194217,18904581.0
1182,BTC,2021-12-19,895571619,934485796,361157,741075,938523603,206719,696248387,16037,11.5120261871577,714866,178987501.161013,24195286980613.6,580.587837837838,786520,18905418.0
1182,BTC,2021-12-20,896052569,934918533,432737,1015320,938956340,266947,696515334,22446,11.1072729019175,715010,180089548.460505,24195286980613.6,577.034965034965,1248501,18906318.0
1182,BTC,2021-12-21,896487217,935399189,480656,1020149,939436996,304713,696820047,24052,8.89287797888082,715171,193623935.716546,24195286980613.6,536.7,1110320,18907325.0
1182,BTC,2021-12-22,896941338,935861667,462478,1007074,939899474,288495,697108542,21960,11.0448330136683,715319,181071796.571563,24195286980613.6,573.904761904762,1205787,18908256.0
1182,BTC,2021-12-23,897363921,936334888,473221,991258,940372695,291799,697400341,21807,11.0165138916368,715471,185684178.957478,24195286980613.6,559.649006622517,1124778,18909287.0
1182,BTC,2021-12-24,897755984,936758268,423380,987514,940796075,260565,697660906,21558,10.9740660220385,715622,181634544.155263,24195286980613.6,572.126666666667,1239346,18910218.0
1182,BTC,2021-12-25,898129996,937125608,367340,878650,941163415,207803,697868709,17808,11.6023910782671,715769,179141648.501803,24242457398797.1,581.219178082192,1164388,18911168.0
1182,BTC,2021-12-26,898406666,937487235,361627,771509,941525042,198574,698067283,16024,12.4037512511554,715903,161727962.96069,24272331996980.0,644.593984962406,984266,18911900.0
1182,BTC,2021-12-27,898820950,937912601,425366,1001923,941950408,249548,698316831,22938,12.5510681593669,716051,180959841.794042,24272331996980.0,576.08843537415,1228930,18912825.0
1182,BTC,2021-12-28,899269681,938377153,464552,1052127,942414960,265422,698582253,23219,12.3414439321804,716185,161673274.167244,24272331996980.0,644.812030075188,1470745,18913662.0
1182,BTC,2021-12-29,899815285,938851355,474203,1147265,942889163,276083,698858336,22444,12.6642969650376,716330,173981706.758546,24272331996980.0,599.194444444444,1402007,18914568.0
1182,BTC,2021-12-30,900199035,939276594,425239,983172,943314402,245021,699103357,22347,12.8703397052074,716449,146694574.224127,24272331996980.0,710.652542372881,1440239,18915312.0
1182,BTC,2021-12-31,900761387,939730631,454037,1115526,943768439,269540,699372897,22148,11.8231545970738,716598,180380348.096722,24272331996980.0,577.939189189189,1394028,18916243.0
1182,BTC,2022-01-01,901037904,940052771,322140,703687,944090579,186834,699559731,15029,12.3953956964264,716770,209507299.893297,24272331996980.0,497.590643274854,697698,18917450.0
1182,BTC,2022-01-02,901347150,940400565,347794,747901,944438373,196865,699756596,15704,11.4034898458435,716928,192293637.121251,24272331996980.0,542.133757961783,788183,18918306.0
1182,BTC,2022-01-03,901772146,940797482,396917,937567,944835290,234793,699991389,21137,14.4715958415656,717068,169314278.665767,24272331996980.0,615.712230215827,1185446,18919193.0
1182,BTC,2022-01-04,902204397,941240515,443034,981322,945278324,274544,700265933,22962,11.6252222613522,717215,178036440.872661,24272331996980.0,585.547945205479,1196001,18920181.0
1182,BTC,2022-01-05,902663935,941688074,447559,1010591,945725883,272155,700538088,21580,14.9928071325123,717365,182860462.023401,24272331996980.0,570.10067114094,1235002,18921062.0
1182,BTC,2022-01-06,903074511,942129985,441911,960123,946167794,264899,700802987,24325,14.3471156123015,717511,176112480.870527,24272331996980.0,591.944827586207,1187899,18922025.0
1182,BTC,2022-01-07,903519911,942556029,426044,969222,946593838,255381,701058368,22782,14.167799543148,717651,169698948.651259,24272331996980.0,614.31654676259,1275552,18922825.0
1182,BTC,2022-01-08,903867717,942936428,380399,822664,946974237,223920,701282288,17857,12.591235085694,717795,176274835.163165,24341458814595.0,593.083916083916,1026073,18923725.0
1182,BTC,2022-01-09,904163395,943302778,366350,763229,947340587,210143,701492431,17406,12.6197997514668,717936,170786726.228813,24371874614345.6,612.907142857143,929576,18924606.0
1182,BTC,2022-01-10,904601179,943735209,432431,968910,947773018,266743,701759174,22993,12.84216953913,718078,174098483.319886,24371874614345.6,601.248226950354,1268167,18925575.0
1182,BTC,2022-01-11,905024866,944185204,449995,963768,948223013,277470,702036644,21697,26.5456592058728,718236,191587632.083609,24371874614345.6,546.36305732484,1109629,18926493.0
1182,BTC,2022-01-12,905474432,944623722,438091,972780,948661104,271933,702308805,21514,17.0961867893503,718375,180704584.854628,24371874614345.6,579.268115942029,1281750,18927456.0
1182,BTC,2022-01-13,905869397,945072290,448568,948196,949109672,274515,702583320,21735,15.5780868159173,718554,218346731.49187,24371874614345.6,479.404494382023,950327,18928525.0
1182,BTC,2022-01-14,906313248,945512531,440241,991166,949549913,270882,702854202,21402,14.2891966295717,718713,194444571.251169,24371874614345.6,538.335443037975,1151093,18929475.0
1182,BTC,2022-01-15,906627649,945911854,399323,830710,949949236,234373,703088575,17639,16.8427993709551,718879,200711276.063153,24371874614345.6,521.527272727272,854830,18930506.0
1182,BTC,2022-01-16,906933882,946279257,367403,775715,950316639,216151,703304726,17030,17.4800443543032,719054,212048505.9199,24371874614345.6,493.643678160919,770400,18931675.0
1182,BTC,2022-01-17,907395723,946686009,406752,971298,950723391,258141,703562867,20360,14.405599574789,719215,198051495.36726,24371874614345.6,528.53125,1112459,18932600.0
1182,BTC,2022-01-18,907784273,947105409,419400,916974,951142791,265057,703827924,20772,16.4231881178801,719351,164382600.044921,24371874614345.6,636.785185185185,1210699,18933450.0
1182,BTC,2022-01-19,908217488,947531246,425837,950212,951568628,270334,704098258,20923,13.9332685955393,719524,211117852.260905,24371874614345.6,495.819767441861,998671,18934631.0
1182,BTC,2022-01-20,908620297,947970436,439190,958119,952007818,271265,704369523,21381,13.0162255802884,719693,204841420.39626,24371874614345.6,511.011904761905,1026111,18935675.0
1182,BTC,2022-01-21,909044029,948420777,450341,1033192,952458159,272348,704641871,25084,18.9838666646202,719827,176511342.084765,26338083826987.6,640.872180451128,1410456,18936425.0
1182,BTC,2022-01-22,909495795,948839959,419183,997611,952877342,250294,704892165,21957,25.4982212283643,719961,177556162.699681,26643185256535.5,644.481203007519,1371155,18937262.0
1182,BTC,2022-01-23,909805934,949191579,351620,767044,953228962,203986,705096151,16044,28.0047304999324,720102,191432663.464248,26643185256535.5,597.764285714286,967822,18938150.0
1182,BTC,2022-01-24,910249153,949619299,427720,976712,953656682,270712,705366863,23230,24.9197611925267,720252,197634340.12629,26643185256535.5,579.006711409396,1216134,18939081.0
1182,BTC,2022-01-25,910632796,950038880,419582,897415,954076264,265128,705631991,21219,21.3993099022529,720404,205557613.728902,26643185256535.5,556.688741721854,1072904,18940087.0
1182,BTC,2022-01-26,911003205,950460522,421642,885174,954497906,261070,705893061,21287,15.8920599544897,720534,173715844.528026,26643185256535.5,658.728682170542,1240494,18940925.0
1182,BTC,2022-01-27,911401393,950873942,413420,912466,954911326,255925,706148986,19534,15.5917947824791,720665,174581730.007647,26643185256535.5,655.461538461539,1266465,18941768.0
1182,BTC,2022-01-28,911806635,951303954,430012,955985,955341338,264609,706413595,20181,16.0468891414501,720819,205137041.626373,26643185256535.5,557.830065359477,1189178,18942625.0
1182,BTC,2022-01-29,912148029,951687211,383258,832877,955724596,231038,706644633,17234,16.9214008900817,720968,198733594.410134,26643185256535.5,575.804054054054,1044287,18943556.0
1182,BTC,2022-01-30,912458991,952041776,354565,783141,956079161,207173,706851806,16193,18.2043945991034,721114,195009559.199198,26643185256535.5,586.8,1048152,18944468.0
1182,BTC,2022-01-31,912890377,952461430,419654,999813,956498815,263410,707115216,20572,14.9249421573489,721257,190165814.600794,26643185256535.5,601.746478873239,1425218,18945368.0
1182,BTC,2022-02-01,913382939,952892170,430741,1063484,956929556,272984,707388200,21172,14.2726232174545,721411,203671811.134311,26643185256535.5,561.843137254902,1337182,18946325.0
1182,BTC,2022-02-02,913823266,953330771,438601,981122,957368157,278985,707667185,20322,11.9543310266792,721564,203027916.323955,26643185256535.5,563.625,1190933,18947293.0
1182,BTC,2022-02-03,914234794,953756143,425372,937908,957793529,265344,707932529,19509,13.5989458267956,721711,194720454.118427,26643185256535.5,587.671232876712,1182716,18948200.0
1182,BTC,2022-02-04,914542741,954160733,404590,890327,958198119,247946,708180475,19294,18.0671761157781,721841,173205850.912339,26684698822067.7,661.697674418604,1212899,18949081.0
1182,BTC,2022-02-05,914929878,954581093,420361,961340,958618480,258646,708439121,18858,13.6497999131641,721960,158354078.811678,26690525287405.5,723.915254237288,1428582,18949762.0
1182,BTC,2022-02-06,915377939,954941778,360685,913200,958979165,219196,708658317,16308,13.8976240861285,722116,205872163.061159,26690525287405.5,556.825806451613,1086566,18950731.0
1182,BTC,2022-02-07,915756738,955357794,416016,933433,959395181,262034,708920351,22948,18.0104709423418,722252,180795298.780732,26690525287405.5,634.059259259259,1220094,18951581.0
1182,BTC,2022-02-08,916201153,955792081,434287,1024351,959829468,276850,709197201,23752,43.1899544036393,722406,204614489.174241,26690525287405.5,560.248366013071,1269141,18952606.0
1182,BTC,2022-02-09,916640386,956215814,423733,1005608,960253201,265804,709463005,21082,20.2723573052356,722546,185415715.026217,26690525287405.5,618.258992805756,1412872,18953425.0
1182,BTC,2022-02-10,917080606,956634727,418913,1029618,960672114,260813,709723818,21476,20.5440744437431,722693,194560759.91863,26690525287405.5,589.198630136986,1389048,18954337.0
1182,BTC,2022-02-11,917480654,957053790,419063,984285,961091177,258595,709982413,20452,15.1557355190198,722835,191252639.614359,26690525287405.5,599.390070921986,1526755,18955312.0
1182,BTC,2022-02-12,918082559,957434392,380602,1088876,961471779,228189,710210602,16009,13.9644703653631,723022,249191814.169099,26690525287405.5,460.02688172043,1299513,18956412.0
1182,BTC,2022-02-13,918431285,957822288,387896,827179,961859675,208977,710419579,14425,15.736332620481,723180,209648380.443433,26690525287405.5,546.796178343949,908228,18957381.0
1182,BTC,2022-02-14,918819850,958224951,402663,904274,962262338,247592,710667171,18672,15.9855627211914,723333,209906034.740156,26690525287405.5,546.125,1058443,18958437.0
1182,BTC,2022-02-15,919303454,958661608,436658,1022494,962698996,273623,710940794,19767,12.5193261407471,723508,236282290.278251,26690525287405.5,485.16091954023,1109690,18959431.0
1182,BTC,2022-02-16,919696373,959104600,442992,930742,963141988,266788,711207582,19363,14.6674836656207,723664,212091799.055618,26690525287405.5,540.496774193549,1062859,18960406.0
1182,BTC,2022-02-17,920094807,959535862,431262,938318,963573250,255573,711463155,19458,14.3376092803932,723821,217682930.00783,27324773218056.7,539.128205128205,1072667,18961387.0
1182,BTC,2022-02-18,920504062,959961451,425589,950177,963998839,261055,711724210,20795,15.0237475569129,723955,188884885.492184,27967152532434.2,635.932330827068,1296436,18962293.0
1182,BTC,2022-02-19,920907683,960327510,366059,859806,964364898,220673,711944883,16285,14.6061507068348,724104,208267022.954571,27967152532434.2,576.75,1051747,18963231.0
1182,BTC,2022-02-20,921208026,960674197,346687,745783,964711585,200535,712145418,15352,17.0124371817363,724248,202352269.925947,27967152532434.2,593.608391608392,903767,18964056.0
1182,BTC,2022-02-21,921585401,961066011,391814,882870,965103399,237402,712382820,18842,21.0083050805344,724371,177461268.977984,27967152532434.2,676.868852459016,1303794,18964831.0
1182,BTC,2022-02-22,921989022,961486495,420484,909069,965523883,260265,712643085,19401,18.2769099105897,724523,211125815.723971,27967152532434.2,568.940397350993,1097987,18965787.0
1182,BTC,2022-02-23,922363700,961890089,403594,863872,965927477,251275,712894360,17720,14.3151198340765,724673,209015541.853929,27967152532434.2,574.684563758389,1037381,18966712.0
1182,BTC,2022-02-24,922780648,962318343,428254,956898,966355731,254139,713148499,22107,16.8538630331461,724805,185824805.666876,27967152532434.2,646.404580152672,1313897,18967625.0
1182,BTC,2022-02-25,923178926,962756416,438073,942391,966793804,260340,713408839,20994,16.6065533849745,724939,185593405.244525,27967152532434.2,647.210526315789,1293635,18968462.0
1182,BTC,2022-02-26,923534391,963130820,374404,816478,967168208,220423,713629262,15948,14.1876274219135,725064,178860794.724011,27967152532434.2,671.572580645162,1165299,18969156.0
1182,BTC,2022-02-27,923857436,963506188,375368,792012,967543576,211164,713840426,16246,13.942911547245,725200,188550756.845942,27967152532434.2,637.059259259259,1020711,18970006.0
1182,BTC,2022-02-28,924265493,963948134,441946,979415,967985522,270918,714111344,22854,15.9532464563165,725354,214817360.667482,27967152532434.2,559.16339869281,1168960,18971018.0
1182,BTC,2022-03-01,924708372,964401582,453448,1066006,968438970,280634,714391978,23689,17.7725700255123,725516,226563402.185347,27967152532434.2,530.173913043478,1282074,18972037.0
1182,BTC,2022-03-02,925205683,964865900,464318,1100872,968903288,288657,714680635,21867,12.5738807990587,725652,189697726.343502,27967152532434.2,633.207407407408,1522395,18972831.0
1182,BTC,2022-03-03,925657951,965315799,449899,1017862,969353187,268244,714948879,20317,14.7077521755886,725800,207082886.546914,27851682002895.7,577.65306122449,1270955,18973762.0
1182,BTC,2022-03-04,926078193,965747795,431996,966182,969785183,262101,715210980,20042,13.5644345537452,725939,190277482.473084,27550332084343.8,621.869565217391,1317418,18974775.0
1182,BTC,2022-03-05,926413989,966129883,382088,818445,970167271,225321,715436301,16748,11.6130884007786,726062,170199587.188285,27550332084343.8,695.229508196721,1201288,18975400.0
1182,BTC,2022-03-06,926746227,966483301,353418,784370,970520689,207116,715643417,15007,13.3472515159879,726193,178927903.461697,27550332084343.8,661.315384615384,1067880,18976225.0
1182,BTC,2022-03-07,927153677,966893541,410240,926136,970930929,255441,715898858,20793,14.0509767732585,726341,203690883.172795,27550332084343.8,580.918367346939,1180208,18977150.0
1182,BTC,2022-03-08,927596498,967313068,419527,963012,971350456,255771,716154629,19687,34.6906447014312,726489,202947017.414254,27550332084343.8,583.047619047619,1243527,18978125.0
1182,BTC,2022-03-09,927976437,967761468,448400,967729,971798856,272805,716427434,21784,27.6163022843376,726627,188896459.007666,27550332084343.8,626.41605839416,1249582,18979025.0
1182,BTC,2022-03-10,928431766,968200868,439400,1005046,972238256,261553,716688987,20298,18.7055921950084,726772,199529253.283514,27550332084343.8,593.034722222222,1281342,18979906.0
1182,BTC,2022-03-11,928810065,968620366,419498,911121,972657754,252383,716941370,19168,16.3545051467731,726910,189823246.084062,27550332084343.8,623.357664233577,1231351,18980800.0
1182,BTC,2022-03-12,929153048,968997469,377103,818806,973034857,225148,717166518,14802,15.1423926404056,727066,214766041.416298,27550332084343.8,550.961290322581,941650,18981675.0
1182,BTC,2022-03-13,929472027,969349659,352190,766163,973387047,208092,717374610,13652,16.6828123405383,727217,206436063.392566,27550332084343.8,573.193333333333,893361,18982612.0
1182,BTC,2022-03-14,929870711,969765762,416103,935383,973803150,259592,717634202,18473,16.8111286791964,727370,209454079.946685,27550332084343.8,564.934210526315,1130072,18983650.0
1182,BTC,2022-03-15,930271775,970205906,440144,941486,974243294,263178,717897380,18811,13.9322005217476,727509,193183633.523905,27550332084343.8,612.514492753624,1232380,18984512.0
1182,BTC,2022-03-16,930711246,970675189,469283,1018750,974712577,276390,718173770,20646,15.1038880893379,727664,213407942.516679,27550332084343.8,554.467532467532,1212247,18985462.0
1182,BTC,2022-03-17,931156332,971163414,488225,1037510,975200802,278800,718452570,19439,14.7314876493276,727823,216438038.006073,27520860571022.3,546.120253164557,1177280,18986468.0
1182,BTC,2022-03-18,931562708,971610998,447584,991557,975648386,261318,718713888,19001,12.9208231433178,727966,195069431.877781,27452707696466.4,604.443661971831,1280325,18987337.0
1182,BTC,2022-03-19,931939522,972026108,415110,887796,976063496,242424,718956312,16597,14.9785305882401,728121,211475329.168763,27452707696466.4,557.551948051948,1035743,18988262.0
1182,BTC,2022-03-20,932258713,972394121,368013,790049,976431509,210547,719166859,13919,11.8616495005959,728275,213604851.183169,27452707696466.4,551.993464052287,878539,18989312.0
1182,BTC,2022-03-21,932668989,972819361,425240,947604,976856749,259912,719426771,19292,17.3190147691628,728428,209644502.443987,27452707696466.4,562.421052631579,1110128,18990275.0
1182,BTC,2022-03-22,933034555,973247489,428128,939357,977284877,264569,719691340,20719,13.6645587574593,728577,203960533.181697,27452707696466.4,578.094594594595,1114318,18991206.0
1182,BTC,2022-03-23,933469087,973678057,430568,974165,977715445,264182,719955522,19940,12.6180323963239,728722,197425859.827069,27452707696466.4,597.229166666667,1256502,18992106.0
1182,BTC,2022-03-24,933859001,974110612,432555,960407,978148000,262987,720218509,19376,13.4622309522633,728865,199971388.05286,27452707696466.4,589.62676056338,1191505,18993000.0
1182,BTC,2022-03-25,934334059,974590634,480022,1084340,978628022,290719,720509228,20874,14.5273332941959,729021,212855982.648037,27452707696466.4,553.935483870968,1283710,18993975.0
1182,BTC,2022-03-26,934661524,974984126,393492,839220,979021514,231031,720740259,15794,14.3565960961288,729182,223907863.970984,27452707696466.4,526.59375,922095,18994900.0
1182,BTC,2022-03-27,934987773,975357265,373139,819815,979394653,218202,720958461,15217,15.0937259911323,729313,178786743.025943,27452707696466.4,659.492307692307,1090554,18995712.0
1182,BTC,2022-03-28,935464244,975807926,450661,1052990,979845314,293304,721251765,23544,16.1573438961628,729472,217998994.99619,27452707696466.4,540.867088607595,1244156,18996793.0
1182,BTC,2022-03-29,935863054,976249888,441962,969097,980287276,286940,721538705,21928,15.5081324195121,729623,206475428.581634,27452707696466.4,571.053333333334,1171784,18997731.0
1182,BTC,2022-03-30,936262544,976668042,418154,951685,980705430,272864,721811569,20826,13.4868545191403,729758,187174057.640597,27452707696466.4,629.940298507463,1321063,18998562.0
1182,BTC,2022-03-31,936641182,977110397,442355,983682,981147785,279210,722090779,21498,14.0358004858711,729896,194824117.80303,28315874718216.5,624.233576642335,1276887,18999443.0
1182,BTC,2022-04-01,937073257,977560291,449894,1072470,981597679,284105,722374884,21241,12.088034592962,730037,200655171.057665,28587155782195.1,611.9,1366774,19000325.0
1182,BTC,2022-04-02,937481665,977973609,413318,951158,982010997,254442,722629326,17096,15.7954858360768,730172,194158942.727051,28587155782195.1,632.373134328358,1300146,19001081.0
1182,BTC,2022-04-03,937820042,978345905,372296,811263,982383293,225564,722854890,15505,13.0634222836786,730311,199031658.097351,28587155782195.1,616.891304347826,1061416,19002062.0
1182,BTC,2022-04-04,938250191,978777885,431980,991442,982815273,275106,723129996,20889,12.8733610437391,730469,225679043.384367,28587155782195.1,544.050955414013,1165983,19003050.0
1182,BTC,2022-04-05,938635554,979215199,437314,954258,983252587,273430,723403426,18995,28.0559986255269,730614,205658363.15583,28587155782195.1,597.013888888888,1175464,19003912.0
1182,BTC,2022-04-06,939033286,979637959,422760,928405,983675347,273640,723677066,21127,23.0395449752428,730764,216288781.154105,28587155782195.1,567.671140939597,1135374,19004787.0
1182,BTC,2022-04-07,939439725,980069541,431582,943697,984106929,269404,723946470,20302,20.5491637702544,730902,195114117.529264,28587155782195.1,629.277372262774,1279268,19005781.0
1182,BTC,2022-04-08,939808915,980495905,426364,932330,984533293,266805,724213275,20072,18.5399651790162,731036,190874190.146864,28587155782195.1,643.255639097744,1222204,19006543.0
1182,BTC,2022-04-09,940147924,980872706,376801,813141,984910094,232792,724446067,15745,14.3363160499323,731189,220750593.478605,28587155782195.1,556.197368421053,958481,19007512.0
1182,BTC,2022-04-10,940465988,981222346,349640,756941,985259734,216446,724662513,14470,15.6901664673643,731329,200163552.592048,28587155782195.1,613.402877697842,963704,19008387.0
1182,BTC,2022-04-11,940899409,981651341,428995,985815,985688729,276623,724939136,20783,20.7183960565463,731466,197226744.075417,28587155782195.1,622.536764705882,1305536,19009262.0
1182,BTC,2022-04-12,941367274,982093564,442223,1001863,986130952,278839,725217975,20152,18.0177159481908,731619,218261837.460157,28587155782195.1,562.539473684211,1253908,19010225.0
1182,BTC,2022-04-13,941778584,982527563,433999,950299,986564951,276968,725494943,19501,18.5947522919796,731759,199131264.041255,28587155782195.1,616.58273381295,1241552,19011000.0
1182,BTC,2022-04-14,942163787,982953014,425451,919508,986990402,265537,725760480,19287,20.69062696105,731897,198519212.831502,28351572544596.9,613.386861313869,1226918,19011875.0
1182,BTC,2022-04-15,942527076,983380273,427259,898503,987417661,254831,726015311,16519,16.212833154886,732055,221682819.274672,28225928151211.1,546.859872611465,1011750,19012850.0
1182,BTC,2022-04-16,942843948,983764275,384002,803288,987801663,225486,726240797,13541,14.1447090900228,732189,191127492.829027,28225928151211.1,634.285714285714,1039411,19013687.0
1182,BTC,2022-04-17,943150672,984112829,348554,756979,988150217,207324,726448121,13077,16.1121845521888,732354,232053268.469092,28225928151211.1,522.420731707317,828635,19014718.0
1182,BTC,2022-04-18,943580288,984506962,394133,932584,988544350,246421,726694542,19074,21.9538742789957,732488,192572471.186795,28225928151211.1,629.526315789474,1293231,19015556.0
1182,BTC,2022-04-19,943971636,984946236,439274,950234,988983624,273168,726967710,19068,18.203102972579,732612,173622497.02467,28225928151211.1,698.235772357724,1359555,19016337.0
1182,BTC,2022-04-20,944393883,985389538,443302,976492,989426926,285655,727253365,19963,14.8752689347407,732772,224999482.789374,28225928151211.1,538.798742138365,1148729,19017331.0
1182,BTC,2022-04-21,944828868,985840363,450825,993088,989877751,282438,727535803,18850,19.3692184044276,732941,237427671.203791,28225928151211.1,510.595238095238,1109322,19018387.0
1182,BTC,2022-04-22,945228423,986262474,422111,952065,990299862,260930,727796733,17974,21.0606498648998,733076,189160724.904696,28225928151211.1,640.880597014925,1286750,19019231.0
1182,BTC,2022-04-23,945600909,986643155,380681,864789,990680543,234978,728031711,14259,20.0074314461023,733239,236343133.315791,28225928151211.1,512.938271604938,953027,19020250.0
1182,BTC,2022-04-24,945954396,987006048,362893,816123,991043436,221992,728253703,13738,23.7962531863113,733410,240503722.823617,28225928151211.1,504.064705882353,850437,19021318.0
1182,BTC,2022-04-25,946394813,987430754,424706,1008968,991468142,277417,728531120,21179,29.1455397964073,733572,227510981.217875,28225928151211.1,532.850931677019,1168047,19022331.0
1182,BTC,2022-04-26,946798968,987858277,427523,967613,991895665,273297,728804417,20531,27.646058938795,733712,197054189.079086,28225928151211.1,615.208633093525,1236938,19023212.0
1182,BTC,2022-04-27,947229684,988298766,440489,973994,992336154,287105,729091522,20639,23.6782155946359,733882,243714195.952867,28770282779728.5,507.01775147929,1062318,19024268.0
1182,BTC,2022-04-28,947662883,988735083,436317,1015298,992772471,275765,729367287,19406,25.1303603428367,734014,195634707.452297,29794407589312.1,654.106870229008,1367430,19025100.0
1182,BTC,2022-04-29,948123754,989185497,450414,1063975,993222885,286563,729653850,19435,18.738936106779,734164,223237462.666034,29794407589312.1,573.228187919463,1317207,19026043.0
1182,BTC,2022-04-30,948550074,989611141,425644,970531,993648529,261630,729915480,15490,14.390323447301,734314,221571995.441979,29794407589312.1,577.536912751678,1227105,19026975.0
1182,BTC,2022-05-01,948882439,989993537,382396,840129,994030925,232322,730147802,14213,17.2895099707965,734481,249892443.229479,29794407589312.1,512.084337349397,874984,19028012.0
1182,BTC,2022-05-02,949310155,990417118,423581,980280,994454506,272206,730420008,18820,23.4079207660361,734641,237374963.375915,29794407589312.1,539.088050314466,1117986,19029012.0
1182,BTC,2022-05-03,949714935,990852093,434975,952464,994889481,277895,730697903,17906,31.7066277136353,734791,222339368.951078,29794407589312.1,575.543624161074,1124335,19029950.0
1182,BTC,2022-05-04,950034160,991226726,374633,872482,995264114,233045,730930948,18107,26.9058384241087,734937,218691168.693509,29794407589312.1,585.144827586207,1092913,19030862.0
1182,BTC,2022-05-05,950551525,991718452,491726,1174988,995755840,315759,731246707,20792,31.5760759945556,735094,233048447.532275,29794407589312.1,549.096153846154,1419433,19031843.0
1182,BTC,2022-05-06,951064091,992170041,451589,1099911,996207429,286887,731533594,20916,29.4080921375522,735236,209259682.619344,29794407589312.1,611.517730496454,1459279,19033125.0
1182,BTC,2022-05-07,951387151,992545563,375522,840612,996582951,231623,731765217,14829,18.5506647644423,735379,211098791.579481,29794407589312.1,606.19014084507,1067810,19033625.0
1182,BTC,2022-05-08,951747456,992912541,366978,849741,996949929,233892,731999109,15338,21.642853369316,735534,229073847.523685,29794407589312.1,558.623376623377,1012209,19034612.0
1182,BTC,2022-05-09,952211626,993352640,440099,1044085,997390028,279511,732278620,22809,28.2872711446401,735689,228696355.515465,29794407589312.1,559.545454545454,1245684,19035825.0
1182,BTC,2022-05-10,952625751,993794147,441507,985477,997831535,279658,732558278,22328,30.372363728688,735842,232282798.721346,29822970212378.7,551.434210526316,1163013,19036518.0
1182,BTC,2022-05-11,952985504,994219171,425024,1005376,998256559,262683,732820961,24735,27.8819338995312,735987,227420741.745638,31251101365711.1,590.194444444445,1238315,19037512.0
1182,BTC,2022-05-12,953341861,994672611,453440,1043690,998709999,274204,733095165,29127,36.5416236440748,736122,208816809.271597,31251101365711.1,642.776119402985,1387405,19038343.0
1182,BTC,2022-05-13,953714102,995109508,436897,1036736,999146896,269880,733365045,25431,25.0551233942071,736274,235529990.445041,31251101365711.1,569.87417218543,1305426,19039231.0
1182,BTC,2022-05-14,954204269,995557640,448132,1097507,999595028,290225,733655270,20778,15.8542076589991,736415,217896127.809453,31251101365711.1,615.992857142857,1396389,19040093.0
1182,BTC,2022-05-15,954728974,995924754,367114,1022995,999962142,235433,733890703,17672,11.8927072843162,736537,188935754.512505,31251101365711.1,710.413223140496,1530435,19040862.0
1182,BTC,2022-05-16,955284137,996335672,410918,1098098,1000373060,272134,734162837,22173,16.6912169583122,736701,258638854.566057,31251101365711.1,518.957055214723,1425462,19041887.0
1182,BTC,2022-05-17,955781843,996761882,426210,1036631,1000799270,278496,734441333,20986,14.4482389054424,736848,230788459.871368,31251101365711.1,581.582191780822,1460201,19042806.0
1182,BTC,2022-05-18,956173770,997165073,403191,903949,1001202461,262907,734704240,20307,11.1975181576813,736982,215094909.967606,31251101365711.1,624.015037593985,1273787,19043643.0
1182,BTC,2022-05-19,956527500,997572887,407814,902105,1001610275,262479,734966719,18821,10.4895499640575,737104,192594512.527363,31251101365711.1,696.917355371901,1335489,19044418.0
1182,BTC,2022-05-20,956935755,997986025,413138,948874,1002023413,267034,735233753,17952,9.11401360835804,737232,198189189.720651,31251101365711.1,677.244094488189,1443016,19045206.0
1182,BTC,2022-05-21,957253112,998338062,352037,787760,1002375450,225225,735458978,13041,6.77646435292983,737367,211991813.207859,31251101365711.1,633.149253731343,1071192,19046056.0
1182,BTC,2022-05-22,957558428,998663692,325630,751429,1002701080,209047,735668025,13101,5.68983708611441,737489,188173952.100558,31251101365711.1,713.289256198347,1205588,19046818.0
1182,BTC,2022-05-23,957988174,999060264,396572,939060,1003097652,265106,735933131,17809,7.96809581126168,737649,247691773.243392,31251101365711.1,541.893081761006,1142381,19047812.0
1182,BTC,2022-05-24,958300940,999425399,365135,848460,1003462787,235866,736168997,17452,10.8730272022319,737769,190807221.852055,31251101365711.1,703.44537815126,1228520,19048568.0
1182,BTC,2022-05-25,958786203,999863026,437627,1034175,1003900414,288842,736457839,17331,6.68942713573632,737913,219389464.4084,30705864440302.1,601.125874125874,1354729,19049462.0
1182,BTC,2022-05-26,959183138,1000276162,413136,910133,1004313550,262367,736720206,17906,8.84703135806801,738054,210522824.573578,29897409688833.6,609.949999999999,1196357,19050337.0
1182,BTC,2022-05-27,959557573,1000704368,428206,936015,1004741756,270453,736990659,19020,10.3896309778332,738192,205960970.897811,29897409688833.6,623.459854014599,1263145,19051206.0
1182,BTC,2022-05-28,959880304,1001057685,353317,794128,1005095073,226794,737217453,14932,6.94378327351799,738340,221406771.88144,29897409688833.6,579.965986394558,1055595,19052131.0
1182,BTC,2022-05-29,960199572,1001384357,326672,757441,1005421745,207859,737425312,13736,7.25677528116772,738489,224702548.401447,29897409688833.6,571.45945945946,1021936,19053081.0
1182,BTC,2022-05-30,960627120,1001777607,393250,941604,1005814995,271819,737697131,19616,8.29731934923615,738643,227787971.081915,29897409688833.6,563.718954248365,1258586,19054025.0
1182,BTC,2022-05-31,961053337,1002188623,411016,1000162,1006226011,276273,737973404,20691,16.3002714612766,738789,219305044.028396,29897409688833.6,585.524137931035,1295370,19054937.0
1182,BTC,2022-06-01,961443479,1002602372,413749,968548,1006639760,272165,738245569,19210,12.9487736081538,738925,203499836.527185,29897409688833.6,631.0,1337666,19055793.0
1182,BTC,2022-06-02,961853190,1003013051,410679,956018,1007050439,264901,738510470,17418,8.50821760860612,739050,185017908.543262,29897409688833.6,694.032258064516,1423832,19056575.0
1182,BTC,2022-06-03,962262036,1003433437,420386,946371,1007470825,267517,738777987,17936,7.54509129691231,739193,211727732.843809,29897409688833.6,606.478873239437,1253306,19057462.0
1182,BTC,2022-06-04,962583706,1003780253,346816,780613,1007817641,218629,738996616,12888,6.04120207939002,739332,213668203.211159,29897409688833.6,600.971014492754,1043881,19058337.0
1182,BTC,2022-06-05,962893115,1004109384,329131,742340,1008146772,201341,739197957,10979,7.52200626116787,739478,220246723.876302,29897409688833.6,583.020689655173,903880,19059243.0
1182,BTC,2022-06-06,963334630,1004510445,401061,957734,1008547833,268921,739466878,17587,8.27701253503137,739628,222469839.427565,29897409688833.6,577.194630872483,1212194,19060181.0
1182,BTC,2022-06-07,963778578,1004912394,401949,946090,1008949782,263641,739730519,19348,9.44680541907363,739790,239520719.852552,29897409688833.6,536.105590062111,1152025,19061193.0
1182,BTC,2022-06-08,964163277,1005320838,408444,894223,1009358226,261597,739992116,18087,7.21330615163083,739968,273023986.719296,30107694713067.3,473.627118644068,963582,19062312.0
1182,BTC,2022-06-09,964567821,1005734475,413637,916889,1009771863,262105,740254221,16458,6.24956204812667,740114,220791104.139538,30283293547736.7,589.089655172413,1173805,19063218.0
1182,BTC,2022-06-10,964939724,1006148412,413937,908421,1010185800,261856,740516077,17651,9.22326498217826,740261,222629169.710467,30283293547736.7,584.226027397261,1140199,19064137.0
1182,BTC,2022-06-11,965325317,1006512692,364280,849994,1010550080,230002,740746079,16842,9.63162889683516,740415,233467397.686599,30283293547736.7,557.104575163399,1007854,19065150.0
1182,BTC,2022-06-12,965634044,1006847249,334557,760134,1010884637,215473,740961552,15871,10.9761681143612,740542,193971749.606332,30283293547736.7,670.539682539683,1091046,19065900.0
1182,BTC,2022-06-13,965977499,1007287313,440064,1005439,1011324701,272503,741234055,26881,29.1768977476772,740675,199508218.152995,30283293547736.7,651.931818181818,1391880,19066725.0
1182,BTC,2022-06-14,966485612,1007733238,445925,1097038,1011770626,283231,741517286,23658,48.3675914245305,740821,221278124.291811,30283293547736.7,587.793103448277,1443100,19067637.0
1182,BTC,2022-06-15,966995557,1008194626,461388,1069858,1012232014,296312,741813598,23902,59.6866182218178,740986,248897724.484455,30283293547736.7,522.567073170732,1266195,19068668.0
1182,BTC,2022-06-16,967372039,1008607578,412952,893767,1012644966,251253,742064851,18654,53.4882514352982,741105,180780936.164037,30283293547736.7,719.466101694915,1372612,19069412.0
1182,BTC,2022-06-17,967715652,1009023474,415896,880351,1013060862,251574,742316425,18030,46.5504426723098,741213,164915283.130367,30283293547736.7,788.682242990654,1452408,19070087.0
1182,BTC,2022-06-18,968141630,1009433419,409945,936380,1013470807,247890,742564315,20037,42.6024329579451,741369,235516262.703482,30283293547736.7,552.258064516129,1193897,19071062.0
1182,BTC,2022-06-19,968445007,1009772295,338876,750949,1013809683,199777,742764092,13316,25.2432069236388,741502,200388432.288198,30283293547736.7,649.068181818182,1039797,19071900.0
1182,BTC,2022-06-20,968781404,1010144227,371932,834875,1014181615,236636,743000728,15949,18.6961934965402,741634,200636034.498938,30283293547736.7,648.267175572519,1130450,19072725.0
1182,BTC,2022-06-21,969198527,1010554516,410289,917352,1014591904,254438,743255166,17979,16.4138685483634,741784,228602743.202617,30283293547736.7,568.959731543624,1134158,19073656.0
1182,BTC,2022-06-22,969580507,1010959828,405312,881810,1014997216,255472,743510638,17381,12.7060786272905,741913,197595849.469928,30139562945443.3,655.1171875,1278783,19074531.0
1182,BTC,2022-06-23,969954187,1011363285,403457,861825,1015400673,255213,743765851,16561,11.4966957593103,742065,225619583.663157,29570168636358.0,562.907284768212,1064888,19075481.0
1182,BTC,2022-06-24,970325181,1011771078,407793,885638,1015808466,254348,744020199,16663,14.3708787905403,742194,189651669.161151,29570168636358.0,669.6640625,1311823,19076218.0
1182,BTC,2022-06-25,970618801,1012118443,347365,755500,1016155831,218017,744238216,12584,8.11523427203232,742345,221069418.670996,29570168636358.0,574.493333333333,1082723,19077162.0
1182,BTC,2022-06-26,970885126,1012448432,329989,715607,1016485820,206755,744444971,11843,6.63835721595023,742483,202870581.472374,29570168636358.0,626.029197080292,1271307,19078025.0
1182,BTC,2022-06-27,971352865,1012838033,389601,974966,1016875421,258883,744703854,15727,11.5129386062824,742619,198962476.803896,29570168636358.0,638.325925925926,1439817,19078875.0
1182,BTC,2022-06-28,971758467,1013227488,389455,909041,1017264876,248080,744951934,15103,16.0632224151226,742765,218086256.065212,29570168636358.0,582.351724137931,1155505,19079787.0
1182,BTC,2022-06-29,972172086,1013643727,416239,923528,1017681115,265079,745217013,16559,17.4539528945825,742916,222801694.476918,29570168636358.0,570.026666666667,1218980,19080731.0
1182,BTC,2022-06-30,972590993,1014078332,434605,963234,1018115720,271213,745488226,16589,17.4162897368869,743087,253537515.755154,29570168636358.0,500.923529411765,1071478,19081812.0
1182,BTC,2022-07-01,972945252,1014518048,439716,941571,1018555436,271874,745760100,17404,18.3605949369186,743221,199338974.257269,29570168636358.0,637.12030075188,1260714,19082637.0
1182,BTC,2022-07-02,973301575,1014901774,383726,848341,1018939162,235096,745995196,14003,14.122989958916,743359,205506322.379227,29570168636358.0,618.0,1156715,19083500.0
1182,BTC,2022-07-03,973593083,1015242882,341108,737759,1019280270,206333,746201529,11916,16.1763161621903,743514,228820681.058506,29570168636358.0,555.032467532468,857652,19084500.0
1182,BTC,2022-07-04,973957692,1015617343,374461,855494,1019654731,240385,746441914,15305,15.1933101922667,743657,212094705.712236,29570168636358.0,598.802816901409,1105456,19085362.0
1182,BTC,2022-07-05,974295239,1015988101,370758,868674,1020025489,245829,746687743,16277,14.8710892055199,743775,175966796.29047,29570168636358.0,721.74358974359,1318495,19086112.0
1182,BTC,2022-07-06,974691336,1016406198,418097,984020,1020443586,267118,746954861,17640,12.600010531777,743902,186494724.27366,29570168636358.0,681.0,1383303,19086893.0
1182,BTC,2022-07-07,975171748,1016841298,435100,1007918,1020878686,281435,747236296,17495,9.38452773350585,744059,229080267.104422,29155457214820.2,546.628205128205,1264901,19087875.0
1182,BTC,2022-07-08,975576712,1017260454,419156,946807,1021297842,268331,747504627,16439,13.9503826527166,744207,222368876.76816,29152798808271.9,563.074829931973,1234133,19088800.0
1182,BTC,2022-07-09,975900731,1017613036,352582,782171,1021650424,220708,747725335,12458,10.8893912371359,744341,193169764.447988,29152798808271.9,648.187969924812,1068876,19089637.0
1182,BTC,2022-07-10,976191812,1017931202,318166,710613,1021968590,199369,747924704,10118,9.03815707476699,744494,225963102.310404,29152798808271.9,554.118421052632,858886,19090600.0
1182,BTC,2022-07-11,976525403,1018286483,355281,838433,1022323871,229482,748154186,13504,20.1791457078378,744617,177880417.475712,29152798808271.9,703.901639344262,1210307,19091375.0
1182,BTC,2022-07-12,976962489,1018699816,413333,945981,1022737204,275378,748429564,15404,16.7275913376207,744768,219600444.546212,29152798808271.9,570.173333333333,1204294,19092312.0
1182,BTC,2022-07-13,977215052,1019050297,350481,810857,1023087685,222657,748652221,14438,23.917988973837,744878,160305444.214092,29152798808271.9,781.073394495412,1352413,19092993.0
1182,BTC,2022-07-14,977645019,1019478226,427929,990479,1023515614,286894,748939115,15641,11.0794662806985,745002,179447113.262172,29152798808271.9,697.756097560976,1519424,19093768.0
1182,BTC,2022-07-15,978071512,1019881087,402861,955069,1023918475,269269,749208384,16337,13.4089570771295,745144,207650518.848799,29152798808271.9,602.985815602837,1351248,19094656.0
1182,BTC,2022-07-16,978401107,1020236358,355271,791313,1024273746,226638,749435022,12692,12.0415858163232,745292,215354479.663197,29152798808271.9,581.414965986394,1024222,19095650.0
1182,BTC,2022-07-17,978709584,1020549916,313558,727955,1024587304,202157,749637179,11433,8.4558359001903,745416,179275825.30455,29152798808271.9,698.422764227642,1107770,19096356.0
1182,BTC,2022-07-18,979064041,1020915308,365392,874433,1024952696,247895,749885074,16024,13.3489872987286,745547,193840178.044031,29152798808271.9,645.946153846154,1206672,19097175.0
1182,BTC,2022-07-19,979539757,1021336263,420955,998065,1025373651,279950,750165024,19400,11.8826585894883,745685,202526753.481979,29152798808271.9,618.240875912409,1401116,19098037.0
1182,BTC,2022-07-20,979905695,1021726783,390520,920079,1025764171,260195,750425219,19468,9.89255558701993,745811,186065714.226012,29152798808271.9,672.936,1374580,19098825.0
1182,BTC,2022-07-21,980324203,1022140314,413531,965128,1026177702,273976,750699195,16926,13.7235257920263,745950,200192172.828584,28827135813162.6,618.463768115942,1335751,19099700.0
1182,BTC,2022-07-22,980637372,1022533023,392709,852850,1026570411,263276,750962471,16615,12.2973172759807,746082,181363825.611206,27692567959233.6,655.801526717557,1202991,19100518.0
1182,BTC,2022-07-23,980953679,1022880772,347749,776821,1026918160,223744,751186215,12548,11.8630626599473,746236,211413368.189232,27692567959233.6,562.588235294117,956607,19101481.0
1182,BTC,2022-07-24,981255370,1023211969,331197,734545,1027249357,199919,751386134,9705,8.50267176692015,746393,217501882.629067,27692567959233.6,546.839743589744,857081,19102462.0
1182,BTC,2022-07-25,981650156,1023596441,384472,905603,1027633829,253417,751639551,15253,14.8107225963015,746535,199896930.633892,27692567959233.6,595.0,1188824,19103362.0
1182,BTC,2022-07-26,982094005,1023998129,401688,962865,1028035517,264861,751904412,15495,19.6714523221668,746695,219382950.773988,27692567959233.6,542.150943396227,1159198,19104356.0
1182,BTC,2022-07-27,982458100,1024385469,387340,890784,1028422857,255930,752160342,17332,14.6514285581347,746860,226897711.837605,27692567959233.6,524.195121951219,1019873,19105381.0
1182,BTC,2022-07-28,982926463,1024815730,430261,1016625,1028853118,287254,752447596,18030,11.0635250096557,747001,197727388.816624,27692567959233.6,601.528571428572,1348517,19106262.0
1182,BTC,2022-07-29,983317698,1025250400,434670,954956,1029287788,281608,752729204,17769,12.1635827647164,747147,201529724.34373,27692567959233.6,590.179310344828,1240760,19107175.0
1182,BTC,2022-07-30,983635004,1025621250,370850,801682,1029658638,232696,752961900,12837,7.75848849721504,747276,177989457.257666,27692567959233.6,668.234375,1139579,19107981.0
1182,BTC,2022-07-31,983946905,1025960447,339197,773541,1029997835,209042,753170942,11252,7.49540263534357,747428,211485124.382398,27692567959233.6,562.397350993377,922711,19108931.0
1182,BTC,2022-08-01,984343175,1026342623,382176,908302,1030380011,249610,753420552,16737,13.8287436011073,747564,190105857.701302,27692567959233.6,625.644444444445,1287020,19109781.0
1182,BTC,2022-08-02,984741396,1026741928,399305,947567,1030779316,266968,753687520,17169,14.4150237929863,747719,218517283.696208,27692567959233.6,544.298701298701,1146315,19110750.0
1182,BTC,2022-08-03,985144574,1027159686,417758,979238,1031197074,282037,753969557,18486,15.4104416136836,747864,199187870.17168,27692567959233.6,597.118055555555,1292170,19111662.0
1182,BTC,2022-08-04,985534895,1027580434,420748,955783,1031617822,279707,754249264,16737,13.2481794897453,747996,183444286.336303,27915356836850.3,653.580152671756,1341702,19112481.0
1182,BTC,2022-08-05,985906270,1028000237,419803,950479,1032037625,268463,754517727,17203,16.4980886083116,748146,211718638.309507,28174668481289.4,571.557046979866,1156854,19113418.0
1182,BTC,2022-08-06,986297899,1028379480,379243,876047,1032416868,237677,754755404,12557,10.000774214668,748307,226378626.0765,28174668481289.4,534.54375,1013497,19114431.0
1182,BTC,2022-08-07,986587942,1028697653,318173,712883,1032735041,196161,754951565,10383,6.34989167659713,748466,226958835.177693,28174668481289.4,533.177215189873,825161,19115418.0
1182,BTC,2022-08-08,986961576,1029089723,392070,923946,1033127111,256582,755208147,16992,21.5745595548971,748610,202427670.64594,28174668481289.4,597.79020979021,1151677,19116312.0
1182,BTC,2022-08-09,987369649,1029486029,396306,953042,1033523417,256233,755464380,16522,15.5426592661351,748753,202254236.958942,28174668481289.4,598.302816901408,1271388,19117218.0
1182,BTC,2022-08-10,987875234,1029894283,408254,1033613,1033931671,264566,755728946,16682,17.7938507453112,748901,208531518.426183,28174668481289.4,580.292517006803,1360227,19118137.0
1182,BTC,2022-08-11,988304480,1030336174,441891,1012662,1034373562,287356,756016302,17923,13.3016608176408,749041,199898862.410706,28174668481289.4,605.352517985611,1358893,19119012.0
1182,BTC,2022-08-12,988709026,1030769268,433094,961031,1034806656,273661,756289963,16184,9.34004212838198,749195,216766025.787071,28174668481289.4,558.248366013072,1187840,19119975.0
1182,BTC,2022-08-13,989046390,1031151247,381979,828340,1035188635,233308,756523271,12797,7.56972904958831,749334,194736984.116983,28174668481289.4,621.398550724638,1083895,19120843.0
1182,BTC,2022-08-14,989425321,1031488593,337346,819073,1035525981,205350,756728621,11433,6.00043811820638,749467,189197935.716094,28174668481289.4,639.590909090909,1122552,19121675.0
1182,BTC,2022-08-15,989836701,1031868936,380343,918182,1035906324,241934,756970555,16011,14.2501430739178,749612,204772683.524494,28174668481289.4,590.944444444445,1185214,19122581.0
1182,BTC,2022-08-16,990315182,1032292746,423810,1032647,1036330134,273896,757244451,16385,12.0119292576094,749760,208138679.634801,28174668481289.4,581.387755102041,1310104,19123506.0
1182,BTC,2022-08-17,990671494,1032691704,398958,913886,1036729092,256127,757500578,16729,13.6114621032865,749889,181113488.949695,28174668481289.4,668.140625,1330205,19124312.0
1182,BTC,2022-08-18,991158886,1033121025,429321,1014144,1037158413,291921,757792499,16606,8.46911084748637,750033,205254936.455724,28275424991711.3,591.664335664336,1401119,19125218.0
1182,BTC,2022-08-19,991576811,1033573205,452180,999569,1037610593,279910,758072409,16789,16.2209793179366,750211,249798945.367139,28351606743493.8,487.468926553672,1080193,19126325.0
1182,BTC,2022-08-20,991936399,1033944502,371297,844049,1037981890,222722,758295131,11813,19.0891751393745,750360,213162754.927543,28351606743493.8,571.25,1011525,19127256.0
1182,BTC,2022-08-21,992264100,1034285243,340741,769158,1038322631,205435,758500566,10516,10.8840155056219,750506,208329350.513752,28351606743493.8,584.503448275862,945787,19128168.0
1182,BTC,2022-08-22,992646731,1034671581,386338,886312,1038708969,250534,758751100,14893,20.5176169156285,750651,204458480.683049,28351606743493.8,595.569444444444,1125842,19129075.0
1182,BTC,2022-08-23,993089567,1035069356,397775,936789,1039106744,256928,759008028,15860,20.1541851472632,750823,243438794.197152,28351606743493.8,500.204678362573,1053092,19130150.0
1182,BTC,2022-08-24,993487297,1035469507,400151,923697,1039506895,256606,759264634,14955,14.0405248879091,750969,205851928.276871,28351606743493.8,591.537931034483,1156057,19131112.0
1182,BTC,2022-08-25,993897930,1035874645,405138,920757,1039912033,260460,759525094,15202,12.487343240067,751128,226801100.470031,28351606743493.8,536.898734177215,1094529,19132056.0
1182,BTC,2022-08-26,994289023,1036296397,421752,931907,1040333785,262722,759787816,14894,11.0604965342508,751304,249325652.068736,28351606743493.8,488.394285714286,1001132,19133156.0
1182,BTC,2022-08-27,994657794,1036671129,374732,844000,1040708517,225420,760013236,11677,13.2989072196635,751449,205332367.885753,28351606743493.8,593.034722222223,1072243,19134068.0
1182,BTC,2022-08-28,994982764,1037006435,335306,772045,1041043823,202109,760215345,10017,8.91561964115705,751610,225901210.495297,28351606743493.8,539.0375,878384,19135075.0
1182,BTC,2022-08-29,995416624,1037399990,393555,940481,1041437378,252235,760467580,14509,14.6809742499157,751767,221117681.562677,28351606743493.8,550.698717948718,1140683,19136050.0
1182,BTC,2022-08-30,995842078,1037808266,408276,952599,1041845654,262445,760730025,14369,13.1423378465778,751929,229315207.375221,28351606743493.8,531.012422360249,1118923,19137062.0
1182,BTC,2022-08-31,996235249,1038210696,402430,925078,1042248084,260425,760990450,15345,16.2892144080155,752075,224283150.819894,30293716756044.2,580.11724137931,1212705,19137981.0
1182,BTC,2022-09-01,996623917,1038632898,422202,969780,1042670286,268022,761258472,15608,15.6603749787864,752213,212107234.86119,30977051760460.1,627.255474452555,1268659,19138837.0
1182,BTC,2022-09-02,996988156,1039059015,426117,993737,1043096403,270588,761529060,14653,14.4578902086772,752342,197733692.916371,30977051760460.1,672.8515625,1407585,19139643.0
1182,BTC,2022-09-03,997420490,1039468679,409664,945920,1043506067,242597,761771657,12000,8.12833416589818,752489,225712963.649364,30977051760460.1,589.445205479452,1193150,19140562.0
1182,BTC,2022-09-04,997758176,1039804226,335547,774346,1043841614,204538,761976195,9248,12.3221344189403,752657,261878833.229515,30977051760460.1,508.041916167665,861416,19141612.0
1182,BTC,2022-09-05,998195450,1040189383,385157,939069,1044226771,250179,762226374,13076,17.4273394407737,752810,237966916.336714,30977051760460.1,559.092105263158,1166262,19142568.0
1182,BTC,2022-09-06,998605387,1040595108,405725,931166,1044632496,268125,762494499,16833,23.9942443056505,752952,218748161.308708,30977051760460.1,608.212765957447,1258158,19143456.0
1182,BTC,2022-09-07,999051292,1041014791,419683,961941,1045052179,265239,762759738,18102,21.8399834173274,753098,225910024.175454,30977051760460.1,588.931034482759,1281344,19144368.0
1182,BTC,2022-09-08,999449359,1041438577,423786,934179,1045475965,262863,763022601,15596,18.7757238415727,753225,197543317.353638,30977051760460.1,673.5,1380804,19145162.0
1182,BTC,2022-09-09,999880972,1041895126,456549,1036225,1045932514,290849,763313450,16223,14.2058788715405,753372,233046177.474782,30977051760460.1,570.897260273973,1377290,19146093.0
1182,BTC,2022-09-10,1000268560,1042306329,411203,897672,1046343717,241936,763555386,12936,9.64137995519046,753529,240842523.887781,30977051760460.1,552.416666666667,1051505,19147081.0
1182,BTC,2022-09-11,1000666063,1042691485,385156,862582,1046728873,220361,763775747,11327,5.94098482356288,753712,282273494.879602,30977051760460.1,471.335164835165,876390,19148206.0
1182,BTC,2022-09-12,1001142149,1043105454,413969,987756,1047142842,268971,764044718,16663,9.01388472904451,753865,242501222.933899,30977051760460.1,548.638157894737,1222385,19149162.0
1182,BTC,2022-09-13,1001348763,1043285933,180479,476690,1047323321,115814,764160532,7902,7.52944384812838,753943,229424622.450921,30977051760460.1,579.909090909091,1085263,19150018.0
1182,BTC,2022-09-14,1001348761,1043285933,0,0,1047323321,0,0,0,0.0,0,0.0,0.0,0.0,0,19150812.0
1182,BTC,2022-09-15,1001348757,1043285933,0,0,1047323321,0,0,0,0.0,0,0.0,0.0,0.0,0,19151731.0
1182,BTC,2022-09-16,1002713694,1044805012,425416,937515,1047748737,261361,765113537,14863,11.9329718221093,754404,208448976.898638,32045359565303.1,660.275590551181,1286414,19155068.0
1182,BTC,2022-09-17,1003153594,1045222294,417282,936221,1048166019,247863,765361400,11113,7.5131188042743,754574,272695491.674266,32045359565303.1,504.715976331361,1038760,19155068.0
1182,BTC,2022-09-18,1003507628,1045589554,367260,779131,1048533279,212396,765573796,10096,9.22592120825124,754728,245811888.033843,32045359565303.1,559.915032679739,945075,19155068.0
1182,BTC,2022-09-19,1003901616,1045994125,404571,916643,1048937850,253795,765827591,15949,19.1021949486951,754858,207257999.188448,32045359565303.1,664.069767441861,1253221,19155375.0
1182,BTC,2022-09-20,1004383210,1046408056,413931,968908,1049351781,269773,766097364,15393,16.6853641827002,755010,241698642.448215,32045359565303.1,569.443708609272,1275621,19156318.0
1182,BTC,2022-09-21,1004805231,1046814584,406528,915105,1049758309,260924,766358288,16013,17.8329518469617,755151,225560461.510726,32045359565303.1,610.185714285714,1217900,19157200.0
1182,BTC,2022-09-22,1005164566,1047210561,395977,866821,1050154286,245794,766604082,14599,14.1113588318417,755279,205786307.485699,32045359565303.1,668.818897637795,1225528,19158000.0
1182,BTC,2022-09-23,1005621670,1047656977,446416,987921,1050600702,281419,766885501,14696,10.205618988422,755414,213979874.197541,32045359565303.1,643.208955223881,1380416,19158837.0
1182,BTC,2022-09-24,1005980249,1048043143,386166,814336,1050986868,228040,767113541,10343,6.90055297583288,755560,235969646.009684,32045359565303.1,583.268965517241,1043804,19159756.0
1182,BTC,2022-09-25,1006315161,1048414786,371643,795079,1051358511,212009,767325550,9500,8.51850578829762,755707,234499896.289511,32045359565303.1,586.924657534246,953861,19160675.0
1182,BTC,2022-09-26,1006774438,1048810561,395775,932798,1051754286,259311,767584861,12951,11.7307852545146,755857,240587429.77873,32045359565303.1,572.073825503356,1179956,19161612.0
1182,BTC,2022-09-27,1007229009,1049221802,411241,955761,1052165527,271117,767855978,15072,10.3354836115372,755986,208817802.540796,32045359565303.1,659.109375,1460768,19162418.0
1182,BTC,2022-09-28,1007616735,1049621078,399276,867381,1052564803,264048,768120026,14554,12.29148430914,756136,238930164.989616,31419898493798.6,564.798657718121,1113080,19163468.0
1182,BTC,2022-09-29,1007998687,1050038186,417108,887558,1052981911,267342,768387368,15238,10.3826287217206,756279,223867445.666196,31360548173144.9,601.661971830986,1215810,19164256.0
1182,BTC,2022-09-30,1008432851,1050486954,448768,993821,1053430679,286672,768674040,15031,9.02539378682243,756448,263699815.133639,31360548173144.9,510.779761904762,1137219,19165306.0
1182,BTC,2022-10-01,1008830616,1050894774,407820,884590,1053838499,241993,768916033,10520,5.99237648146905,756629,289495333.403689,31360548173144.9,465.266666666667,931414,19166450.0
1182,BTC,2022-10-02,1009227262,1051264209,369435,841556,1054207934,213646,769129679,9549,5.6057657948132,756786,245774911.290669,31360548173144.9,548.032051282051,983753,19167425.0
1182,BTC,2022-10-03,1009716244,1051684686,420477,989556,1054628411,273820,769403499,13427,8.84499711039216,756940,240899129.177382,31360548173144.9,559.124183006536,1245323,19168381.0
1182,BTC,2022-10-04,1010150459,1052102764,418078,938192,1055046489,278744,769682243,14607,8.86166673859925,757103,254516279.378796,31360548173144.9,529.20987654321,1111434,19169418.0
1182,BTC,2022-10-05,1010531417,1052510496,407732,894638,1055454221,267021,769949264,15233,8.03259601803637,757278,273957310.622836,31360548173144.9,491.655172413793,977979,19170493.0
1182,BTC,2022-10-06,1010950314,1052947308,436812,944081,1055891033,278204,770227468,15055,6.17800270662241,757437,247807025.565619,31360548173144.9,543.537974683544,1140855,19171487.0
1182,BTC,2022-10-07,1011375831,1053387718,440410,946342,1056331443,270191,770497659,14352,6.58638403018035,757608,270998294.482558,31360548173144.9,497.023529411765,1151927,19172556.0
1182,BTC,2022-10-08,1011710422,1053784892,397174,820789,1056728617,235498,770733157,11483,6.16839085455927,757783,274541386.607811,31360548173144.9,490.609195402299,855713,19173650.0
1182,BTC,2022-10-09,1012045466,1054146481,361589,776456,1057090206,211238,770944395,9399,7.1619961420342,757941,250654612.281742,31360548173144.9,537.363057324841,883335,19174637.0
1182,BTC,2022-10-10,1012484919,1054545892,399411,917604,1057489617,258286,771202681,12599,8.96846133333417,758109,281097203.296111,33738662001569.4,515.502994011976,1050634,19175693.0
1182,BTC,2022-10-11,1012905487,1054954340,408448,902571,1057898065,266451,771469132,13908,9.96600564548956,758266,278650907.738397,35610794164371.6,548.884615384615,1111307,19176668.0
1182,BTC,2022-10-12,1013283207,1055370084,415744,876831,1058313809,261196,771730328,13410,9.1094415102863,758403,242289765.985215,35610794164371.6,631.257352941177,1211656,19177531.0
1182,BTC,2022-10-13,1013707332,1055819895,449811,949993,1058763620,281093,772011421,15007,9.74368961221201,758546,252755267.582018,35610794164371.6,605.119718309859,1348097,19178418.0
1182,BTC,2022-10-14,1014133854,1056266600,446705,983980,1059210325,284648,772296069,14595,6.95383253963787,758702,280976324.531395,35610794164371.6,544.341935483871,1320485,19179412.0
1182,BTC,2022-10-15,1014518494,1056670755,404155,863932,1059614480,241758,772537827,10680,3.71255184061777,758854,268344003.304539,35610794164371.6,569.966887417219,1064861,19180343.0
1182,BTC,2022-10-16,1014846803,1057039870,369115,767400,1059983595,212919,772750746,9678,3.92934100731818,758998,257674941.96325,35610794164371.6,593.566433566434,959875,19181243.0
1182,BTC,2022-10-17,1015256655,1057437278,397408,876676,1060381003,260471,773011217,12227,5.86515751969993,759148,265830676.695642,35610794164371.6,575.355704697987,1142144,19182181.0
1182,BTC,2022-10-18,1015624534,1057832855,395577,887436,1060776580,257694,773268911,13625,8.72715785618276,759290,253816920.863879,35610794164371.6,602.58865248227,1300711,19183068.0
1182,BTC,2022-10-19,1016063679,1058229650,396795,925521,1061173375,263517,773532428,14803,8.89873677318936,759441,268907115.290035,35610794164371.6,568.773333333333,1373442,19184012.0
1182,BTC,2022-10-20,1016477354,1058640675,411025,894481,1061584400,263986,773796414,13799,6.73493278303027,759586,263743114.591126,35610794164371.6,579.909722222222,1220903,19184918.0
1182,BTC,2022-10-21,1016881247,1059079759,439084,929251,1062023484,270741,774067155,13196,6.88004842831717,759742,277233785.07914,35610794164371.6,551.690322580645,1140868,19185900.0
1182,BTC,2022-10-22,1017245182,1059480921,401162,835674,1062424646,233097,774300252,9865,5.41019101337207,759878,240766234.485898,35610794164371.6,635.251851851852,1121854,19186743.0
1182,BTC,2022-10-23,1017587337,1059856239,375318,808800,1062799964,217872,774518124,10965,5.9568773674715,760033,276158422.839214,35626599175757.7,554.084415584416,927848,19187712.0
1182,BTC,2022-10-24,1018018871,1060266782,410543,923403,1063210507,264486,774782610,12544,6.97502947848052,760169,249533683.074113,36835682546788.0,634.014814814815,1287803,19188568.0
1182,BTC,2022-10-25,1018336630,1060649757,382975,830671,1063593482,248540,775031150,13661,7.61014460833286,760291,225856842.723747,36835682546788.0,700.479338842975,1197666,19189325.0
1182,BTC,2022-10-26,1018881257,1061096789,447032,1053033,1064040514,306069,775337219,16684,8.3980781622854,760446,284536886.579011,36835682546788.0,556.019480519481,1378651,19190293.0
1182,BTC,2022-10-27,1019281854,1061514791,418002,901087,1064458516,267995,775605214,15018,9.89962365940208,760581,250717018.695261,36835682546788.0,631.022388059701,1274635,19191137.0
1182,BTC,2022-10-28,1019704665,1061956447,441656,942825,1064900172,283035,775888249,14897,6.43025119635144,760740,292118500.362952,36835682546788.0,541.588607594937,1149426,19192131.0
1182,BTC,2022-10-29,1020075625,1062396249,439802,884714,1065339974,252661,776140910,12652,7.30853092923138,760883,264755266.277718,36835682546788.0,597.56338028169,1132976,19193025.0
1182,BTC,2022-10-30,1020454609,1062791908,395659,833298,1065735633,222138,776363048,10769,5.95586669582233,761018,248210171.404329,36835682546788.0,637.39552238806,1138961,19193868.0
1182,BTC,2022-10-31,1020938519,1063231981,440073,972865,1066175706,284125,776647173,15252,7.39660883101424,761191,316802897.964472,36835682546788.0,499.389534883721,1080200,19194950.0
1182,BTC,2022-11-01,1021398171,1063662933,430952,963108,1066606658,276192,776923365,15374,7.64966234404393,761335,266994174.976029,36835682546788.0,592.552447552447,1308074,19195850.0
1182,BTC,2022-11-02,1021757560,1064069189,406256,873292,1067012914,257467,777180832,14941,9.55929467780512,761457,225023207.113732,36835682546788.0,703.07438016529,1252918,19196618.0
1182,BTC,2022-11-03,1022236697,1064541134,471945,1016762,1067484859,297039,777477871,16352,11.5385519558829,761621,301651820.16259,36835682546788.0,524.472392638037,1178928,19197637.0
1182,BTC,2022-11-04,1022619778,1064987374,446240,950915,1067931099,281515,777759386,16328,13.0631998598206,761750,236882727.852206,36835682546788.0,667.875,1351270,19198443.0
1182,BTC,2022-11-05,1023072027,1065419931,432557,933416,1068363656,257198,778016584,13497,7.43644141862063,761901,276839175.23674,36835682546788.0,571.48,1165122,19199381.0
1182,BTC,2022-11-06,1023453585,1065800821,380890,825050,1068744546,223404,778239988,13463,17.4758848139338,762038,251567246.823227,36835682546788.0,628.889705882353,1072657,19200243.0
1182,BTC,2022-11-07,1023863325,1066220968,420147,919351,1069164693,264869,778504857,18249,14.8179906758417,762182,262687899.710639,36766791551487.3,601.13986013986,1182003,19201143.0
1182,BTC,2022-11-08,1024388785,1066692841,471873,1059839,1069636566,295778,778800635,20170,7.19306536894769,762345,298699981.876232,36762198818467.2,528.598765432099,1224523,19202162.0
1182,BTC,2022-11-09,1024853297,1067188864,496023,1076548,1070132589,292265,779092900,23728,12.6950447422716,762494,271264511.751654,36762198818467.2,582.060810810811,1310950,19203093.0
1182,BTC,2022-11-10,1025314085,1067708501,519637,1053637,1070652226,292831,779385731,22367,13.3819703690406,762641,270126161.327617,36762198818467.2,584.513698630137,1321115,19204012.0
1182,BTC,2022-11-11,1025722535,1068213923,505422,977570,1071157648,284467,779670198,19429,14.3557874222887,762775,250354014.544954,36762198818467.2,630.676691729323,1311679,19204862.0
1182,BTC,2022-11-12,1026121478,1068673625,459702,927792,1071617350,239254,779909452,14676,10.4957920055403,762942,307500883.601117,36762198818467.2,513.469879518072,1077008,19205893.0
1182,BTC,2022-11-13,1026495983,1069119646,446021,897887,1072063371,227644,780137096,14556,14.8107425702249,763071,234890721.072034,36762198818467.2,672.1953125,1210634,19206700.0
1182,BTC,2022-11-14,1026846212,1069551923,432277,948108,1072495648,242416,780379512,16635,13.1254993552245,763194,229560466.701219,36762198818467.2,687.803278688525,1294296,19207475.0
1182,BTC,2022-11-15,1027192133,1070010195,458272,997707,1072953920,283090,780662602,17865,9.55376364215016,763349,285064550.338489,36762198818467.2,553.883116883117,1335959,19208443.0
1182,BTC,2022-11-16,1027531448,1070449935,439740,955242,1073393660,268373,780930975,18059,8.18973661519382,763499,273148112.790124,36762198818467.2,578.046979865772,1309563,19209375.0
1182,BTC,2022-11-17,1027832479,1070862470,412535,885270,1073806195,248465,781179440,15715,6.47291970735114,763637,253388441.882769,36762198818467.2,623.124087591241,1302199,19210237.0
1182,BTC,2022-11-18,1028216604,1071317849,455379,971978,1074261574,282091,781461531,16876,6.37279164820721,763776,258913885.501956,36762198818467.2,609.826086956522,1369823,19211106.0
1182,BTC,2022-11-19,1028817470,1071750022,432173,1109770,1074693747,260694,781722225,13390,4.55984031605415,763923,269485124.050613,36762198818467.2,585.904109589041,1496934,19212125.0
1182,BTC,2022-11-20,1029381907,1072157397,407375,1019510,1075101122,229923,781952148,13870,7.10516022788255,764072,275356763.535461,36773572356982.6,573.587837837838,1424174,19212956.0
1182,BTC,2022-11-21,1029855539,1072594397,437000,978810,1075538122,270779,782222927,15540,6.44389387028374,764201,241703737.797934,36950494067222.4,656.59375,1422428,19213762.0
1182,BTC,2022-11-22,1030279591,1073000652,406255,928080,1075944377,253235,782476162,14662,6.0355638426554,764327,239845791.908116,36950494067222.4,661.68,1423033,19214550.0
1182,BTC,2022-11-23,1030749268,1073462818,462166,1061671,1076406543,273997,782750159,15526,4.63964905747855,764468,259770406.90479,36950494067222.4,610.928571428571,1474427,19215543.0
1182,BTC,2022-11-24,1031211952,1073890873,428055,997933,1076834598,254639,783004798,14082,3.64952500147746,764597,235888208.224831,36950494067222.4,672.78125,1571701,19216237.0
1182,BTC,2022-11-25,1031645927,1074307656,416783,981952,1077251381,258341,783263139,13146,5.87504926277776,764720,226411061.895001,36950494067222.4,700.94262295082,1506700,19217006.0
1182,BTC,2022-11-26,1032057565,1074703350,395694,893310,1077647075,229735,783492874,11072,3.46016207620315,764829,203204923.325007,36950494067222.4,780.990740740741,1519975,19217693.0
1182,BTC,2022-11-27,1032484884,1075090826,387476,857686,1078034551,222672,783715546,10564,3.11373679481965,764965,249382000.961669,36950494067222.4,636.377777777778,1150471,19218537.0
1182,BTC,2022-11-28,1032940649,1075504870,414044,940694,1078448595,262636,783978182,13324,3.7623836159627,765104,266448817.755182,36950494067222.4,595.615942028986,1336178,19219406.0
1182,BTC,2022-11-29,1033402921,1075941399,436529,964873,1078885124,271512,784249694,13497,3.47500540500486,765235,241641987.686306,36950494067222.4,656.761538461539,1361236,19220225.0
1182,BTC,2022-11-30,1033815932,1076369117,427718,941581,1079312842,271416,784521110,13957,3.19649067321728,765373,257582923.559348,36950494067222.4,616.116788321168,1248211,19221087.0
1182,BTC,2022-12-01,1034296059,1076827895,458778,1035543,1079771620,285467,784806577,14834,3.12302076051572,765526,284561664.550894,36950494067222.4,557.703947368421,1255363,19222050.0
1182,BTC,2022-12-02,1034701986,1077272604,444709,971482,1080216329,271725,785078302,13505,2.99889641635904,765651,233608474.520478,36950494067222.4,679.346774193549,1392480,19222825.0
1182,BTC,2022-12-03,1035134468,1077709646,437042,942108,1080653371,250951,785329253,11250,2.7373795391472,765782,240487140.153972,36950494067222.4,659.915384615384,1318575,19223643.0
1182,BTC,2022-12-04,1035553352,1078095214,385568,854339,1081038939,219810,785549063,9829,2.55671718336359,765922,260848804.97324,36950494067222.4,608.402877697842,1086377,19224518.0
1182,BTC,2022-12-05,1036026791,1078525286,430072,968963,1081469011,274064,785823127,13770,3.36676373207878,766068,268988167.255205,36950494067222.4,589.993103448276,1246357,19225431.0
1182,BTC,2022-12-06,1036467127,1078939243,413957,945078,1081882968,262438,786085565,13776,3.07236212686718,766203,233690249.948284,34464833739061.4,633.425373134328,1328943,19226275.0
1182,BTC,2022-12-07,1036917344,1079370105,430862,923181,1082313830,272328,786357893,14033,3.28504179062454,766375,293624267.400467,34244331613176.2,500.906432748538,1029506,19227375.0
1182,BTC,2022-12-08,1037334372,1079798000,427895,886391,1082741725,263838,786621731,13022,3.5706791015229,766542,283700661.202514,34244331613176.2,518.427710843373,1004454,19228306.0
1182,BTC,2022-12-09,1037740499,1080231236,433236,945942,1083174961,265668,786887399,13096,3.31773636645456,766694,264277463.672088,34244331613176.2,556.529801324503,1180113,19229343.0
1182,BTC,2022-12-10,1038213762,1080639377,408141,937078,1083583102,241668,787129067,10498,2.79463922440472,766848,262655121.165468,34244331613176.2,559.967320261438,1285053,19230312.0
1182,BTC,2022-12-11,1038565749,1081027946,388569,776310,1083971671,217788,787346855,10122,2.89076825883359,766995,249094372.959976,34244331613176.2,590.452054794521,972099,19231225.0
1182,BTC,2022-12-12,1038994077,1081446270,418324,909723,1084389995,262646,787609501,12895,3.31035576153069,767138,246542595.830341,34244331613176.2,596.56338028169,1200833,19232118.0
1182,BTC,2022-12-13,1039447567,1081919931,473661,975737,1084863656,287224,787896725,14822,4.39701850721607,767303,282972262.569927,34244331613176.2,519.762195121951,1119508,19233150.0
1182,BTC,2022-12-14,1039872047,1082362195,442264,929316,1085305920,276441,788173166,14959,4.9641608920833,767451,257218580.688117,34244331613176.2,571.802721088436,1205358,19234075.0
1182,BTC,2022-12-15,1040280879,1082823679,461484,916384,1085767404,276713,788449879,13586,3.74153448358216,767590,237798357.885159,34244331613176.2,618.5,1235629,19234956.0
1182,BTC,2022-12-16,1040601957,1083261295,437616,880665,1086205020,254176,788704055,13245,4.41750727492423,767720,220371430.5125,34244331613176.2,667.410852713178,1183964,19235756.0
1182,BTC,2022-12-17,1041070929,1083716254,454959,973490,1086659979,263200,788967255,11470,2.9949115983516,767858,235752017.739791,34244331613176.2,623.868613138686,1289653,19236631.0
1182,BTC,2022-12-18,1041450468,1084094037,377783,806020,1087037762,212673,789179928,9309,3.32530089786842,768003,246061749.29053,34244331613176.2,597.729166666667,980154,19237525.0
1182,BTC,2022-12-19,1041946011,1084506657,412620,966009,1087450382,259096,789439024,12441,4.04822203195275,768139,233470454.79137,34606598588473.0,636.62962962963,1322322,19238375.0
1182,BTC,2022-12-20,1042404996,1084936582,429925,953831,1087880307,268893,789707917,14249,3.69107124768953,768279,245235955.429797,35364065900457.1,619.352517985611,1314352,19239250.0
1182,BTC,2022-12-21,1042856102,1085369952,433370,929009,1088313677,272491,789980408,12270,3.17366263574599,768422,253884851.709664,35364065900457.1,598.253521126761,1220129,19240143.0
1182,BTC,2022-12-22,1043274382,1085809271,439319,905153,1088752996,271181,790251589,13653,3.02968225291455,768557,240860177.636608,35364065900457.1,630.60447761194,1244493,19240993.0
1182,BTC,2022-12-23,1043639104,1086254308,445037,893033,1089198033,273926,790525515,12987,3.2291012987681,768689,231167303.927861,35364065900457.1,657.045801526718,1262014,19241806.0
1182,BTC,2022-12-24,1043929296,1086619938,365630,760320,1089563663,213339,790738854,8224,2.83889555998936,768778,155282547.651524,35364065900457.1,978.136363636364,1449313,19243250.0
1182,BTC,2022-12-25,1044294032,1086966876,346938,756854,1089910601,205314,790944168,8044,2.80220135592176,768919,249019239.617848,35364065900457.1,609.942857142857,987936,19243250.0
1182,BTC,2022-12-26,1044664027,1087329898,363022,782542,1090273623,223504,791167672,9258,2.95243835139,769048,226507605.921971,35364065900457.1,670.562500000001,1119263,19244062.0
1182,BTC,2022-12-27,1045062615,1087715631,385733,865433,1090659356,239359,791407031,10909,3.09579671009145,769163,201933312.425507,35364065900457.1,752.166666666667,1376405,19244775.0
1182,BTC,2022-12-28,1045503162,1088160331,444700,916269,1091104056,272949,791679980,12023,3.19846660445406,769331,298435343.492961,35364065900457.1,508.946107784431,1026325,19245837.0
1182,BTC,2022-12-29,1045952115,1088608258,447927,951167,1091551983,265955,791945935,12143,3.26800878225711,769472,247791771.94485,35364065900457.1,612.964285714286,1263212,19246718.0
1182,BTC,2022-12-30,1046502599,1089095025,486767,1071554,1092038750,291015,792236950,11945,3.04739859509104,769630,278823016.894243,35364065900457.1,544.745222929937,1356429,19247693.0
1182,BTC,2022-12-31,1046885616,1089508777,413752,845887,1092452502,242325,792479275,9406,2.58472844664661,769786,278623408.290192,35364065900457.1,545.135483870968,1071710,19249637.0
1182,BTC,2023-01-01,1047213005,1089843707,334930,720492,1092787432,187516,792666791,7886,2.97077226616603,769941,273982125.500943,35364065900457.1,554.37012987013,842700,19250612.0
1182,BTC,2023-01-02,1047633248,1090229115,385408,852672,1093172840,229347,792896138,10524,2.99597979331406,770097,278359859.852536,35364065900457.1,545.651612903226,1021220,19250612.0
1182,BTC,2023-01-03,1048140517,1090658554,429439,984940,1093602279,272055,793168193,16387,3.03876646068567,770251,262372413.210784,34209069922954.1,559.993464052287,1248256,19251575.0
1182,BTC,2023-01-04,1048578045,1091091488,432934,924789,1094035213,277936,793446129,17474,3.14232057367693,770394,247070061.148409,34093570325203.8,592.669014084507,1224450,19252475.0
1182,BTC,2023-01-05,1049013896,1091549032,457544,937729,1094492757,279391,793725520,13335,3.15122532248032,770551,265171513.725669,34093570325203.8,552.211538461538,1155025,19254587.0
1182,BTC,2023-01-06,1049447099,1092009180,460148,953581,1094952905,276071,794001591,12076,3.61038668904782,770731,306964769.634634,34093570325203.8,477.027932960894,1052704,19254587.0
1182,BTC,2023-01-07,1049803419,1092416980,407800,807340,1095360705,246679,794248270,9233,3.02572552406565,770885,260649972.557948,34093570325203.8,561.790849673202,956566,19255537.0
1182,BTC,2023-01-08,1050148243,1092800246,383266,773840,1095743971,228488,794476758,9130,3.12277461813605,771038,261366835.43173,34093570325203.8,560.25,905175,19256506.0
1182,BTC,2023-01-09,1050579970,1093242557,442311,984100,1096186282,287347,794764105,13437,3.66575009689797,771190,258514996.926782,34093570325203.8,566.430463576159,1235484,19257443.0
1182,BTC,2023-01-10,1051232480,1093706712,464155,1150952,1096650437,302809,795066914,13209,3.22426876385963,771359,287350565.750958,34093570325203.8,509.589285714286,1378499,19258500.0
1182,BTC,2023-01-11,1051647132,1094151352,444640,945470,1097095077,287494,795354408,12420,2.99633028879764,771506,250188907.729476,34093570325203.8,585.280821917808,1295226,19259418.0
1182,BTC,2023-01-12,1052158898,1094632477,481125,1050430,1097576202,315980,795670388,13899,3.43356832845459,771657,254975569.193374,34093570325203.8,574.293333333333,1350650,19260362.0
1182,BTC,2023-01-13,1052699428,1095129099,496622,1074196,1098072824,316549,795986937,13932,3.43080411320336,771816,270682690.311549,34093570325203.8,540.96835443038,1278143,19261356.0
1182,BTC,2023-01-14,1053156609,1095621965,492866,983318,1098565690,309880,796296817,13957,2.98109339092139,771987,291701596.283092,34093570325203.8,501.988235294118,1113400,19262431.0
1182,BTC,2023-01-15,1053504324,1096032614,410649,811063,1098976339,252086,796548903,10410,2.98491600919508,772150,279602440.034423,34586995580398.6,531.29012345679,876146,19263437.0
1182,BTC,2023-01-16,1053982349,1096484451,451837,971751,1099428176,302804,796851707,14376,2.73721069724792,772297,277150691.210534,37590453655497.1,582.534246575342,1260744,19264368.0
1182,BTC,2023-01-17,1054486356,1096939181,454730,993453,1099882906,308715,797160422,13867,3.25920746958013,772453,294904535.975646,37590453655497.1,547.464516129032,1242123,19265343.0
1182,BTC,2023-01-18,1054933226,1097395996,456815,953948,1100339721,300045,797460467,13413,2.99963898251529,772593,261127027.889026,37590453655497.1,618.280575539568,1339286,19266218.0
1182,BTC,2023-01-19,1055365727,1097856321,460325,935852,1100800046,298919,797759386,13431,2.72588988507489,772738,270036201.280813,37590453655497.1,597.881944444445,1295968,19267125.0
1182,BTC,2023-01-20,1055747042,1098319850,463529,918882,1101263575,295822,798055208,14252,2.79570340888578,772870,246381954.650095,37590453655497.1,655.282442748092,1293477,19267943.0
1182,BTC,2023-01-21,1056142088,1098777161,457311,905450,1101720886,287860,798343068,13225,2.91436637076086,773008,259106406.204257,37590453655497.1,623.102189781022,1177075,19268800.0
1182,BTC,2023-01-22,1056557861,1099192423,415262,863602,1102136148,250760,798593828,10784,2.59250723450841,773159,289595998.371594,37590453655497.1,557.5,1101524,19269750.0
1182,BTC,2023-01-23,1057020638,1099630346,437923,932335,1102574071,293709,798887537,13370,2.88983007974638,773317,297800810.041234,37590453655497.1,542.140127388535,1100509,19270737.0
1182,BTC,2023-01-24,1057450180,1100067523,437177,915811,1103011248,292970,799180507,13076,2.59142617508127,773446,247216518.653439,37590453655497.1,653.0703125,1342045,19271543.0
1182,BTC,2023-01-25,1057881239,1100529193,461670,922991,1103472918,306681,799487188,13227,2.76347842844232,773621,327000195.812272,37590453655497.1,493.729885057471,1000924,19272637.0
1182,BTC,2023-01-26,1058302006,1100979342,450149,901563,1103923067,296263,799783451,13108,2.64653686364487,773776,291709366.562167,37590453655497.1,553.461038961039,1106107,19273618.0
1182,BTC,2023-01-27,1058712624,1101445326,465984,928369,1104389051,303179,800086630,13992,2.60270726677827,773930,292336086.902661,37590453655497.1,552.274509803922,1141640,19274575.0
1182,BTC,2023-01-28,1059111158,1101878145,432819,862388,1104821870,268849,800355479,10828,1.92463073149772,774098,320120052.69684,37590453655497.1,504.341317365269,960155,19275618.0
1182,BTC,2023-01-29,1059490478,1102301813,423668,835444,1105245538,258583,800614062,11190,2.2164466503926,774259,312071185.368617,38858880377385.0,534.80625,989034,19276625.0
1182,BTC,2023-01-30,1059946620,1102749355,447542,948343,1105693080,309909,800923971,13377,2.9827169376818,774397,274449826.38144,39350942467772.6,615.817518248175,1331806,19277487.0
1182,BTC,2023-01-31,1060347886,1103223461,474106,948426,1106167186,313500,801237471,14831,2.8973629536401,774512,228925137.233356,39350942467772.6,738.280701754386,1539453,19278206.0
1182,BTC,2023-02-01,1060860467,1103721322,497861,1054557,1106665047,345561,801583032,14293,2.63889664566308,774649,280690904.655779,39350942467772.6,602.125,1575890,19279062.0
1182,BTC,2023-02-02,1061323015,1104230276,508954,1004623,1107174001,340169,801923201,14787,2.28255910197043,774794,284796685.769097,39350942467772.6,593.444444444444,1426083,19279968.0
1182,BTC,2023-02-03,1061736456,1104722567,492291,993120,1107666292,315951,802239152,13665,2.56312774371684,774927,260932331.927785,39350942467772.6,647.719696969697,1461705,19280800.0
1182,BTC,2023-02-04,1062202514,1105194753,472186,977809,1108138478,304495,802543647,13203,1.66637589987708,775063,268362951.275464,39350942467772.6,629.785185185185,1758863,19281656.0
1182,BTC,2023-02-05,1062560772,1105597597,402844,809568,1108541322,254113,802797760,10589,2.12733927506271,775215,296238640.678882,39350942467772.6,570.523178807947,1629097,19282600.0
1182,BTC,2023-02-06,1062967023,1106041997,444400,915864,1108985722,301977,803099737,13302,2.22446373951003,775363,299524016.685131,39350942467772.6,564.265306122449,2203473,19283525.0
1182,BTC,2023-02-07,1063352020,1106500740,458743,933987,1109444465,300429,803400166,14245,2.10004919767892,775505,280726036.897435,39350942467772.6,602.049645390071,2142792,19284412.0
1182,BTC,2023-02-08,1063762731,1106956543,455803,945889,1109900268,316963,803717129,14800,2.08108245430997,775643,278476776.099233,39350942467772.6,606.912408759124,2108701,19285287.0
1182,BTC,2023-02-09,1064246774,1107506931,550388,1074333,1110450656,369499,804086628,13920,2.2413721905154,775805,317608291.494545,39350942467772.6,532.136645962733,2143936,19286300.0
1182,BTC,2023-02-10,1064588028,1107969435,462504,916853,1110913160,300092,804386720,14853,4.60527110915573,775952,288094798.671536,39350942467772.6,586.650684931507,2064632,19287218.0
1182,BTC,2023-02-11,1064955340,1108404775,435340,883953,1111348500,277433,804664153,11095,2.97165158422697,776100,301732069.613572,39350942467772.6,560.136054421769,2358842,19288131.0
1182,BTC,2023-02-12,1065339123,1108839859,435084,876806,1111783584,262528,804926681,10893,2.70501862630858,776262,322662186.402354,39227251924109.8,522.155279503105,2517537,19289143.0
1182,BTC,2023-02-13,1065776986,1109282051,442192,970819,1112225776,299329,805226010,13650,2.91631746817361,776418,304622960.091879,39156400059293.2,552.077419354839,2162067,19290118.0
1182,BTC,2023-02-14,1066151614,1109732417,450366,912315,1112676142,302653,805528663,14216,2.52599161274965,776572,305668219.218745,39156400059293.2,550.18954248366,2336343,19291087.0
1182,BTC,2023-02-15,1066604905,1110220998,488581,994080,1113164723,325460,805854123,16757,2.50260942865378,776735,316666753.585966,39156400059293.2,531.08024691358,2190209,19292106.0
1182,BTC,2023-02-16,1067153128,1110726471,505473,1127027,1113670196,344711,806198834,17244,2.92982626464154,776914,347465920.719054,39156400059293.2,484.005617977528,2106646,19293325.0
1182,BTC,2023-02-17,1067652601,1111198655,472184,1052081,1114142380,321260,806520094,15095,2.8961040002898,777079,322653865.304993,39156400059293.2,521.225609756098,2048259,19294256.0
1182,BTC,2023-02-18,1068182909,1111641749,443094,1054449,1114585474,276798,806796892,13486,2.1901576613232,777247,326050075.845589,39156400059293.2,515.796407185629,2114063,19295293.0
1182,BTC,2023-02-19,1068646257,1112016981,375232,920448,1114960706,240406,807037298,11039,2.07360579710328,777409,315338776.286742,39156400059293.2,533.316770186336,2263326,19297243.0
1182,BTC,2023-02-20,1069074712,1112416478,399497,910033,1115360203,270081,807307379,13109,2.58544529687246,777556,286112666.594753,39156400059293.2,587.794520547945,2145953,19297243.0
1182,BTC,2023-02-21,1069571075,1112844381,427903,1015220,1115788106,290457,807597836,14529,2.8769067837157,777723,325143266.15697,39156400059293.2,517.234939759036,2044759,19298350.0
1182,BTC,2023-02-22,1069983082,1113279341,434960,942922,1116223066,282319,807880155,14249,2.88070268029282,777863,275658458.739678,39156400059293.2,610.086330935252,1894046,19299150.0
1182,BTC,2023-02-23,1070545733,1113743205,463864,1079195,1116686930,290728,808170883,13900,2.88951088955467,778034,334141649.403224,39156400059293.2,503.305882352941,2014352,19300218.0
1182,BTC,2023-02-24,1070951992,1114199038,455833,964183,1117142763,294562,808465445,13985,2.88697154930721,778169,262477274.18409,39156400059293.2,640.723880597015,1841840,19301062.0
1182,BTC,2023-02-25,1071271251,1114619634,420596,817375,1117563359,258413,808723858,10308,2.20568068470634,778276,229016907.000008,42835295924696.6,803.330188679245,1846932,19301731.0
1182,BTC,2023-02-26,1071725327,1115055927,436293,918618,1117999652,277103,809000961,10163,1.98730366489406,778444,361161821.835942,43053844193928.5,512.0,2082147,19302781.0
1182,BTC,2023-02-27,1072175990,1115478395,422468,971028,1118422120,292748,809293709,13154,2.60427544009185,778584,300400459.736338,43053844193928.5,615.561151079136,1633578,19303656.0
1182,BTC,2023-02-28,1072580048,1115967124,488729,985104,1118910849,332358,809626067,13903,2.52747756231705,778721,296020481.17333,43053844193928.5,624.669117647059,1856715,19304581.0
1182,BTC,2023-03-01,1073053616,1116533203,566079,1086910,1119476928,381932,810007999,15491,2.20846496839479,778891,365431553.022444,43053844193928.5,506.01775147929,2110520,19305656.0
1182,BTC,2023-03-02,1073422445,1117019596,486393,943944,1119963321,330047,810338046,14551,2.48116739027772,779035,307857729.355597,43053844193928.5,600.650349650349,2024497,19306481.0
1182,BTC,2023-03-03,1073892696,1117565082,545486,1089648,1120508807,355273,810693319,17123,2.67857717131096,779203,358233244.948092,43053844193928.5,516.185628742515,2004600,19308475.0
1182,BTC,2023-03-04,1074284127,1118027553,462471,907044,1120971278,306300,810999619,11631,1.87405473352553,779355,329239491.20107,43053844193928.5,561.64238410596,2145609,19309443.0
1182,BTC,2023-03-05,1074811463,1118457168,429615,995109,1121400893,286638,811286257,10943,2.03596650488599,779510,340103754.06808,43053844193928.5,543.701298701299,1933650,19309443.0
1182,BTC,2023-03-06,1075200518,1118901692,444524,928914,1121845417,316016,811602273,14359,2.43596437841391,779642,284007429.849815,43053844193928.5,651.091603053435,1809956,19311300.0
1182,BTC,2023-03-07,1075711696,1119429550,527858,1067377,1122373275,362082,811964355,14848,2.57920033101891,779807,354433461.769481,43053844193928.5,521.719512195122,2018768,19311300.0
1182,BTC,2023-03-08,1076090449,1119862861,433311,895631,1122806586,292493,812256848,13854,2.96772534047379,779940,287141620.202812,43053844193928.5,643.984848484849,1980563,19312137.0
1182,BTC,2023-03-09,1076463676,1120325006,462145,930069,1123268731,336854,812593702,14136,2.50610339921295,780075,289466130.915764,43053844193928.5,638.813432835821,1825581,19313825.0
1182,BTC,2023-03-10,1076853374,1120832176,507170,993874,1123775901,329334,812923036,15596,3.02562318929242,780211,290621643.310768,43127061549761.1,637.355555555556,1836066,19313825.0
1182,BTC,2023-03-11,1077290889,1121332087,499911,975440,1124275812,319707,813242743,17025,2.93889195108728,780376,357984065.26861,43551722213590.4,522.518292682927,2271631,19314856.0
1182,BTC,2023-03-12,1077725218,1121759506,427419,891560,1124703231,265555,813508298,12195,2.52032965307288,780537,358292317.998055,43551722213590.4,522.06875,2356654,19315875.0
1182,BTC,2023-03-13,1078152121,1122239218,479712,995257,1125182943,333107,813841405,18470,3.48353999446856,780694,341581733.226359,43551722213590.4,547.608974358974,2066050,19316850.0
1182,BTC,2023-03-14,1078581142,1122710856,471638,1028332,1125654581,327892,814169297,21002,3.56466967135508,780840,320701846.639209,43551722213590.4,583.262068965518,1813072,19317756.0
1182,BTC,2023-03-15,1079015607,1123208747,497891,1015004,1126152472,345059,814514356,18090,2.84979905446631,780987,321605455.897049,43551722213590.4,581.623287671233,1952574,19318681.0
1182,BTC,2023-03-16,1079350918,1123658952,450205,893376,1126602677,295049,814809405,16299,2.92752508916919,781121,289424696.123826,43551722213590.4,646.293233082707,1985878,19319512.0
1182,BTC,2023-03-17,1079819017,1124167059,508107,1074437,1127110784,338823,815148228,18950,3.39197637285916,781268,321015721.77318,43551722213590.4,582.691780821918,1900525,19320431.0
1182,BTC,2023-03-18,1080257793,1124635643,468584,972557,1127579368,296890,815445118,15029,2.6455266389321,781430,356722324.926707,43551722213590.4,524.36645962733,2262015,19321443.0
1182,BTC,2023-03-19,1080613625,1125046960,411317,849038,1127990685,269131,815714249,14205,3.29081299723848,781578,322554737.656475,43551722213590.4,579.911564625851,2320146,19323331.0
1182,BTC,2023-03-20,1081084046,1125528401,481441,1023019,1128472126,341288,816055537,18732,3.85048956262895,781732,332583503.463674,43551722213590.4,562.424836601307,2003264,19324237.0
1182,BTC,2023-03-21,1081529246,1125996994,468593,985637,1128940719,327932,816383469,20413,3.53405455651952,781877,313373014.091561,43551722213590.4,596.902777777777,1988930,19324237.0
1182,BTC,2023-03-22,1081901684,1126444059,447065,944070,1129387784,297575,816681044,17884,3.53043079648596,782036,350478015.908639,43551722213590.4,533.708860759493,2161154,19325231.0
1182,BTC,2023-03-23,1082265262,1126886825,442766,915894,1129830550,295245,816976289,17166,3.53816377440326,782219,400009485.072609,43767569956061.6,469.93956043956,2493021,19326387.0
1182,BTC,2023-03-24,1082596443,1127330752,443927,886593,1130274477,292095,817268384,15951,3.74259298615218,782381,377213849.079924,46843400286276.5,533.360248447205,2430091,19328412.0
1182,BTC,2023-03-25,1083010291,1127778956,448204,909390,1130722681,290197,817558581,13100,2.55553386728684,782526,339073834.086716,46843400286276.5,593.354166666667,2090348,19328412.0
1182,BTC,2023-03-26,1083371492,1128183188,404232,838165,1131126913,261243,817819824,11737,2.81878220405576,782670,338131945.720897,46843400286276.5,595.006993006993,2280120,19329193.0
1182,BTC,2023-03-27,1083886401,1128621638,438450,1055338,1131565363,296557,818116381,15218,3.77295048259724,782818,348052419.270359,46843400286276.5,578.047619047619,1882243,19330118.0
1182,BTC,2023-03-28,1084327730,1129067119,445481,977256,1132010844,316281,818432662,16227,3.62089832149339,782952,320371466.67359,46843400286276.5,627.992481203008,1815144,19330956.0
1182,BTC,2023-03-29,1084769216,1129555469,488350,992610,1132499194,334637,818767299,17353,3.34746642717431,783099,340772028.937994,46843400286276.5,590.397260273973,2014914,19331875.0
1182,BTC,2023-03-30,1085239705,1130043729,488260,1018397,1132987454,326347,819093646,15886,4.6397497835215,783254,366333569.747109,46843400286276.5,549.201298701299,2052353,19333718.0
1182,BTC,2023-03-31,1085681255,1130522185,478456,1044871,1133465910,308386,819402032,15458,3.49356077048744,783395,329238958.245015,46843400286276.5,611.078571428571,1793979,19334600.0
1182,BTC,2023-04-01,1086163516,1131006295,484110,1047870,1133950020,319646,819721678,13146,2.46407048283326,783535,324271880.480935,46843400286276.5,620.438848920863,1813156,19335531.0
1182,BTC,2023-04-02,1086683570,1131462715,456420,1015069,1134406440,341622,820063300,11641,2.20616008099634,783684,350448992.478441,46843400286276.5,574.094594594594,1876088,19335531.0
1182,BTC,2023-04-03,1087107372,1131912314,449599,975912,1134856039,332870,820396170,15528,3.19904492162802,783815,305268720.023686,46843400286276.5,659.061538461538,1737822,19337368.0
1182,BTC,2023-04-04,1087640818,1132471192,558878,1126607,1135414917,421130,820817300,18485,2.60850582243381,783977,378403645.218422,46843400286276.5,531.683229813664,1782377,19338231.0
1182,BTC,2023-04-05,1088032310,1132965676,494484,962257,1135909401,346885,821164185,16890,3.22129129037609,784116,322920019.682635,46843400286276.5,623.036231884058,1829118,19339231.0
1182,BTC,2023-04-06,1088482903,1133505037,539361,1038298,1136448762,354019,821518204,17071,2.91342493237795,784276,380287878.990305,47189345878587.6,532.955974842767,1957578,19339231.0
1182,BTC,2023-04-07,1088894697,1134020595,515558,974883,1136964320,355031,821873235,13216,2.17640337094358,784418,337964197.47896,47887764338536.2,608.574468085107,1880772,19340118.0
1182,BTC,2023-04-08,1089257253,1134476980,456385,873000,1137420705,318505,822191740,11225,1.83112805603818,784565,351110806.548202,47887764338536.2,585.787671232877,2217774,19341950.0
1182,BTC,2023-04-09,1089749784,1134861263,384283,936841,1137804988,278404,822470144,10449,2.12300071410436,784711,350085403.440888,47887764338536.2,587.503448275862,1984282,19341950.0
1182,BTC,2023-04-10,1090184260,1135277284,416021,948055,1138221009,289625,822759769,14567,3.27272637986683,784834,295982619.919711,47887764338536.2,694.893442622951,1622220,19342718.0
1182,BTC,2023-04-11,1090748119,1135808140,530856,1160423,1138751865,385002,823144771,22671,2.5019632910916,784988,365598048.214594,47887764338536.2,562.575163398693,1666888,19344681.0
1182,BTC,2023-04-12,1091253159,1136288316,480176,1046999,1139232041,338102,823482873,16893,3.49740531253592,785148,383612062.221238,47887764338536.2,536.157232704402,1937240,19344681.0
1182,BTC,2023-04-13,1091724783,1136766686,478370,1020560,1139710411,332042,823814915,16598,2.34570445907611,785290,343744752.879977,47887764338536.2,598.340425531915,1792668,19346443.0
1182,BTC,2023-04-14,1092162160,1137238878,472192,1016870,1140182603,315959,824130874,17425,3.2577210183101,785430,332113764.295056,47887764338536.2,619.294964028777,1777183,19346443.0
1182,BTC,2023-04-15,1092696146,1137666752,427874,1052383,1140610477,276185,824407059,13661,2.78117494315727,785588,377312892.066944,47887764338536.2,545.108280254777,1835977,19347431.0
1182,BTC,2023-04-16,1093068301,1138033853,367101,838013,1140977578,232268,824639327,11948,2.73241221316492,785712,300710761.585274,47887764338536.2,683.967479674796,1870822,19348206.0
1182,BTC,2023-04-17,1093530740,1138463636,429783,987873,1141407361,316193,824955520,16612,3.47953960750007,785867,380392746.030667,47887764338536.2,540.694805194805,1789871,19350212.0
1182,BTC,2023-04-18,1094157410,1138907814,444178,1149961,1141851539,312522,825268042,17242,2.55801047377676,786033,399856289.26588,47887764338536.2,514.375757575757,1774748,19350212.0
1182,BTC,2023-04-19,1094611953,1139347009,439195,994818,1142290734,301722,825569764,16628,2.6054926078505,786172,329334223.015112,47887764338536.2,624.521739130435,1789357,19351912.0
1182,BTC,2023-04-20,1095026178,1139782544,435535,953756,1142726269,296683,825866447,17548,2.65928515607278,786305,318142869.138489,48296984989381.5,652.015151515151,1683680,19351912.0
1182,BTC,2023-04-21,1095500824,1140302106,519562,1036355,1143245831,352218,826218665,16303,2.37996306375344,786450,354807558.75317,48712405953118.4,589.666666666666,1773189,19352818.0
1182,BTC,2023-04-22,1095942432,1140745618,443512,921038,1143689343,354752,826573417,11554,1.56044723369382,786599,364611796.320965,48712405953118.4,573.810810810811,1686116,19354675.0
1182,BTC,2023-04-23,1096338457,1141161460,415842,842549,1144105185,432760,827006177,10505,1.12677524578676,786746,354516559.617992,48712405953118.4,590.150684931507,1601784,19354675.0
1182,BTC,2023-04-24,1096826866,1141563942,402482,983636,1144507667,360173,827366350,14633,2.26371925246029,786887,345603014.288002,48712405953118.4,605.371428571429,1715576,19355550.0
1182,BTC,2023-04-25,1097211304,1141986822,422880,906982,1144930547,369843,827736193,15016,2.15678699037359,787012,303168705.307595,48712405953118.4,690.104838709678,1597077,19357150.0
1182,BTC,2023-04-26,1097547612,1142415862,429040,893665,1145359587,436461,828172654,17224,2.05570224462321,787142,316829800.688823,48712405953118.4,660.348837209302,1607471,19357150.0
1182,BTC,2023-04-27,1097893277,1142844341,428479,897822,1145788066,418912,828591566,17766,2.07455743978074,787272,320007903.480921,48712405953118.4,653.790697674418,1559151,19357968.0
1182,BTC,2023-04-28,1098267539,1143309028,464687,955033,1146252753,483522,829075088,16312,1.78588946820275,787419,361420983.125153,48712405953118.4,578.876712328767,1608638,19358875.0
1182,BTC,2023-04-29,1098575136,1143711506,402478,811292,1146655231,486031,829561119,12818,1.21296673331818,787556,339036924.694957,48712405953118.4,617.095588235294,1604319,19359731.0
1182,BTC,2023-04-30,1098871125,1144108373,396867,782782,1147052098,568516,830129635,12849,1.19071117417791,787704,358141859.006027,48712405953118.4,584.176870748299,1647023,19360643.0
1182,BTC,2023-05-01,1099261879,1144551806,443433,933809,1147495531,682281,830811916,14973,1.19726007374988,787886,441795397.264652,48712405953118.4,473.563535911602,1664010,19361793.0
1182,BTC,2023-05-02,1099541107,1144927575,375769,815626,1147871300,457708,831269624,14941,1.47073134860612,788015,314732140.621466,48712405953118.4,664.75,1644593,19362600.0
1182,BTC,2023-05-03,1099931338,1145390998,463423,964920,1148334723,489559,831759183,15064,1.94330793041719,788156,344667655.114456,48712405953118.4,607.014285714286,1597977,19363500.0
1182,BTC,2023-05-04,1100288472,1145820193,429195,904617,1148763918,491123,832250306,16238,1.70827616632277,788302,349862967.403592,48484851384225.5,595.206896551724,1596318,19364393.0
1182,BTC,2023-05-05,1100544399,1146214769,394576,831530,1149158494,411429,832661735,15480,1.99731981893974,788421,287382317.162399,48005534313578.8,717.449152542373,1604926,19366068.0
1182,BTC,2023-05-06,1100803271,1146601611,386842,767118,1149545336,601134,833262869,15140,1.45190278363229,788570,359909955.602599,48005534313578.8,572.871621621622,1666302,19366068.0
1182,BTC,2023-05-07,1100971777,1146910711,309100,567445,1149854436,607883,833870752,10078,1.67813429537857,788709,338104017.428888,48005534313578.8,609.81884057971,1684206,19366937.0
1182,BTC,2023-05-08,1101198360,1147243310,332599,691575,1150187035,575051,834445803,15258,1.39212121433071,788846,327044310.554239,48005534313578.8,630.441176470588,1703124,19368737.0
1182,BTC,2023-05-09,1101496236,1147594318,351008,761548,1150538043,598256,835044059,15680,1.24690936410789,788997,369855656.368979,48005534313578.8,557.466666666667,1660357,19368737.0
1182,BTC,2023-05-10,1101869916,1148029349,435031,899670,1150973074,671668,835715727,15806,1.26182821241298,789167,410706990.532251,48005534313578.8,502.01775147929,1681128,19369793.0
1182,BTC,2023-05-11,1102221158,1148403105,373756,832817,1151346830,546549,836262276,14045,1.56378948228404,789318,361034869.028332,48005534313578.8,571.086666666666,1737399,19370743.0
1182,BTC,2023-05-12,1102530903,1148779128,376023,809108,1151722853,509159,836771435,13917,1.88854034305865,789459,336678967.837731,48005534313578.8,612.4,1670210,19371625.0
1182,BTC,2023-05-13,1102814616,1149145226,366098,719504,1152088951,575640,837347075,11137,0.916823437630429,789604,347067505.039991,48005534313578.8,594.069444444444,1706875,19372537.0
1182,BTC,2023-05-14,1103215797,1149522019,376793,836690,1152465744,631677,837978752,10421,0.826059949147539,789778,413296107.796327,48005534313578.8,498.872832369942,1719132,19373625.0
1182,BTC,2023-05-15,1103570309,1149887240,365221,813853,1152830965,526379,838505131,13146,1.36512681443302,789925,355461365.349157,48005534313578.8,580.041095890411,1751037,19374537.0
1182,BTC,2023-05-16,1103901106,1150278107,390867,813434,1153221832,566462,839071593,15535,1.56072403863961,790078,366271964.674181,48005534313578.8,562.921052631579,1714052,19375493.0
1182,BTC,2023-05-17,1104248945,1150677834,399727,838435,1153621559,583454,839655047,14737,1.43423679483629,790238,382795270.778114,48005534313578.8,538.622641509434,1672989,19376493.0
1182,BTC,2023-05-18,1104571831,1151064383,386549,813710,1154008108,476704,840131751,15749,1.75147713144375,790379,353298064.335004,49188301954866.1,597.971428571428,1642504,19377375.0
1182,BTC,2023-05-19,1104947031,1151501729,437346,898269,1154445454,515474,840647225,13879,1.41928761945425,790529,374191227.94286,49549703178592.7,568.731543624161,1726897,19379131.0
1182,BTC,2023-05-20,1105241318,1151863519,361790,741142,1154807244,423736,841070961,10488,1.15304257749714,790660,334015865.506992,49549703178592.7,637.138461538462,1709835,19379131.0
1182,BTC,2023-05-21,1105602208,1152219350,355831,777170,1155163075,486625,841557586,9550,1.09391195753114,790811,372752521.652336,49549703178592.7,570.926666666667,1849795,19380075.0
1182,BTC,2023-05-22,1105966589,1152608872,389522,830833,1155552597,499281,842056867,12944,1.67688687982753,790955,353200398.308239,49549703178592.7,602.531468531469,1707516,19380968.0
1182,BTC,2023-05-23,1106344197,1153028035,419163,851408,1155971760,519870,842576737,13722,1.82389854884181,791109,383219126.071842,49549703178592.7,555.333333333333,1793346,19382818.0
1182,BTC,2023-05-24,1106733776,1153429119,401084,863939,1156372844,405521,842982258,14634,2.44555381483371,791250,350241687.787259,49549703178592.7,607.621428571429,1793709,19382818.0
1182,BTC,2023-05-25,1107147591,1153887783,458664,934639,1156831508,460167,843442425,14696,1.84529344527902,791401,375656391.750526,49549703178592.7,566.513333333333,1717907,19383768.0
1182,BTC,2023-05-26,1107577274,1154370907,483124,962531,1157314632,532373,843974798,14506,1.35416068498062,791554,375927179.145844,49549703178592.7,566.105263157895,1670583,19385625.0
1182,BTC,2023-05-27,1107995102,1154832349,461442,887381,1157776074,471633,844446431,11813,1.14905423803057,791699,358663285.157509,49549703178592.7,593.354166666667,1794709,19385625.0
1182,BTC,2023-05-28,1108411367,1155275321,442972,874230,1158219046,496158,844942589,11593,1.27102091208754,791859,393052334.141313,49549703178592.7,541.440251572327,1696633,19387637.0
1182,BTC,2023-05-29,1108833499,1155719618,444297,905417,1158663343,550324,845492913,15753,1.60011423410556,792021,402418414.940143,49549703178592.7,528.83850931677,1724601,19388600.0
1182,BTC,2023-05-30,1109278506,1156192623,473005,956160,1159136348,515246,846008159,17178,1.96508515416067,792175,381110963.362284,49549703178592.7,558.40522875817,1698502,19388600.0
1182,BTC,2023-05-31,1109683612,1156664840,472217,934567,1159608565,421579,846429738,16993,3.29916993591284,792316,356208219.593806,49896188532214.4,601.621428571429,1680761,19389481.0
1182,BTC,2023-06-01,1110067112,1157089449,424609,920709,1160033174,355986,846785724,15467,3.09073415727849,792448,340920407.905359,51234338863442.9,645.458015267175,1599280,19391331.0
1182,BTC,2023-06-02,1110484996,1157542089,452640,982299,1160485814,479437,847265161,16935,2.61988783750238,792612,420464199.536481,51234338863442.9,523.349693251534,1638168,19392143.0
1182,BTC,2023-06-03,1110872850,1157959098,417009,866525,1160902823,381453,847646614,12467,2.14934798416211,792742,334410384.293294,51234338863442.9,658.023255813953,1687837,19392143.0
1182,BTC,2023-06-04,1111315094,1158356021,396923,895565,1161299746,364020,848010634,11688,2.64426238340316,792890,387625189.311544,51234338863442.9,567.687074829932,1796594,19393068.0
1182,BTC,2023-06-05,1111678944,1158734015,377994,884878,1161677740,359254,848369888,15437,4.27659448552929,793028,352594432.158382,51234338863442.9,624.087591240876,1597624,19394875.0
1182,BTC,2023-06-06,1112047164,1159234607,500592,1030676,1162178332,462072,848831960,20767,2.92948872445011,793179,390353029.608084,51234338863442.9,563.72,1692034,19394875.0
1182,BTC,2023-06-07,1112446272,1159679075,444468,1002967,1162622800,433781,849265741,18993,2.35311572386677,793314,346539206.242754,51234338863442.9,634.992537313433,1621679,19395718.0
1182,BTC,2023-06-08,1112868689,1160104031,424956,974592,1163047756,407006,849672747,19606,2.60287703734154,793468,394123676.099836,51234338863442.9,558.326797385621,1693495,19397737.0
1182,BTC,2023-06-09,1113344864,1160525890,421859,1025999,1163469615,387084,850059831,16757,2.89080701476966,793637,432651827.527472,51234338863442.9,508.607142857143,1630917,19397737.0
1182,BTC,2023-06-10,1113775437,1160943934,418044,943821,1163887659,365369,850425200,13597,2.8235391545171,793791,390933929.089912,51234338863442.9,562.882352941177,1897741,19398700.0
1182,BTC,2023-06-11,1114209099,1161314629,370695,885081,1164258354,399201,850824401,11206,2.56885804326845,793954,414797002.54603,51234338863442.9,530.5,1998654,19399718.0
1182,BTC,2023-06-12,1114699229,1161707055,392426,978234,1164650780,370634,851195035,14657,3.15055181770698,794111,400272505.412768,51234338863442.9,549.75,1696170,19400700.0
1182,BTC,2023-06-13,1115135732,1162155409,448354,939394,1165099134,410483,851605518,15462,2.44084641318542,794258,382873189.905944,51234338863442.9,574.732876712329,1798182,19402381.0
1182,BTC,2023-06-14,1115477131,1162557270,401861,835411,1165500995,330658,851936176,15150,2.90348997072691,794379,311769487.249613,51935360722908.9,715.466666666667,1615091,19403300.0
1182,BTC,2023-06-15,1115885470,1163007274,450004,913181,1165950999,423069,852359245,16875,2.20210915868416,794527,387651984.854969,52350439455487.5,580.013605442177,1773660,19403300.0
1182,BTC,2023-06-16,1116291535,1163512232,504958,962059,1166455957,512202,852871447,16480,1.93823158312021,794680,405224162.720297,52350439455487.5,554.861842105263,1654360,19404262.0
1182,BTC,2023-06-17,1116684355,1163947142,434910,860690,1166890867,475252,853346699,11967,1.42487211056707,794820,368048849.799378,52350439455487.5,610.906474820144,1713229,19406075.0
1182,BTC,2023-06-18,1117167755,1164415266,468124,897404,1167358991,439868,853786567,11360,1.7174804694938,794971,391476852.642794,52350439455487.5,574.346666666667,1984185,19406962.0
1182,BTC,2023-06-19,1117619684,1164817437,402171,909634,1167761162,415604,854202171,13719,2.30472496052942,795113,371002703.042048,52350439455487.5,606.042553191489,1766902,19406962.0
1182,BTC,2023-06-20,1118079894,1165328849,511412,959473,1168272574,447715,854649886,16628,2.36974229509965,795249,356345457.648934,52350439455487.5,630.97037037037,1681460,19407812.0
1182,BTC,2023-06-21,1118456063,1165775592,446743,915404,1168719317,363280,855013166,22483,3.35569196934725,795370,314136815.078654,52350439455487.5,715.75,1608081,19409425.0
1182,BTC,2023-06-22,1118957289,1166256822,481230,1008212,1169200547,392041,855405207,18076,2.99812006533225,795507,368729119.177455,52350439455487.5,609.779411764706,1640141,19409425.0
1182,BTC,2023-06-23,1119374652,1166721290,464468,951874,1169665015,374001,855779208,17772,2.83249565487247,795632,326589098.486287,52350439455487.5,688.459677419354,1664020,19410212.0
1182,BTC,2023-06-24,1119924515,1167193835,472545,1013179,1170137560,361437,856140645,13610,2.0184202311272,795778,380552306.870695,52350439455487.5,590.834482758621,1781937,19411118.0
1182,BTC,2023-06-25,1120448887,1167661158,467323,951595,1170604883,382769,856523414,11706,2.02776658693706,795931,401162075.049207,52350439455487.5,560.480263157895,1868063,19412987.0
1182,BTC,2023-06-26,1120970081,1168132719,471561,1010313,1171076444,403979,856927393,15596,2.57976205667356,796077,377402549.972441,52350439455487.5,595.765517241379,1723111,19412987.0
1182,BTC,2023-06-27,1121441324,1168616878,484159,963926,1171560603,434858,857362251,16190,2.27659041733479,796217,365436620.903897,52350439455487.5,615.273381294964,1717011,19413868.0
1182,BTC,2023-06-28,1121790511,1169028350,411472,836792,1171972075,331278,857693529,15146,2.81287386698839,796325,278978350.765134,52255759843019.2,804.495327102804,1680819,19414537.0
1182,BTC,2023-06-29,1122271921,1169521430,493080,982837,1172465155,438193,858131722,16346,2.60464116481055,796471,368447532.757895,50646206431058.1,590.379310344827,1676636,19415450.0
1182,BTC,2023-06-30,1122768638,1170015829,494399,1062608,1172959554,445197,858576919,17916,2.57796124212223,796629,399705488.526514,50646206431058.1,544.210191082803,1656886,19416437.0
1182,BTC,2023-07-01,1123203357,1170410949,395120,926042,1173354674,324274,858901193,13762,2.34562977340185,796762,338092027.717892,50646206431058.1,643.386363636364,1656755,19417268.0
1182,BTC,2023-07-02,1123784464,1170750618,339669,1010690,1173694343,309920,859211113,11664,1.90356033317343,796933,432508521.139851,50646206431058.1,502.935294117647,1816713,19418337.0
1182,BTC,2023-07-03,1124221114,1171164332,413714,961193,1174108057,328114,859539227,15589,2.83147079529389,797070,347090726.947026,50646206431058.1,626.705882352941,1780203,19419193.0
1182,BTC,2023-07-04,1124697575,1171569541,405209,963114,1174513266,375807,859915034,14973,2.30256605767378,797211,376343405.631561,50646206431058.1,577.992857142857,1727264,19420075.0
1182,BTC,2023-07-05,1125158022,1172056224,486683,969986,1174999949,496227,860411261,16182,1.72424026179045,797367,397109547.778882,50646206431058.1,547.767741935484,1691748,19421056.0
1182,BTC,2023-07-06,1125607568,1172532795,476571,974988,1175476520,392688,860803949,19482,2.36551370845475,797506,351469235.197225,50646206431058.1,618.898550724638,1652073,19421925.0
1182,BTC,2023-07-07,1126128197,1173067249,534454,1033152,1176010974,556014,861359963,16640,1.66272312993081,797681,440270115.043825,50646206431058.1,494.068965517241,1799449,19423025.0
1182,BTC,2023-07-08,1126686412,1173562658,495409,1006754,1176506383,573697,861933660,12237,1.23429360597885,797859,451908643.993417,50646206431058.1,481.344632768361,1751515,19424137.0
1182,BTC,2023-07-09,1127250525,1174115291,552633,980068,1177059016,594265,862527925,13193,1.21451833477189,798028,426253583.19854,50646206431058.1,510.315476190476,1763557,19425181.0
1182,BTC,2023-07-10,1127694992,1174576801,461510,930844,1177520526,507115,863035040,16828,1.80190812232389,798182,389448979.534064,50646206431058.1,558.542483660131,1663702,19426143.0
1182,BTC,2023-07-11,1128148333,1175042462,465661,931508,1177986187,432293,863467333,15539,1.88753967240316,798317,345935618.017935,50646206431058.1,628.798507462687,1714983,19426987.0
1182,BTC,2023-07-12,1128608660,1175566293,523831,953165,1178510018,478320,863945653,16064,1.89099139526946,798461,381633144.263719,53503052179805.0,602.132867132867,1703309,19427887.0
1182,BTC,2023-07-13,1128964355,1176013164,446871,873562,1178956889,375859,864321512,17820,2.47518662311803,798581,319245281.734385,53911173001054.6,725.294117647059,1601404,19428637.0
1182,BTC,2023-07-14,1129422829,1176524599,511435,1002400,1179468324,421666,864743178,19223,2.24432643653697,798719,374569322.051368,53911173001054.6,618.167883211679,1602543,19429506.0
1182,BTC,2023-07-15,1129888602,1177053843,529244,916326,1179997568,484980,865228158,12979,1.40374493710155,798857,369796709.277101,53911173001054.6,626.14598540146,1683448,19430362.0
1182,BTC,2023-07-16,1130396038,1177599723,545880,925365,1180543448,595145,865823303,11829,1.15383086093594,799012,419853946.061383,53911173001054.6,551.493506493506,1731302,19431331.0
1182,BTC,2023-07-17,1130860024,1178085487,485764,951557,1181029212,428612,866251915,14660,2.01939490398836,799148,373226127.605593,53911173001054.6,620.392592592593,1615517,19432187.0
1182,BTC,2023-07-18,1131380124,1178634726,549239,1017135,1181578451,582684,866834599,19278,1.90443716447294,799310,434517830.075447,53911173001054.6,532.88198757764,1725549,19433193.0
1182,BTC,2023-07-19,1131850693,1179157171,522445,961963,1182100896,480249,867314848,16407,1.86309040078318,799458,402233116.655364,53911173001054.6,575.65306122449,1738754,19434118.0
1182,BTC,2023-07-20,1132247321,1179609654,452483,904255,1182553379,400400,867715248,19151,2.15810706771946,799586,352269895.491249,53911173001054.6,657.299212598425,1575706,19434918.0
1182,BTC,2023-07-21,1132598115,1180033984,424330,856403,1182977709,323847,868039095,15228,2.29834207155885,799698,298547857.067297,53911173001054.6,775.576576576577,1583604,19435618.0
1182,BTC,2023-07-22,1133081911,1180399089,365105,925679,1183342814,288750,868327845,11644,1.8241499537599,799832,369514577.644787,53911173001054.6,626.624060150375,1668878,19436456.0
1182,BTC,2023-07-23,1133566328,1180910112,511023,895779,1183853837,559624,868887469,10792,0.956912779000722,799979,395232560.614084,53911173001054.6,585.849315068493,1730404,19437375.0
1182,BTC,2023-07-24,1134047491,1181401581,491469,942591,1184345306,529923,869417392,14431,1.4206666937656,800129,402727561.538873,53911173001054.6,574.946308724832,1700942,19438312.0
1182,BTC,2023-07-25,1134499776,1181916978,515397,941826,1184860703,462586,869879978,15442,1.49573276790569,800267,376650732.183283,53911173001054.6,614.751824817519,1683894,19439175.0
1182,BTC,2023-07-26,1135026709,1182430727,513749,1017946,1185374452,452746,870332724,16850,1.54834223166429,800411,387857861.21665,53251647610383.4,589.685314685315,1682859,19440075.0
1182,BTC,2023-07-27,1135461506,1182910327,479600,943039,1185854052,413038,870745762,14287,1.79069118647769,800549,362796386.10263,52328312063443.8,619.48905109489,1653487,19440937.0
1182,BTC,2023-07-28,1135909456,1183399071,488744,944840,1186342796,449225,871194987,13604,1.75105998219091,800689,378387205.417387,52328312063443.8,593.964028776978,1629710,19441812.0
1182,BTC,2023-07-29,1136326394,1183888857,489786,883630,1186832582,423119,871618106,10771,1.26835039622494,800821,358480932.116473,52328312063443.8,626.946564885496,1616703,19442637.0
1182,BTC,2023-07-30,1136899145,1184496893,608036,1013491,1187440618,645854,872263960,11658,0.968990019781839,800989,439630109.372308,52328312063443.8,511.221556886228,1721756,19443681.0
1182,BTC,2023-07-31,1137326097,1184951097,454204,916255,1187894822,445666,872709626,14707,1.79055203928013,801130,379945111.399429,52328312063443.8,591.528571428571,1678803,19444568.0
1182,BTC,2023-08-01,1137779382,1185432340,481243,988380,1188376065,412219,873121845,17964,1.83783423297956,801269,361479209.770254,52328312063443.8,621.746376811594,1650291,19445437.0
1182,BTC,2023-08-02,1138337820,1185889246,456906,1076907,1188832971,390768,873512613,17579,1.76362505011613,801423,404333041.472258,52328312063443.8,555.849673202614,1570630,19446412.0
1182,BTC,2023-08-03,1138834009,1186360234,470988,1035109,1189303959,476007,873988620,16556,1.45089358666539,801574,393678426.152066,52328312063443.8,570.893333333333,1690188,19448100.0
1182,BTC,2023-08-04,1139214294,1186768946,408712,915811,1189712671,318486,874307106,13960,2.07379074122743,801695,319892380.126497,52328312063443.8,702.575000000001,1594248,19448100.0
1182,BTC,2023-08-05,1139715314,1187280846,511900,993100,1190224571,500723,874807829,16256,1.16093310343134,801849,404832864.516225,52328312063443.8,555.163398692811,1692858,19449062.0
1182,BTC,2023-08-06,1140273003,1187870885,590039,980117,1190814610,607275,875415104,11836,0.832804959119806,802013,444446987.621404,52328312063443.8,505.680981595092,1709818,19450093.0
1182,BTC,2023-08-07,1140715248,1188329238,458353,952715,1191272963,427534,875842638,15573,2.09205342460305,802159,379072879.762114,52328312063443.8,592.889655172414,1700017,19451000.0
1182,BTC,2023-08-08,1141085318,1188720174,390936,876004,1191663899,331194,876173832,17345,2.7139040433054,802284,331424225.001835,52328312063443.8,678.129032258064,1562834,19451787.0
1182,BTC,2023-08-09,1141626017,1189226618,506444,1051782,1192170343,506746,876680578,18584,1.72305424021806,802446,424038624.184071,52358969387622.2,530.329192546584,1655576,19452793.0
1182,BTC,2023-08-10,1142014305,1189713642,487024,953741,1192657367,358039,877038617,16078,2.6284075742818,802573,334520894.824049,52391178981379.4,672.65873015873,1558921,19453587.0
1182,BTC,2023-08-11,1142475226,1190209253,495611,967467,1193152978,506538,877545155,14117,1.61611803028489,802724,394889206.642792,52391178981379.4,569.826666666667,1640799,19454537.0
1182,BTC,2023-08-12,1142946967,1190706232,496979,929964,1193649957,503934,878049089,13216,1.45988227667889,802891,432587372.652158,52391178981379.4,520.168674698795,1594641,19455575.0
1182,BTC,2023-08-13,1143414683,1191176816,470584,867958,1194120541,497112,878546201,10986,1.25466997638331,803026,356424762.620466,52391178981379.4,631.320895522388,1700896,19456425.0
1182,BTC,2023-08-14,1143935090,1191685028,508212,1004609,1194628753,568517,879114718,15558,1.50994951357351,803197,443077871.721367,52391178981379.4,507.852941176471,1712082,19457487.0
1182,BTC,2023-08-15,1144496962,1192247809,562781,1069685,1195191534,583063,879697781,16417,1.37664527472671,803368,446960659.637368,52391178981379.4,503.441176470588,1655428,19458556.0
1182,BTC,2023-08-16,1144961569,1192688221,440412,956823,1195631946,566878,880264659,14775,1.60834455451455,803531,433308935.923935,52391178981379.4,519.302469135803,1685414,19459581.0
1182,BTC,2023-08-17,1145480666,1193219086,530865,1053728,1196162811,502274,880766933,18124,2.42692090056411,803687,404714049.248722,52391178981379.4,555.993548387097,1644293,19460550.0
1182,BTC,2023-08-18,1145898215,1193750328,531242,1020222,1196694053,423207,881190140,18362,2.38048631352303,803826,364376611.923108,52391178981379.4,617.54347826087,1630965,19461418.0
1182,BTC,2023-08-19,1146329553,1194172282,421954,887935,1197116007,519780,881709920,14225,1.27739578383982,803966,367811160.377519,52391178981379.4,611.776978417266,1698904,19462300.0
1182,BTC,2023-08-20,1146847249,1194679340,507058,932504,1197623065,612461,882322381,10577,0.985869161270236,804128,423867584.557728,52391178981379.4,530.869565217392,1721834,19463306.0
1182,BTC,2023-08-21,1147315534,1195200933,521593,1009275,1198144658,550074,882872455,13469,1.85077991349019,804293,429319516.189731,52391178981379.4,524.128048780488,1633983,19464337.0
1182,BTC,2023-08-22,1147769508,1195612387,411454,930845,1198556112,420857,883293312,15153,2.50090718979563,804436,379648339.326349,53588410123873.5,606.246478873239,1728887,19465231.0
1182,BTC,2023-08-23,1148215870,1196049291,436904,934855,1198993016,417822,883711134,13038,2.54685324590943,804578,391881843.526245,55621444139429.6,609.602836879433,1687615,19466118.0
1182,BTC,2023-08-24,1148703122,1196490214,440923,950085,1199433939,399151,884110285,13018,2.15511759782533,804717,388767970.469575,55621444139429.6,614.485507246377,1570589,19466987.0
1182,BTC,2023-08-25,1149123957,1196962857,472643,921331,1199906582,425192,884535477,14439,1.83952777102895,804852,383656918.83445,55621444139429.6,622.671641791045,1627875,19467837.0
1182,BTC,2023-08-26,1149570257,1197510375,547518,921637,1200454100,497513,885032990,11747,1.16294966969645,804989,376544053.414684,55621444139429.6,634.433823529412,1663669,19468687.0
1182,BTC,2023-08-27,1149986201,1197943480,433105,804867,1200887205,413594,885446584,9266,1.90373268382827,805105,338591197.793157,55621444139429.6,705.547826086957,1694263,19469418.0
1182,BTC,2023-08-28,1150382094,1198370137,426657,878193,1201313862,331345,885777929,12762,2.73619690191468,805223,326351768.037965,55621444139429.6,732.008547008547,1583304,19470150.0
1182,BTC,2023-08-29,1150915467,1198907209,537072,1051269,1201850934,500301,886278230,16487,1.9914941417599,805381,450280191.068097,55621444139429.6,530.541401273885,1658418,19471143.0
1182,BTC,2023-08-30,1151278066,1199342976,435767,880620,1202286701,408001,886686231,15801,2.44294644963689,805507,346968946.852257,55621444139429.6,688.512,1623768,19471925.0
1182,BTC,2023-08-31,1151696044,1199812488,469512,996890,1202756213,437435,887123666,15122,1.87400918822476,805651,396978601.175136,55621444139429.6,601.776223776224,1648730,19472825.0
1182,BTC,2023-09-01,1152155196,1200315726,503238,1030029,1203259451,419548,887543214,15436,2.21230737552554,805802,416091994.081179,55621444139429.6,574.133333333333,1688032,19473768.0
1182,BTC,2023-09-02,1152622700,1200865085,549359,969824,1203808810,539748,888082962,11401,1.1244535207804,805954,423722114.970767,55621444139429.6,563.794701986755,1706112,19474718.0
1182,BTC,2023-09-03,1153052992,1201373121,508036,872819,1204316846,625257,888708219,10129,0.776474541237747,806112,439001445.719168,55621444139429.6,544.171974522293,1683306,19475706.0
1182,BTC,2023-09-04,1153465443,1201889252,516131,925489,1204832977,573196,889281415,13322,1.12908825009915,806261,418608090.872721,55621444139429.6,570.682432432432,1629390,19476643.0
1182,BTC,2023-09-05,1153878098,1202422618,533366,939569,1205366343,462093,889743508,13505,1.53805172889769,806385,342891577.879692,55621444139429.6,696.69918699187,1541140,19477412.0
1182,BTC,2023-09-06,1154394544,1202952124,529506,1009477,1205895849,485357,890228865,17277,1.43647192045606,806520,372054851.331599,54302721812289.6,626.865671641791,1545213,19478256.0
1182,BTC,2023-09-07,1154919248,1203514401,562277,999440,1206458126,537939,890766804,15550,1.29467957563177,806666,393570614.80826,54150142369480.0,590.931034482758,1653818,19479225.0
1182,BTC,2023-09-08,1155393255,1203968573,454172,986362,1206912298,414799,891181603,14373,1.553765000479,806799,356566330.840289,54150142369480.0,652.257575757576,1614360,19479993.0
1182,BTC,2023-09-09,1156023172,1204687588,719015,1111523,1207631313,597409,891779012,10021,0.923822587045023,806950,411876783.737888,54150142369480.0,564.666666666666,1696613,19480943.0
1182,BTC,2023-09-10,1156604326,1205349351,661763,1054485,1208293076,558395,892337407,9660,1.14184559614991,807097,398246264.152053,54150142369480.0,583.993150684931,1658724,19481862.0
1182,BTC,2023-09-11,1157246568,1205846297,496946,1115222,1208790022,459132,892796539,15146,1.60249975427224,807256,433214438.383509,54150142369480.0,536.854430379747,1538914,19482856.0
1182,BTC,2023-09-12,1157795813,1206406277,559980,1045471,1209350002,462328,893258867,15665,1.77185050395909,807397,379569521.31091,54150142369480.0,612.728571428572,1613062,19483850.0
1182,BTC,2023-09-13,1158359332,1206987450,581173,1049807,1209931175,512446,893771313,14605,1.31645842857903,807544,396854575.86775,54150142369480.0,586.041095890411,1672407,19484656.0
1182,BTC,2023-09-14,1158984322,1207637547,650097,1124087,1210581272,576215,894347528,14185,1.33005073908545,807706,444896482.803293,54150142369480.0,522.757763975155,1684738,19485668.0
1182,BTC,2023-09-15,1159672688,1208407963,770416,1240740,1211351688,703692,895051220,15907,1.2258229763822,807894,508377280.073099,54150142369480.0,457.48128342246,1699829,19486925.0
1182,BTC,2023-09-16,1160235798,1209076124,668161,1058662,1212019849,593144,895644364,11867,1.0898759916483,808049,420571105.844245,54150142369480.0,552.993506493506,1684559,19487812.0
1182,BTC,2023-09-17,1160817054,1209747442,671318,1043496,1212691167,611220,896255584,10682,0.947797303886309,808198,407322849.553254,54150142369480.0,570.97972972973,1722460,19488743.0
1182,BTC,2023-09-18,1161460960,1210386294,638852,1125339,1213330019,635845,896891429,14856,1.2374082849608,808354,423754896.383595,54150142369480.0,548.838709677419,1743559,19489718.0
1182,BTC,2023-09-19,1161993072,1210897808,511514,1027880,1213841533,493887,897385316,16000,1.73663354538457,808493,386052983.155466,55816608966185.9,620.978260869565,1671012,19490587.0
1182,BTC,2023-09-20,1162537713,1211478002,580194,1064416,1214421727,551783,897937099,17440,1.69426966358552,808639,415990048.118356,57119871304635.3,589.744827586206,1656908,19491500.0
1182,BTC,2023-09-21,1163120268,1212012519,534517,1083042,1214956244,431540,898368639,14534,1.6544008469135,808777,394061895.758097,57119871304635.3,622.56204379562,1641259,19492362.0
1182,BTC,2023-09-22,1163595789,1212531957,519438,983637,1215475682,441679,898810318,14240,1.45137140542297,808906,368256653.277249,57119871304635.3,666.1875,1631603,19493168.0
1182,BTC,2023-09-23,1164210014,1213206531,674574,1090031,1216150256,629617,899439935,10181,0.754778204989827,809062,447995249.491003,57119871304635.3,547.612903225806,1666335,19494206.0
1182,BTC,2023-09-24,1164812134,1213704298,497767,1057446,1216648023,441181,899881116,9367,1.09761932294718,809208,418067847.225754,57119871304635.3,586.813793103448,1679160,19495056.0
1182,BTC,2023-09-25,1165391827,1214113980,409682,1105224,1217057705,285750,900166866,13172,2.86082477384423,809353,411197711.703,57119871304635.3,596.618055555555,1731199,19495975.0
1182,BTC,2023-09-26,1165901936,1214509052,395072,1027121,1217452777,309789,900476655,14444,2.1409715196485,809489,390723387.200858,57119871304635.3,627.881481481482,1722585,19496812.0
1182,BTC,2023-09-27,1166487070,1214902415,393363,1079190,1217846140,337265,900813920,14063,2.25839791820731,809646,457340464.568264,57119871304635.3,536.423076923077,1696628,19497793.0
1182,BTC,2023-09-28,1166982741,1215303561,401146,1037665,1218247286,378975,901192895,14613,2.14045956110511,809792,421495769.760948,57119871304635.3,582.041379310345,1717577,19498706.0
1182,BTC,2023-09-29,1167468816,1215755832,452271,1055075,1218699557,330269,901523164,14597,2.69417475418946,809939,425972348.979605,57119871304635.3,575.924657534246,1713152,19499625.0
1182,BTC,2023-09-30,1167986387,1216157316,401484,1018477,1219101041,275474,901798638,12103,2.37256470110747,810077,395415630.196871,57119871304635.3,620.430656934307,1738484,19500487.0
1182,BTC,2023-10-01,1168438035,1216556636,399320,932326,1219500361,320516,902119154,11503,1.73212728599549,810218,406754190.465534,57119871304635.3,603.135714285714,1766710,19501375.0
1182,BTC,2023-10-02,1168925061,1216991617,434981,1032203,1219935342,344263,902463417,16560,3.21389362150295,810375,445215443.70123,57119871304635.3,551.032051282051,1795309,19502350.0
1182,BTC,2023-10-03,1169497858,1217418230,426613,1086734,1220361955,310664,902774081,15801,2.70188076789535,810539,468344853.339165,57252656596460.0,525.036809815951,1868119,19503381.0
1182,BTC,2023-10-04,1169884596,1217823908,405678,887242,1220767633,287430,903061511,15449,3.41732455474418,810670,372049897.892071,57321508229258.0,661.723076923077,1738857,19504200.0
1182,BTC,2023-10-05,1170308063,1218268152,444244,953504,1221211877,319310,903380821,19046,3.36820992305979,810811,400967431.925176,57321508229258.0,614.0,1518329,19505081.0
1182,BTC,2023-10-06,1170691366,1218696416,428264,920042,1221640141,298650,903679471,16365,3.55085045569145,810971,456292141.289994,57321508229258.0,539.553459119496,1454646,19507143.0
1182,BTC,2023-10-07,1171067525,1219081417,385001,866698,1222025142,244567,903924038,14196,3.30781966762854,811142,488582808.530619,57321508229258.0,503.894117647059,1586042,19507143.0
1182,BTC,2023-10-08,1171415147,1219452333,370916,788615,1222396058,242440,904166478,10464,2.61249840999489,811290,422702482.809518,57321508229258.0,582.428571428572,1845773,19508068.0
1182,BTC,2023-10-09,1171926115,1219838874,386541,958607,1222782599,283648,904450126,12637,2.6420850266818,811446,453056827.852009,57321508229258.0,543.406451612903,1811959,19509050.0
1182,BTC,2023-10-10,1172345803,1220238232,399358,908967,1223181957,285060,904735186,13596,2.91952158299863,811608,459834041.178336,57321508229258.0,535.39751552795,1771297,19510056.0
1182,BTC,2023-10-11,1172701268,1220617794,379562,866739,1223561519,264600,904999786,15557,3.31018860450117,811768,455957304.537195,57321508229258.0,539.949685534591,1471176,19511056.0
1182,BTC,2023-10-12,1173090685,1221013334,395540,899971,1223957059,267090,905266876,14618,2.84833716777543,811933,477204748.018976,57321508229258.0,515.908536585366,1375921,19512087.0
1182,BTC,2023-10-13,1173482767,1221429725,416391,919317,1224373450,279518,905546394,14465,2.32166020688886,812071,395156445.886966,57321508229258.0,623.029197080292,1520630,19512950.0
1182,BTC,2023-10-14,1173839106,1221829720,399995,830652,1224773445,265220,905811614,14581,2.72963597343914,812217,418348905.606385,57321508229258.0,588.489655172414,1765662,19513881.0
1182,BTC,2023-10-15,1174169435,1222202695,372975,779037,1225146420,251923,906063537,10614,2.06969779450669,812384,476841814.243363,57321508229258.0,516.301204819277,1880928,19514906.0
1182,BTC,2023-10-16,1174686693,1222616059,413364,1025139,1225559784,299782,906363319,16282,3.27181533182036,812525,417779723.756815,59373391582489.0,610.385714285715,1676824,19515793.0
1182,BTC,2023-10-17,1175101261,1223024450,408391,923336,1225968175,294257,906657576,17115,2.96073779955345,812687,491030299.146218,61030681983175.6,533.826086956521,1692141,19516800.0
1182,BTC,2023-10-18,1175535009,1223411619,387169,923760,1226355344,271345,906928921,16978,3.03853912642533,812832,453236257.688133,61030681983175.6,578.340277777778,1608191,19517706.0
1182,BTC,2023-10-19,1175936613,1223825601,413982,911129,1226769326,282007,907210928,16742,3.06310345469357,812972,440386110.60221,61030681983175.6,595.215827338129,1707656,19518581.0
1182,BTC,2023-10-20,1176316728,1224263859,438258,960129,1227207584,295888,907506816,18250,3.45986767839534,813106,410268857.448096,61030681983175.6,638.90977443609,1526025,19519418.0
1182,BTC,2023-10-21,1176695235,1224680239,416380,889257,1227623964,270621,907777437,13411,2.34922709866041,813256,460187728.345101,61030681983175.6,569.604026845638,1506811,19520362.0
1182,BTC,2023-10-22,1177046226,1225065486,385247,810757,1228009211,252457,908029894,12266,2.51901701373945,813409,461968868.6071,61030681983175.6,567.407894736842,1652683,19521325.0
1182,BTC,2023-10-23,1177581809,1225485846,420360,1052873,1228429571,301780,908331674,18731,3.78903617134694,813566,477625927.70539,61030681983175.6,548.807692307692,1915865,19522293.0
1182,BTC,2023-10-24,1178005500,1225975922,490076,1030593,1228919647,373854,908705528,23398,3.87616188980532,813692,386468801.116858,61030681983175.6,678.256,1576735,19523087.0
1182,BTC,2023-10-25,1178540318,1226530044,554122,1085437,1229473769,476549,909182077,20405,2.19003212507096,813836,436289867.815342,61030681983175.6,600.804195804196,1595374,19523981.0
1182,BTC,2023-10-26,1179079796,1227056440,526396,1084798,1230000165,431256,909613333,17808,2.15693802501901,813986,460920891.856791,61030681983175.6,568.697986577181,1664096,19524918.0
1182,BTC,2023-10-27,1179594214,1227598754,542314,1060419,1230542479,452816,910066149,16562,1.91367121064768,814140,470750191.62216,61030681983175.6,556.823529411765,1656251,19525881.0
1182,BTC,2023-10-28,1180122460,1228195256,596502,1028701,1231138981,564383,910630532,13243,1.10576954077929,814300,487032901.245459,61030681983175.6,538.207547169812,1669111,19526881.0
1182,BTC,2023-10-29,1180563704,1228664027,468771,906239,1231607752,410290,911040822,12231,1.54042929357954,814437,414928191.61929,61030681983175.6,631.735294117647,1657909,19527737.0
1182,BTC,2023-10-30,1181159865,1229206331,542304,1105712,1232150056,463202,911504024,17251,2.09710171595282,814593,482035529.529552,62224673386139.9,554.425806451613,1692527,19528712.0
1182,BTC,2023-10-31,1181679828,1229734971,528640,1054273,1232678696,433751,911937775,18504,1.83124770715726,814748,482656333.28075,62463471666732.7,555.837662337662,1679830,19529681.0
1182,BTC,2023-11-01,1182156117,1230264817,529846,1042925,1233208542,463644,912401419,19358,1.81391429393146,814897,473735912.859336,62463471666732.7,566.304054054054,1594948,19530681.0
1182,BTC,2023-11-02,1182620005,1230789327,524510,1078718,1233733052,403541,912804960,19971,2.0842969780546,815041,453082272.087481,62463471666732.7,592.118881118881,1628937,19531518.0
1182,BTC,2023-11-03,1182983136,1231306266,516939,991167,1234249991,452354,913257314,17571,1.8674865128781,815177,420104240.531224,62463471666732.7,638.6,1598543,19532368.0
1182,BTC,2023-11-04,1183521299,1232013217,706951,1121107,1234956942,698917,913956231,13694,0.888419775219389,815345,519335112.920528,62463471666732.7,516.580838323353,1686741,19533412.0
1182,BTC,2023-11-05,1184145737,1232678445,665228,1132351,1235622170,673375,914629606,12806,0.814254422920884,815508,514132090.621708,62463471666732.7,521.808641975309,1724448,19534437.0
1182,BTC,2023-11-06,1184627335,1233158953,480508,1000768,1236102678,439319,915068925,15400,1.77366483567599,815635,394246621.434415,62463471666732.7,680.484126984127,1675654,19535225.0
1182,BTC,2023-11-07,1185024259,1233621686,462733,962942,1236565411,450371,915519296,17847,1.7632345399915,815768,422349887.01358,62463471666732.7,635.204545454546,1593190,19536056.0
1182,BTC,2023-11-08,1185462736,1234190669,568983,1006491,1237134394,583201,916102497,20814,1.47477875955016,815917,468680761.411281,62463471666732.7,572.412162162162,1653791,19536987.0
1182,BTC,2023-11-09,1185907921,1234760330,569661,1000533,1237704055,573466,916675963,22566,1.9176165640446,816060,441815675.922993,62463471666732.7,607.218309859155,1663591,19537881.0
1182,BTC,2023-11-10,1186429250,1235320268,559938,1126341,1238263993,523831,917199794,20007,1.60788072981725,816214,479421387.16021,62463471666732.7,559.588235294118,1621323,19538843.0
1182,BTC,2023-11-11,1186979237,1235979945,659677,1072884,1238923670,627529,917827323,16412,1.10263634352436,816374,501284371.548113,62463471666732.7,535.182389937107,1661074,19539843.0
1182,BTC,2023-11-12,1187519070,1236666577,686632,1015437,1239610302,703327,918530650,12432,0.875141842418633,816535,509408079.331606,63233946844737.5,533.14375,1738508,19540850.0
1182,BTC,2023-11-13,1187998588,1237103701,437124,962078,1240047426,428507,918959157,15304,1.83756632648715,816656,391032039.368179,64678587803496.6,710.408333333334,1671679,19541606.0
1182,BTC,2023-11-14,1188438011,1237602188,498487,959901,1240545913,523422,919482579,16535,1.79745926707223,816794,445409407.955446,64678587803496.6,623.678832116788,1643354,19542468.0
1182,BTC,2023-11-15,1188868663,1238129521,527333,970942,1241073246,561942,920044521,17661,1.47779561023631,816942,485726179.622223,64678587803496.6,571.911564625851,1620298,19543400.0
1182,BTC,2023-11-16,1189298118,1238703728,574207,938169,1241647453,628426,920672947,16645,1.38534146072518,817090,475013501.076226,64678587803496.6,584.809523809524,1681076,19544318.0
1182,BTC,2023-11-17,1189766665,1239187008,483280,1018940,1242130733,536644,921209591,17128,1.4032479651951,817240,488990271.079022,64678587803496.6,568.093959731544,1621066,19545262.0
1182,BTC,2023-11-18,1190187234,1239719246,532238,867084,1242662971,629266,921838857,10823,0.777249647195208,817389,478495357.025993,64678587803496.6,580.554054054054,1687164,19546187.0
1182,BTC,2023-11-19,1190706278,1240319307,600061,960190,1243263032,710579,922549436,10389,0.79248784368788,817559,555578263.844268,64678587803496.6,500.005917159763,1721115,19547250.0
1182,BTC,2023-11-20,1191295513,1240891721,572414,1070654,1243835446,640670,923190106,17931,1.46043027999674,817725,537372786.480428,64678587803496.6,516.945454545455,1717741,19548287.0
1182,BTC,2023-11-21,1191797398,1241425489,533768,1004116,1244369214,522593,923712699,16821,1.83931165012344,817877,495243808.362435,64678587803496.6,560.920529801325,1811776,19549237.0
1182,BTC,2023-11-22,1192247816,1241964507,539018,983283,1244908232,535829,924248528,16910,1.72857079435057,818019,457103375.355239,64678587803496.6,607.723404255319,1673500,19550118.0
1182,BTC,2023-11-23,1192737588,1242511617,547110,966211,1245455342,587706,924836234,15741,1.2231600516089,818166,478675462.092701,64678587803496.6,580.335616438356,1670689,19551043.0
1182,BTC,2023-11-24,1193352640,1243105116,593499,1135376,1246048841,623898,925460132,18345,1.43278373256332,818334,540647430.097423,64678587803496.6,513.814371257485,1751372,19552093.0
1182,BTC,2023-11-25,1193940639,1243761384,656268,1030991,1246705109,617234,926077366,13567,1.04411907705405,818493,515699709.318085,64678587803496.6,538.67088607595,1828529,19553087.0
1182,BTC,2023-11-26,1194514156,1244394449,633065,978981,1247338174,578484,926655850,12114,1.16415714161878,818639,496642970.756219,67912869716769.1,587.310344827587,1826353,19554000.0
1182,BTC,2023-11-27,1195034906,1244938877,544428,972020,1247882602,479487,927135337,15720,1.77577219006492,818769,455428149.147771,67957790298897.9,640.883720930232,1780404,19554812.0
1182,BTC,2023-11-28,1195526614,1245409316,470439,994152,1248353041,447662,927582999,16978,1.8279523574042,818916,514232910.726087,67957790298897.9,567.595890410959,1717509,19555693.0
1182,BTC,2023-11-29,1195929703,1245814371,405055,927484,1248758096,360588,927943587,17672,2.43368681126438,819052,467789651.605618,67957790298897.9,623.948148148148,1589347,19556593.0
1182,BTC,2023-11-30,1196366342,1246264177,449806,967326,1249207902,411882,928355469,18721,2.167196090722,819186,450306503.53233,67957790298897.9,648.172932330827,1753480,19557443.0
1182,BTC,2023-12-01,1196883273,1246809216,545039,1117312,1249752941,496468,928851937,18377,2.08383976162317,819355,569660654.168177,67957790298897.9,512.369047619047,1870515,19558475.0
1182,BTC,2023-12-02,1197218869,1247258357,449141,865744,1250202082,429362,929281299,14900,1.75196843557341,819482,430758495.854997,67957790298897.9,677.587301587301,1682123,19559262.0
1182,BTC,2023-12-03,1197679563,1247818559,560202,922008,1250762284,707876,929989175,13566,1.03958893771453,819647,575547906.577205,67957790298897.9,507.128048780488,1721296,19561275.0
1182,BTC,2023-12-04,1198165137,1248309111,490552,1040544,1251252836,570395,930559570,20308,1.93488966136067,819802,526211413.880796,67957790298897.9,554.675324675325,1679885,19561275.0
1182,BTC,2023-12-05,1198522930,1248732796,423685,865483,1251676521,514962,931074532,20430,1.90505602862145,819940,476405298.116165,67957790298897.9,612.664233576643,1603854,19562131.0
1182,BTC,2023-12-06,1198839499,1249111345,378549,866120,1252055070,467795,931542327,23270,2.17142381488885,820076,464935996.739776,67957790298897.9,627.777777777777,1517801,19562981.0
1182,BTC,2023-12-07,1199240332,1249510939,399594,907921,1252454664,372050,931914377,18142,2.37497167590945,820191,393848770.181454,67957790298897.9,741.087719298246,1651154,19563700.0
1182,BTC,2023-12-08,1199651125,1249937530,426591,936564,1252881255,411456,932325833,18610,2.40306821424745,820326,455239532.984773,67957790298897.9,641.149253731343,1780275,19564537.0
1182,BTC,2023-12-09,1200101671,1250466329,528799,955551,1253410054,587398,932913231,14843,1.05573790495436,820483,534001805.474358,67957790298897.9,546.583333333333,1725131,19565525.0
1182,BTC,2023-12-10,1200516696,1250940221,473892,864229,1253883946,536175,933449406,12722,1.01166526790563,820623,468449558.119222,67436283581404.7,618.287769784173,1763149,19566400.0
1182,BTC,2023-12-11,1201089982,1251453875,513654,1071567,1254397600,525486,933974892,18253,1.88254298374731,820781,532913402.712176,67305906902031.4,542.445859872611,1787631,19567393.0
1182,BTC,2023-12-12,1201484077,1251910354,456479,900468,1254854079,543162,934518054,18427,1.71787047874065,820925,483665976.306617,67305906902031.4,597.678321678321,1623659,19568287.0
1182,BTC,2023-12-13,1201761162,1252309336,398982,764902,1255253061,587920,935105974,18168,1.4340933722656,821074,499787939.766517,67305906902031.4,578.398648648648,1540925,19569218.0
1182,BTC,2023-12-14,1201988452,1252654469,345133,701811,1255598194,570985,935676959,18651,1.45805609631372,821220,505141264.668381,67305906902031.4,572.268965517242,1507396,19570131.0
1182,BTC,2023-12-15,1202347615,1253116954,462485,882952,1256060679,632636,936309595,20173,1.20561321594754,821383,549014881.45745,67305906902031.4,526.537037037037,1637462,19571150.0
1182,BTC,2023-12-16,1202649641,1253537805,420851,743285,1256481530,638144,936947739,13541,0.881656601169532,821535,513687284.669005,67305906902031.4,562.748344370861,1669096,19572100.0
1182,BTC,2023-12-17,1202946776,1253906182,368377,707359,1256849907,616808,937564547,11868,0.712136489833238,821685,500551117.685125,67305906902031.4,577.51677852349,1664704,19573037.0
1182,BTC,2023-12-18,1203400861,1254380610,474428,934037,1257324335,640936,938205483,18924,1.18811768115692,821853,562130923.59453,67305906902031.4,514.251497005988,1665772,19574087.0
1182,BTC,2023-12-19,1203774849,1254833207,452597,828993,1257776932,662880,938868363,17084,1.1153437130566,822015,548151411.024747,67305906902031.4,527.366459627329,1693282,19575106.0
1182,BTC,2023-12-20,1204121208,1255264184,430977,790695,1258207909,582506,939450869,18400,1.40502688865117,822160,485282415.648885,67305906902031.4,595.6875,1663966,19576006.0
1182,BTC,2023-12-21,1204466502,1255726915,462731,818059,1258670640,588137,940039006,17307,1.25803847080576,822306,497095858.742886,67305906902031.4,581.531034482759,1702804,19576931.0
1182,BTC,2023-12-22,1204949189,1256224764,497849,1019741,1259168489,625531,940664537,21623,1.34591291520516,822474,561398778.006072,67305906902031.4,514.922155688623,1701326,19577975.0
1182,BTC,2023-12-23,1205403335,1256696395,471631,908560,1259640120,608479,941273016,13149,0.747807788604504,822634,564469543.736078,70449192118839.6,536.037735849057,1769881,19578968.0
1182,BTC,2023-12-24,1205908130,1257253406,557011,914956,1260197131,723459,941996475,11410,0.768548546485482,822805,611293253.031106,72006146478567.1,505.917647058823,1791090,19580037.0
1182,BTC,2023-12-25,1206247691,1257639368,385962,707047,1260583093,535741,942532216,11149,0.902105494668207,822944,499905568.559469,72006146478567.1,618.644927536232,1843725,19580906.0
1182,BTC,2023-12-26,1206597453,1258024906,385538,746048,1260968631,553693,943085909,13252,1.43112271426182,823083,498702229.572997,72006146478567.1,620.13768115942,1765703,19581775.0
1182,BTC,2023-12-27,1206955277,1258471116,446210,775268,1261414841,545556,943631465,13551,1.4110481989565,823212,462494131.019993,72006146478567.1,668.6875,1675622,19583337.0
1182,BTC,2023-12-28,1207341298,1258842121,371005,848674,1261785846,417180,944048645,14734,1.67744752269447,823333,431195293.299078,72006146478567.1,717.225,1699395,19583337.0
1182,BTC,2023-12-29,1207774587,1259308555,466434,922051,1262252280,581449,944630094,14617,1.40010888621669,823484,552882505.636907,72006146478567.1,559.366666666666,1681139,19584281.0
1182,BTC,2023-12-30,1208138776,1259718686,410131,807966,1262662411,533823,945163917,12125,1.16717342501215,823629,527416830.929748,72006146478567.1,586.375,1625426,19585187.0
1182,BTC,2023-12-31,1208566008,1260239163,520477,793703,1263182888,731351,945895268,10324,0.788347639775744,823785,563388691.974459,72006146478567.1,548.935483870968,1699324,19586162.0
1182,BTC,2024-01-01,1209011515,1260677996,438833,845486,1263621721,657752,946553020,10881,0.807423086515252,823940,570570524.396329,72006146478567.1,542.025974025974,1653640,19587131.0
1182,BTC,2024-01-02,1209430552,1261015016,337020,876861,1263958741,367319,946920339,16266,2.31202332894016,824071,474197086.133422,72006146478567.1,652.184615384615,1718455,19587950.0
1182,BTC,2024-01-03,1209905026,1261459768,444752,958234,1264403493,502749,947423088,16505,1.70935418069526,824229,569760909.481685,72006146478567.1,542.796178343949,1771465,19588925.0
1182,BTC,2024-01-04,1210418281,1261903449,443681,1025456,1264847174,482557,947905645,23909,2.18515318663534,824399,610166283.078719,72006146478567.1,506.852071005917,1782401,19590862.0
1182,BTC,2024-01-05,1210757361,1262353015,449566,868879,1265296740,420884,948326529,21811,1.86775676641706,824537,495105801.397484,72006146478567.1,624.642335766423,1774551,19590862.0
1182,BTC,2024-01-06,1211129456,1262733871,380856,815325,1265677596,382140,948708669,12529,1.47317089033828,824677,516762943.478951,73146570446682.0,607.942446043165,1847959,19591737.0
1182,BTC,2024-01-07,1211444647,1263061133,327262,726494,1266004858,348688,949057357,12117,1.64662732934979,824795,427590633.576697,73197634206448.3,735.239316239316,1776827,19592475.0
1182,BTC,2024-01-08,1211796454,1263458576,397443,809278,1266402301,414359,949471716,17243,2.04586810153893,824918,450075527.441087,73197634206448.3,698.508196721311,1650238,19593243.0
1182,BTC,2024-01-09,1212240152,1263864629,406053,935495,1266808354,468088,949939804,20396,2.43849276854115,825070,558923378.202501,73197634206448.3,562.476821192053,1754116,19594193.0
1182,BTC,2024-01-10,1212618496,1264253504,388875,856843,1267197229,383774,950323578,19983,3.42514632872451,825203,495502695.499548,73197634206448.3,634.469696969697,1792414,19595031.0
1182,BTC,2024-01-11,1213037304,1264680966,427462,968663,1267624691,449075,950772653,20082,2.56507869233026,825376,630905032.792013,73197634206448.3,498.302325581395,1576814,19596106.0
1182,BTC,2024-01-12,1213519347,1265053946,372980,998633,1267997671,375872,951148525,18624,3.85568681053494,825544,618372746.843239,73197634206448.3,508.40119760479,1649432,19598150.0
1182,BTC,2024-01-13,1213923998,1265587324,533378,848148,1268531049,652483,951801008,13297,1.08874004739198,825703,581942315.943579,73197634206448.3,540.227848101266,1733099,19598150.0
1182,BTC,2024-01-14,1214299719,1266042797,455473,711613,1268986522,591806,952392814,11354,0.854828645863087,825831,467533707.145142,73197634206448.3,672.425196850394,1743322,19599662.0
1182,BTC,2024-01-15,1214688297,1266412626,369829,799151,1269356351,408499,952801313,15746,1.73136902323071,825945,418513539.558964,73197634206448.3,751.185840707965,1730983,19599662.0
1182,BTC,2024-01-16,1215082298,1266802947,390321,777712,1269746672,470122,953271435,15445,1.96023282374603,826070,461346278.507403,73197634206448.3,681.443548387097,1705319,19601200.0
1182,BTC,2024-01-17,1215496852,1267267852,464905,843100,1270211577,449415,953720850,21194,2.69710771223043,826191,443634297.694583,73197634206448.3,708.65,1718500,19601200.0
1182,BTC,2024-01-18,1215994156,1267759973,492121,936785,1270703698,484017,954204867,21008,2.34647683191549,826333,518963470.001388,73197634206448.3,605.787234042554,1747136,19602087.0
1182,BTC,2024-01-19,1216399196,1268210704,450731,854201,1271154429,460763,954665630,17146,2.04843352222429,826465,496814916.317144,73197634206448.3,632.793893129771,1668630,19602925.0
1182,BTC,2024-01-20,1216896866,1268766247,555543,911943,1271709972,563331,955228961,13885,0.944256744841186,826608,511653685.926964,72219650984228.1,606.232394366197,1692320,19603812.0
1182,BTC,2024-01-21,1217406397,1269339435,573188,878379,1272283160,600202,955829163,12427,0.949065149793536,826748,501266601.366623,70343519904866.8,602.719424460432,1691078,19604681.0
1182,BTC,2024-01-22,1217953418,1269762205,422770,983112,1272705930,457620,956286783,15935,2.40636270126004,826908,562672191.520036,70343519904866.8,536.943396226415,1701846,19605681.0
1182,BTC,2024-01-23,1218373663,1270158219,396014,869624,1273101944,368462,956655245,16817,2.64702841689127,827062,536406579.332405,70343519904866.8,563.235294117647,1537962,19606643.0
1182,BTC,2024-01-24,1218816713,1270519081,360862,893063,1273462806,372499,957027744,15843,2.97937429019509,827212,521457053.378536,70343519904866.8,579.382550335571,1758379,19607581.0
1182,BTC,2024-01-25,1219442622,1270889534,370453,1102828,1273833259,340188,957367932,15749,2.97290619772708,827393,635840439.924317,70343519904866.8,475.155555555556,1671776,19608712.0
1182,BTC,2024-01-26,1219874554,1271357319,467785,908781,1274301044,493218,957861150,16121,2.16610232644616,827545,536258589.65366,70343519904866.8,563.390728476821,1631785,19609662.0
1182,BTC,2024-01-27,1220437505,1271890239,532920,979299,1274833964,597446,958458596,12501,1.07931846198697,827716,600916450.855586,70343519904866.8,502.770588235294,1740003,19610737.0
1182,BTC,2024-01-28,1220919822,1272439562,549323,899984,1275383287,636523,959095119,11298,0.71224988066681,827876,557273995.415732,70343519904866.8,542.14465408805,1777822,19611731.0
1182,BTC,2024-01-29,1221467016,1272938304,498742,963016,1275882029,575203,959670322,15834,1.59035632044934,828032,578343891.132922,70343519904866.8,522.393548387097,1720092,19612712.0
1182,BTC,2024-01-30,1221933646,1273419466,481162,916025,1276363191,523509,960193831,17724,2.16207388070125,828176,502519433.773009,70343519904866.8,601.216783216783,1692841,19613681.0
1182,BTC,2024-01-31,1222369886,1273832392,412926,876782,1276776117,444450,960638281,15836,3.06999560141024,828307,470692631.760611,70343519904866.8,641.869230769231,1678990,19614425.0
1182,BTC,2024-02-01,1222812231,1274273417,441025,948860,1277217142,413272,961051553,18704,2.37092626626624,828460,539975000.076347,70343519904866.8,559.513157894737,1710286,19615393.0
1182,BTC,2024-02-02,1223219432,1274717785,444368,932784,1277661510,429732,961481285,16653,1.99029475250807,828648,685525458.960861,72346611061723.1,453.267379679144,1702339,19616556.0
1182,BTC,2024-02-03,1223639763,1275198039,480254,818423,1278141764,515539,961996824,11289,1.15995606153461,828799,582147300.250968,75502165623893.7,557.04,1690524,19617500.0
1182,BTC,2024-02-04,1223983051,1275539201,341162,807380,1278482926,336211,962333035,11182,1.61728030680269,828954,592529955.129828,75502165623893.7,547.279220779221,1582979,19618475.0
1182,BTC,2024-02-05,1224343437,1275853721,314520,854077,1278797446,281482,962614517,15452,3.01412679608007,829110,583656105.34881,75502165623893.7,555.6,1413415,19619443.0
1182,BTC,2024-02-06,1224711928,1276161888,308167,861174,1279105613,278093,962892610,15565,3.35115984651671,829280,640538665.353024,75502165623893.7,506.260355029586,1384202,19620506.0
1182,BTC,2024-02-07,1225170907,1276592723,430835,909344,1279536448,427538,963320148,15557,1.97707815699575,829440,606022729.301316,75502165623893.7,535.094339622642,1574571,19621506.0
1182,BTC,2024-02-08,1225510839,1276916050,323327,817557,1279859775,285101,963605249,16788,3.36851807314141,829578,531790001.341335,75502165623893.7,609.788321167883,1523349,19622368.0
1182,BTC,2024-02-09,1225970116,1277290497,374447,963041,1280234222,334084,963939333,19438,3.12748529692383,829744,626329655.402759,75502165623893.7,517.745454545454,1593128,19623406.0
1182,BTC,2024-02-10,1226443714,1277714553,424056,962140,1280658278,399252,964338585,14422,1.57500706381008,829896,570349075.18551,75502165623893.7,568.562913907285,1620540,19624356.0
1182,BTC,2024-02-11,1226840652,1278074276,359723,856030,1281018001,329938,964668523,13814,1.93149119365417,830033,525881368.063683,75502165623893.7,616.639705882353,1799000,19625225.0
1182,BTC,2024-02-12,1227322560,1278485016,410740,1009686,1281428741,409911,965078434,19257,2.37132900224871,830212,670800603.370873,75502165623893.7,483.421348314607,1871392,19626331.0
1182,BTC,2024-02-13,1227712539,1278839097,354081,862962,1281782822,313178,965391612,20077,3.42874002211429,830347,507538666.904095,75502165623893.7,638.925373134329,1708664,19627175.0
1182,BTC,2024-02-14,1228023592,1279183248,344151,799661,1282126973,296717,965688329,24373,4.14942825651395,830486,523086203.950722,75502165623893.7,619.934782608696,2264783,19628050.0
1182,BTC,2024-02-15,1228416236,1279555426,372178,886946,1282499151,303306,965991635,24170,3.22209187754809,830643,606019397.147557,77563331090796.8,549.705128205128,2080268,19629025.0
1182,BTC,2024-02-16,1228758039,1279926016,370590,858413,1282869741,312782,966304417,21666,2.99196261886883,830777,546759848.785655,81725299822043.2,641.977443609022,1807967,19629862.0
1182,BTC,2024-02-17,1229153250,1280304301,378285,850975,1283248026,327713,966632130,16967,1.70813949637298,830927,608671702.167344,81725299822043.2,576.677852348993,1848949,19630800.0
1182,BTC,2024-02-18,1229507314,1280674776,370475,759402,1283618501,343417,966975547,15213,1.67691854744101,831048,490427995.237599,81725299822043.2,715.716666666667,1848168,19631556.0
1182,BTC,2024-02-19,1229930162,1281081925,407149,877518,1284025650,366108,967341655,17662,2.26490994248058,831184,552258765.894929,81725299822043.2,635.585185185186,1692326,19632406.0
1182,BTC,2024-02-20,1230340596,1281504754,422829,879965,1284448479,397096,967738751,20726,2.51626822298495,831325,572612691.814234,81725299822043.2,612.992857142858,1687660,19633287.0
1182,BTC,2024-02-21,1230689149,1281915350,410596,828959,1284859075,369949,968108700,22660,2.7754425785358,831463,568302186.662626,81725299822043.2,617.642335766423,1993191,19634150.0
1182,BTC,2024-02-22,1231033790,1282318751,403401,860531,1285262476,365090,968473790,21265,2.50774502885332,831598,558225968.559152,81725299822043.2,628.791044776119,1812799,19634993.0
1182,BTC,2024-02-23,1231479016,1282755917,437166,953945,1285699642,409204,968882994,19128,1.95592253168454,831757,643945745.885611,81725299822043.2,545.088607594936,1717863,19635993.0
1182,BTC,2024-02-24,1231870297,1283140362,384445,822973,1286084087,340419,969223413,13814,1.56838080040447,831894,553671680.706572,81725299822043.2,633.963235294118,1637703,19636843.0
1182,BTC,2024-02-25,1232315347,1283541448,401086,908205,1286485173,418801,969642214,14518,1.29078371467494,832058,668281132.392012,81725299822043.2,525.239263803681,1847371,19637875.0
1182,BTC,2024-02-26,1232686592,1283922329,380881,884329,1286866054,356184,969998398,20267,2.72755149540341,832191,539006382.955724,81725299822043.2,651.212121212121,1732764,19638706.0
1182,BTC,2024-02-27,1233042986,1284333398,411069,923179,1287277123,387598,970385996,22820,3.21630769965578,832320,529810130.880265,81725299822043.2,662.515625,1664895,19639512.0
1182,BTC,2024-02-28,1233438664,1284806324,472926,1046938,1287750049,413800,970799796,29816,3.72520529244623,832469,603883853.748766,81725299822043.2,581.25,1806319,19640418.0
1182,BTC,2024-02-29,1233809493,1285292739,486415,1005567,1288236464,407090,971206886,29396,3.33531661933361,832602,541507294.962473,81725299822043.2,648.204545454546,1678043,19641268.0
1182,BTC,2024-03-01,1234248776,1285765863,473124,1065754,1288709588,419284,971626170,26138,2.8255037679506,832756,606435887.803417,79428308380841.5,562.535947712418,1715404,19642231.0
1182,BTC,2024-03-02,1234577705,1286151195,385332,845759,1289094920,339311,971965481,17655,1.76044558579094,832883,512057632.119483,79351228131136.8,665.571428571429,1713607,19643025.0
1182,BTC,2024-03-03,1234940733,1286557482,406287,866349,1289501207,385447,972350928,16678,1.65274405825732,833038,613564059.070888,79351228131136.8,555.461038961039,1934863,19643993.0
1182,BTC,2024-03-04,1235287576,1286961338,403856,900297,1289905063,361258,972712186,25300,3.37517785374522,833167,514947754.284902,79351228131136.8,661.8359375,1740203,19644806.0
1182,BTC,2024-03-05,1235829305,1287435968,474630,1174926,1290379693,424347,973136533,31540,3.95264305452005,833334,659354735.074891,79351228131136.8,516.885542168675,1725852,19645843.0
1182,BTC,2024-03-06,1236210989,1287864229,428261,934042,1290807954,381934,973518467,26839,3.72143219693434,833474,552400000.363497,79351228131136.8,616.964028776978,1795174,19646718.0
1182,BTC,2024-03-07,1236689829,1288329927,465698,1045624,1291273652,436344,973954811,26264,2.85308100271538,833654,710179816.53298,79351228131136.8,479.893854748603,1900112,19647850.0
1182,BTC,2024-03-08,1237081250,1288788588,458661,965916,1291732313,426928,974381739,23685,2.81593972762168,833808,607640620.962339,79351228131136.8,560.875816993464,1745010,19648887.0
1182,BTC,2024-03-09,1237469327,1289189637,401049,940966,1292133362,359029,974740768,19188,1.89093689343488,833971,650525150.989115,79351228131136.8,523.901234567901,1614488,19649843.0
1182,BTC,2024-03-10,1237847584,1289590933,401296,873972,1292534658,368196,975108964,19242,1.96739520339599,834114,562204807.336518,79351228131136.8,606.204225352113,1715487,19650718.0
1182,BTC,2024-03-11,1238414267,1290008798,417865,1139020,1292952523,394098,975503062,26319,3.44564453068833,834284,678027112.148524,79351228131136.8,502.650887573964,1734871,19651787.0
1182,BTC,2024-03-12,1238896194,1290419443,410645,1039921,1293363168,341867,975844929,24527,4.0450218168593,834425,554924637.260048,79351228131136.8,614.157142857143,1712962,19652750.0
1182,BTC,2024-03-13,1239449251,1290868952,449509,1101923,1293812677,390118,976235047,26861,4.17055434761431,834585,632081018.833166,79351228131136.8,539.188679245283,1788118,19653675.0
1182,BTC,2024-03-14,1239867078,1291263753,394801,1003406,1294207478,329706,976564753,29439,3.87147821239107,834726,578467626.869138,82709090260024.4,614.092857142857,1677289,19654537.0
1182,BTC,2024-03-15,1240170367,1291638601,374848,969668,1294582326,307904,976872657,25742,3.74910288602366,834853,527731268.535236,83947913181361.5,683.214285714285,1635719,19655337.0
1182,BTC,2024-03-16,1240584636,1292010524,371923,930729,1294954249,355760,977228417,20347,1.7793633065793,834997,604920118.50386,83947913181361.5,596.034965034965,1734020,19656237.0
1182,BTC,2024-03-17,1240971062,1292378962,368438,873076,1295322687,366109,977594526,18738,1.87200319491627,835143,609114103.970666,83947913181361.5,591.931034482759,1761533,19657150.0
1182,BTC,2024-03-18,1241335969,1292792968,414006,907957,1295736693,416270,978010796,20609,2.31076290872102,835287,607350003.067892,83947913181361.5,593.65034965035,1773374,19658050.0
1182,BTC,2024-03-19,1241771588,1293244516,451548,998366,1296188241,463952,978474748,26720,2.37468702300335,835444,657698228.511432,83947913181361.5,548.205128205128,1742939,19659031.0
1182,BTC,2024-03-20,1242200952,1293625884,381368,952120,1296569609,361515,978836263,24440,3.06746460855823,835593,620336012.936916,83947913181361.5,581.222972972973,1808886,19660043.0
1182,BTC,2024-03-21,1242511387,1293983001,357117,822816,1296926726,327642,979163905,24947,2.65913024149227,835713,499120219.863034,83947913181361.5,722.378151260505,1849836,19660712.0
1182,BTC,2024-03-22,1242879406,1294367650,384649,902989,1297311375,339533,979503438,19874,2.59418130709536,835848,569185521.073795,83947913181361.5,633.455223880597,1748697,19661556.0
1182,BTC,2024-03-23,1243286664,1294723235,355585,927156,1297666960,326610,979830048,16339,2.19439622590796,836004,670045308.018802,83947913181361.5,538.103225806452,1786932,19662531.0
1182,BTC,2024-03-24,1243728287,1295072896,349661,913291,1298016621,331527,980161575,14489,1.54989435625313,836174,714888819.665112,83947913181361.5,504.349112426036,1735729,19663593.0
1182,BTC,2024-03-25,1244105147,1295420640,347744,917928,1298364365,317064,980478639,22225,3.94344585214234,836306,552375379.616677,83947913181361.5,652.732824427481,1913881,19664418.0
1182,BTC,2024-03-26,1244437502,1295784095,363455,883192,1298727820,317742,980796381,21091,3.65630516183558,836440,562446440.183741,83947913181361.5,641.045112781955,2015178,19665337.0
1182,BTC,2024-03-27,1244772935,1296162723,378628,866771,1299106448,355902,981152283,21003,2.77185327223559,836576,564888276.56746,83947913181361.5,638.274074074074,1840430,19666106.0
1182,BTC,2024-03-28,1245177776,1296582300,419577,947479,1299526025,428670,981580953,22952,2.27166555917076,836728,631886869.517622,83467245353210.3,567.331125827815,1659517,19667056.0
1182,BTC,2024-03-29,1245509530,1296967050,384750,852562,1299910775,449421,982030374,19965,2.0538250059351,836872,600124198.9748,83126997340024.6,594.923076923077,1690707,19667993.0
1182,BTC,2024-03-30,1245883990,1297354167,387117,833495,1300297892,490072,982520446,15520,1.06346444659238,837027,646204045.230922,83126997340024.6,552.5,1800900,19668981.0
1182,BTC,2024-03-31,1246129958,1297670486,316319,699725,1300614211,319675,982840121,14243,1.4282798532341,837164,570774326.538751,83126997340024.6,625.514705882353,2292706,19669812.0
1182,BTC,2024-04-01,1246561393,1298026761,356275,960059,1300970486,326410,983166531,21463,3.87166516354401,837314,621280379.719972,83126997340024.6,574.664429530201,2049854,19670737.0
1182,BTC,2024-04-02,1246967284,1298404580,377819,961310,1301348305,357709,983524240,20564,3.046877711562,837462,619730029.916545,83126997340024.6,576.102040816326,1800677,19671681.0
1182,BTC,2024-04-03,1247315498,1298812877,408297,969593,1301756602,372978,983897218,20960,2.43980373422813,837604,595919676.992305,83126997340024.6,599.120567375886,1759155,19672556.0
1182,BTC,2024-04-04,1247767280,1299195436,382559,976616,1302139161,320607,984217825,22789,2.69706967750785,837742,570877680.831485,83126997340024.6,625.401459854015,1724585,19673400.0
1182,BTC,2024-04-05,1248179107,1299574699,379263,959099,1302518424,348637,984566462,21816,2.76082882021117,837890,633601065.318683,83126997340024.6,563.489795918367,1781674,19674375.0
1182,BTC,2024-04-06,1248582105,1299983736,409037,920369,1302927461,433591,985000053,17046,1.38142148771121,838045,645634936.454592,83126997340024.6,552.987012987013,1722604,19675312.0
1182,BTC,2024-04-07,1248967467,1300388973,405237,840435,1303332698,526130,985526183,16708,1.05476412514837,838215,710306397.162013,83126997340024.6,502.639053254438,1884625,19676393.0
1182,BTC,2024-04-08,1249314883,1300783649,394676,897904,1303727374,455617,985981800,21593,2.15678121586008,838373,650165337.340145,83126997340024.6,549.133757961783,1937859,19677362.0
1182,BTC,2024-04-09,1249676565,1301175418,391769,902503,1304119143,453811,986435611,19425,1.8444705211583,838519,605528125.641124,83126997340024.6,589.613793103448,1803056,19678312.0
1182,BTC,2024-04-10,1249956878,1301568505,393087,852125,1304512230,531054,986966665,18042,1.45706822193009,838670,623020061.65701,83450993523979.6,575.293333333334,1719400,19679231.0
1182,BTC,2024-04-11,1250189151,1301920816,352311,749867,1304864541,476241,987442906,19277,1.70971734219905,838802,572809152.419013,86388558925171.0,647.748091603053,1725664,19680056.0
1182,BTC,2024-04-12,1250478190,1302306235,385419,831521,1305249960,448489,987891395,19671,1.78086088697593,838938,586498036.061637,86388558925171.0,632.62962962963,1772481,19680925.0
1182,BTC,2024-04-13,1250823237,1302694665,388430,866882,1305638390,507173,988398568,16629,1.26125686920165,839102,709904261.607704,86388558925171.0,522.656441717791,1853496,19681906.0
1182,BTC,2024-04-14,1251167002,1303079519,384854,848904,1306023244,473328,988871896,14678,1.41898165079907,839259,683283416.697003,86388558925171.0,543.019230769231,1933188,19682937.0
1182,BTC,2024-04-15,1251524518,1303510936,431417,866800,1306454661,503358,989375254,19049,1.86429669156125,839400,609533389.029758,86388558925171.0,608.721428571428,1686045,19683775.0
1182,BTC,2024-04-16,1251902664,1303926258,415322,949038,1306869983,454669,989829923,20605,2.26217148095206,839565,705620736.055444,86388558925171.0,525.829268292683,1936371,19684812.0
1182,BTC,2024-04-17,1252176069,1304288231,361973,794322,1307231956,385606,990215529,18607,2.58578943294858,839702,596944361.959687,86388558925171.0,621.558823529411,2018377,19685675.0
1182,BTC,2024-04-18,1252488262,1304675151,386920,828634,1307618876,418095,990633624,18429,2.36574905504601,839847,626213817.088802,86388558925171.0,592.506944444444,1926395,19686606.0
1182,BTC,2024-04-19,1252756642,1305066746,391595,895458,1308010471,393190,991026814,19998,2.06464672511389,839998,651146037.92808,86388558925171.0,569.82,1776053,19687518.0
1182,BTC,2024-04-20,1252935696,1305333906,267160,513263,1308277631,631001,991657815,10734,0.610649208667245,840128,561305569.915693,86388558925171.0,661.023255813954,1452106,19687928.0
1182,BTC,2024-04-21,1253146672,1305600037,266131,579036,1308543762,641668,992299483,10398,0.745895311227286,840268,604179950.225777,86388558925171.0,614.115107913669,1478085,19688375.0
1182,BTC,2024-04-22,1253426505,1305916732,316695,682700,1308860457,671771,992971254,13432,1.03421352139085,840420,649303386.780847,86388558925171.0,571.437086092715,1522667,19688834.0
1182,BTC,2024-04-23,1253631963,1306178279,261547,535269,1309122004,927010,993898264,12697,0.792407145190181,840588,717588135.363164,86388558925171.0,517.059880239521,1432550,19689343.0
1182,BTC,2024-04-24,1253949112,1306502406,324127,840149,1309446131,606713,994504977,15066,1.29578072875534,840743,695231411.698461,87185497750595.5,538.610389610389,1568990,19689834.0
1182,BTC,2024-04-25,1254240076,1306799927,297521,826067,1309743652,523070,995028047,14712,1.17509838771147,840886,654583568.467943,88104191118793.2,578.084507042253,1566181,19690284.0
1182,BTC,2024-04-26,1254541800,1307183373,383446,874788,1310127098,445519,995473566,16661,1.76024492034966,841019,583398464.965767,88104191118793.2,648.621212121212,1575728,19690703.0
1182,BTC,2024-04-27,1254860126,1307580176,396803,884525,1310523901,452967,995926533,12512,1.22858442936373,841159,625120239.953284,88104191118793.2,605.330935251799,1556770,19691150.0
1182,BTC,2024-04-28,1255185608,1307908331,328155,721232,1310852056,487521,996414054,12135,1.15706082321494,841299,620159904.142114,88104191118793.2,610.172661870504,1664185,19691578.0
1182,BTC,2024-04-29,1255542638,1308248531,340200,864590,1311192256,403064,996817118,15582,1.91600228034982,841430,573614437.370393,88104191118793.2,659.684615384615,1654593,19691987.0
1182,BTC,2024-04-30,1255876375,1308619748,371217,864726,1311563473,498085,997315203,19041,1.91029310464483,841571,619016226.886553,88104191118793.2,611.3,1591544,19692434.0
1182,BTC,2024-05-01,1256185607,1308944031,324283,793233,1311887756,478881,997794084,18271,1.84912426603096,841703,575657343.389345,88104191118793.2,657.343511450382,1614335,19692837.0
1182,BTC,2024-05-02,1256510147,1309247771,303740,761983,1312191496,559839,998353923,16382,1.31811922457632,841848,650272867.52814,88104191118793.2,581.916666666667,1632212,19693303.0
1182,BTC,2024-05-03,1256795311,1309559908,312137,730435,1312503633,442742,998796665,15589,1.55998164990613,841977,573700253.419594,88104191118793.2,659.5859375,1608862,19693687.0
1182,BTC,2024-05-04,1257016718,1309846805,286897,625305,1312790530,660263,999456928,12235,0.687028221000359,842118,636241478.765449,88104191118793.2,594.75,1492956,19694140.0
1182,BTC,2024-05-05,1257241951,1310100320,253515,590888,1313044045,625998,1000082926,11211,0.708541985432861,842257,610180267.704438,88104191118793.2,620.152173913043,1461377,19694578.0
1182,BTC,2024-05-06,1257504186,1310373292,272972,669797,1313317017,519817,1000602743,15430,1.29399956842141,842379,533206308.986571,88104191118793.2,709.677685950413,1561740,19694950.0
1182,BTC,2024-05-07,1257801478,1310656543,283251,714029,1313600268,372643,1000975386,14755,1.87847127913282,842501,534120654.180694,88104191118793.2,708.462809917355,1768426,19695325.0
1182,BTC,2024-05-08,1258109431,1310970469,313926,698761,1313914194,450856,1001426242,14514,1.47827950001856,842628,555265492.639367,88104191118793.2,681.484126984128,1702058,19695721.0
1182,BTC,2024-05-09,1258395569,1311278242,307773,690029,1314221967,517193,1001943435,15175,1.35275657879353,842773,625339740.310819,85164867739885.6,584.930555555556,1839527,19696200.0
1182,BTC,2024-05-10,1258609973,1311545686,267444,617192,1314489411,713791,1002657226,14232,0.990841901641797,842918,600488132.04933,83148355189239.8,594.715277777778,1538856,19696640.0
1182,BTC,2024-05-11,1258866052,1311810886,265200,619134,1314754611,719306,1003376532,11992,0.603626596952632,843077,664760552.169278,83148355189239.8,537.215189873418,1606500,19697137.0
1182,BTC,2024-05-12,1259122570,1312036666,225780,577382,1314980391,557164,1003933696,10340,0.886088495108245,843209,551357101.700306,83148355189239.8,647.709923664122,1726513,19697556.0
1182,BTC,2024-05-13,1259466756,1312307608,270942,741821,1315251333,554780,1004488476,15519,1.39180121562098,843356,609875100.279331,83148355189239.8,585.561643835616,1648835,19698003.0
1182,BTC,2024-05-14,1259754399,1312575242,267634,697325,1315518967,422043,1004910519,14403,1.64224558396538,843492,577918629.909219,83148355189239.8,617.940740740741,1616100,19698425.0
1182,BTC,2024-05-15,1260051100,1312881422,306180,736651,1315825147,493012,1005403531,17893,1.69926116967747,843633,581918890.039884,83148355189239.8,613.692857142857,1626940,19698875.0
1182,BTC,2024-05-16,1260331891,1313171302,289880,694288,1316115027,476659,1005880190,16237,1.85497780289593,843775,592942285.177112,83148355189239.8,602.283687943263,1628413,19699315.0
1182,BTC,2024-05-17,1260635327,1313470307,299005,751695,1316414032,573492,1006453682,15342,1.45287116630537,843930,647008832.873877,83148355189239.8,551.954545454546,1533187,19699809.0
1182,BTC,2024-05-18,1260920855,1313729001,258694,640101,1316672726,401264,1006854946,12212,1.32576665517285,844058,531104176.006546,83148355189239.8,672.409448818898,1453582,19700162.0
1182,BTC,2024-05-19,1261232805,1313979973,250972,657375,1316923698,644119,1007499065,11795,0.840723183693883,844212,645503370.943204,83148355189239.8,553.241830065359,1583084,19700678.0
1182,BTC,2024-05-20,1261536363,1314271958,291985,708055,1317215683,626995,1008126060,17833,1.28577474156523,844368,643421100.422718,83148355189239.8,555.032258064516,1767408,19701165.0
1182,BTC,2024-05-21,1261855189,1314564725,292767,754610,1317508450,545041,1008671101,20059,1.80393323763166,844506,569933447.611887,83148355189239.8,626.598540145985,1651607,19701603.0
1182,BTC,2024-05-22,1262158494,1314849564,284839,722431,1317793289,583279,1009254380,16391,1.31405871629332,844659,630257165.239756,83148355189239.8,566.625,1660516,19702053.0
1182,BTC,2024-05-23,1262464199,1315158746,309182,731550,1318102471,744761,1009999141,17078,0.873519729386179,844828,704748412.51161,84060416283612.3,512.291666666667,1584221,19702612.0
1182,BTC,2024-05-24,1262720685,1315437196,278450,666107,1318380921,736439,1010735580,16043,0.870982457908218,844988,687039731.316407,84381461788831.3,527.503144654088,1642964,19703090.0
1182,BTC,2024-05-25,1262949708,1315710968,273772,613764,1318654693,835040,1011570620,12619,0.433999231138963,845148,674454965.995236,84381461788831.3,537.345911949686,1566291,19703612.0
1182,BTC,2024-05-26,1263161101,1315956203,245235,548475,1318899928,852655,1012423275,11533,0.598845839425418,845316,713391345.193539,84381461788831.3,508.017964071856,1665902,19704131.0
1182,BTC,2024-05-27,1263408939,1316207872,251669,612315,1319151597,551610,1012974885,14110,1.0415650432957,845439,518988490.8579,84381461788831.3,698.311475409836,1598298,19704478.0
1182,BTC,2024-05-28,1263694910,1316471521,263649,658785,1319415246,596790,1013571675,15309,1.72729767981937,845573,580472522.178239,84381461788831.3,624.345864661655,1572531,19704756.0
1182,BTC,2024-05-29,1263865608,1316729211,257690,564248,1319672936,725428,1014297103,15621,0.989364234311882,845710,576527910.833198,84381461788831.3,628.617647058823,1505085,19705290.0
1182,BTC,2024-05-30,1264084934,1317010494,281283,653494,1319954219,510417,1014807520,17639,1.40009157312781,845833,517857876.436495,84381461788831.3,699.83606557377,1519309,19705731.0
1182,BTC,2024-05-31,1264317821,1317312032,301538,690971,1320255757,701471,1015508991,19024,1.21247506998962,845981,625147805.203479,84381461788831.3,579.727891156463,1496344,19706225.0
1182,BTC,2024-06-01,1264505395,1317567905,255873,574551,1320511630,740030,1016249021,14383,0.586352944602151,846122,592438221.781565,84381461788831.3,611.735714285715,1501787,19706653.0
1182,BTC,2024-06-02,1264708709,1317792700,224795,549032,1320736425,729202,1016978223,11255,0.799285018884095,846262,589176522.294998,84381461788831.3,615.122302158273,1516947,19707103.0
1182,BTC,2024-06-03,1264975998,1318066598,273898,683287,1321010323,769224,1017747447,16287,1.18127484026801,846419,663087582.285234,84381461788831.3,546.557692307692,1542151,19707384.0
1182,BTC,2024-06-04,1265209953,1318340808,274210,659985,1321284533,627980,1018375427,16464,1.36442853608644,846553,564576430.104909,84381461788831.3,641.924812030075,1575356,19707825.0
1182,BTC,2024-06-05,1265399163,1318595413,254605,597581,1321539138,562049,1018937476,16428,1.77686596615982,846676,514279962.432223,84381461788831.3,704.704918032787,1544365,19708053.0
1182,BTC,2024-06-06,1265604797,1318855536,260123,619404,1321799261,613472,1019550948,15664,1.26370969385465,846809,563055433.568725,83931592439295.9,640.227272727273,1584500,19708475.0
1182,BTC,2024-06-07,1265740218,1319060419,204883,604495,1322004144,263982,1019814930,13202,2.57751005948307,846951,594070794.012917,83716654861184.5,605.248226950354,1328911,19709262.0
1182,BTC,2024-06-08,1265967574,1319320468,260049,771041,1322264193,509927,1020324857,12809,0.999552726142154,847123,721991667.494616,83716654861184.5,498.011695906433,1425803,19709771.0
1182,BTC,2024-06-09,1266176637,1319569417,248949,625266,1322513142,767920,1021092777,10891,0.539629187947247,847276,646117781.732591,83716654861184.5,556.493421052631,1533861,19710246.0
1182,BTC,2024-06-10,1266443568,1319827841,258424,685238,1322771566,658037,1021750814,14732,1.0324990020856,847415,587767361.724524,83716654861184.5,611.739130434783,1559873,19710653.0
1182,BTC,2024-06-11,1266720834,1320098768,270927,712795,1323042493,463737,1022214551,16840,1.78365957812771,847538,513898265.705664,83716654861184.5,699.672131147541,1573228,19711075.0
1182,BTC,2024-06-12,1266988116,1320364245,265477,687286,1323307970,690560,1022905111,15839,0.977119913657742,847684,606207185.015808,83716654861184.5,593.131034482759,1551412,19711525.0
1182,BTC,2024-06-13,1267203300,1320622851,258606,622810,1323566576,731254,1023636365,15211,0.793409666087748,847829,600072811.24357,83716654861184.5,599.194444444444,1550126,19711928.0
1182,BTC,2024-06-14,1267385575,1320881383,258532,600482,1323825108,604349,1024240714,15396,1.20691728195129,847957,541416582.893837,83716654861184.5,664.110236220472,1472245,19712175.0
1182,BTC,2024-06-15,1267629806,1321118151,236768,642196,1324061876,452945,1024693659,12171,1.04689482160587,848091,565740978.871012,83716654861184.5,635.556390977444,1473827,19712671.0
1182,BTC,2024-06-16,1268008619,1321357781,239630,752853,1324301506,461748,1025155407,10859,0.984984331363124,848254,679729826.487359,83716654861184.5,528.975308641975,1572709,19713331.0
1182,BTC,2024-06-17,1268363437,1321605111,247330,745620,1324548836,441215,1025596622,13910,1.71905395677169,848394,588644732.012764,83716654861184.5,610.827338129496,1587256,19713737.0
1182,BTC,2024-06-18,1268692207,1321881697,276586,732985,1324825422,617202,1026213824,15920,1.33021089699196,848546,634115514.986456,83716654861184.5,567.026490066225,1583614,19714215.0
1182,BTC,2024-06-19,1268934629,1322134433,252736,637709,1325078158,634554,1026848378,13785,0.960906353557963,848683,576544520.930788,83716654861184.5,623.64705882353,1608051,19714559.0
1182,BTC,2024-06-20,1269206178,1322394625,260192,663117,1325338350,532756,1027381134,14820,1.17890598683324,848816,551242733.263758,83691445854747.7,652.075757575758,1620019,19714762.0
1182,BTC,2024-06-21,1269503192,1322696127,301502,723090,1325639852,592843,1027973977,15612,1.16446192509388,848956,582311444.650282,83675262295059.9,617.165467625899,1614374,19715137.0
1182,BTC,2024-06-22,1269794221,1322977636,281509,648883,1325921361,681420,1028655397,11218,0.527868988766796,849108,633040452.746805,83675262295059.9,567.708609271524,1613912,19715434.0
1182,BTC,2024-06-23,1270014921,1323187730,210094,531983,1326131455,492352,1029147749,10564,0.718531087448675,849220,467501777.468469,83675262295059.9,768.72972972973,1659104,19715753.0
1182,BTC,2024-06-24,1270366488,1323450887,263157,757276,1326394612,528326,1029676075,17509,1.75268787339037,849372,629822424.865568,83675262295059.9,570.609271523179,1608571,19716321.0
1182,BTC,2024-06-25,1270650257,1323705447,254560,651605,1326649172,536347,1030212422,15599,1.16252351911779,849496,518030368.214424,83675262295059.9,693.747967479674,1568532,19716756.0
1182,BTC,2024-06-26,1270914747,1323989833,284386,654474,1326933558,490817,1030703239,15596,1.45681230694756,849617,503513155.92505,83675262295059.9,713.75,1619558,19717387.0
1182,BTC,2024-06-27,1271238121,1324292991,303158,744585,1327236716,414624,1031117863,15433,2.97549070438892,849747,540979782.72698,83675262295059.9,664.317829457365,1666994,19717978.0
1182,BTC,2024-06-28,1271575575,1324649330,356339,758429,1327593055,593984,1031711847,15951,1.29628791592107,849882,568093158.140398,83675262295059.9,632.611940298508,1626965,19718253.0
1182,BTC,2024-06-29,1271910461,1324972563,323233,731018,1327916288,712249,1032424096,12215,0.636404003964878,850039,659689031.552329,83675262295059.9,544.775641025641,1638790,19718600.0
1182,BTC,2024-06-30,1272210976,1325278980,306417,674631,1328222705,505127,1032929223,12397,0.738854943903711,850160,501079425.150239,83675262295059.9,717.216666666667,1587947,19718878.0
1182,BTC,2024-07-01,1272642778,1325713962,434982,901754,1328657687,611062,1033540285,17331,1.08798274057521,850301,599899273.945518,83675262295059.9,599.071428571429,1653771,19719190.0
1182,BTC,2024-07-02,1272981012,1326007182,293220,776093,1328950907,592285,1034132570,16011,1.07073744945884,850449,616926064.847677,83675262295059.9,582.537414965987,1638245,19719350.0
1182,BTC,2024-07-03,1273319188,1326298958,291776,772869,1329242683,545044,1034677614,16006,1.35337679740537,850594,603820994.632542,83675262295059.9,595.180555555555,1648893,19719406.0
1182,BTC,2024-07-04,1273616116,1326583446,284488,721851,1329527171,538097,1035215711,16802,1.63158331242477,850734,582080745.639351,83675262295059.9,617.410071942446,1540278,19719465.0
1182,BTC,2024-07-05,1273877020,1326869894,286448,699847,1329813619,490537,1035706248,18660,2.0089590801509,850855,479208111.00192,80082477459597.5,717.75,1592418,19719534.0
1182,BTC,2024-07-06,1274165318,1327139727,269833,715900,1330083452,658042,1036364290,12644,0.818832616393938,851020,666758743.899197,79495195323031.5,512.073170731708,1518416,19719618.0
1182,BTC,2024-07-07,1274414993,1327387519,247792,625901,1330331244,673752,1037038042,11823,0.791908769701018,851161,556578758.927567,79495195323031.5,613.442857142857,1571419,19719643.0
1182,BTC,2024-07-08,1274727015,1327652273,264754,796994,1330595998,593010,1037631052,15489,1.5767021722447,851320,625125425.60542,79495195323031.5,546.177215189873,1609362,19719700.0
1182,BTC,2024-07-09,1275062648,1327928978,276705,764029,1330872703,654037,1038285089,15326,1.26031445944624,851474,609773400.034289,79495195323031.5,559.928104575164,1564930,19719790.0
1182,BTC,2024-07-10,1275322084,1328199117,270139,653247,1331142842,631745,1038916834,16054,1.33659977307038,851610,545491617.005249,79495195323031.5,625.911111111111,1550128,19719856.0
1182,BTC,2024-07-11,1275587462,1328485539,286422,670509,1331429264,642066,1039558900,15233,1.24207125743621,851750,562713189.747516,79495195323031.5,606.755395683453,1590616,19719987.0
1182,BTC,2024-07-12,1275879251,1328768210,282671,713437,1331711935,658355,1040217255,15157,1.12050452192061,851900,594143702.129442,79495195323031.5,574.657718120805,1572185,19720159.0
1182,BTC,2024-07-13,1276108061,1329014405,246195,601751,1331958130,735686,1040952941,14026,0.733050835421416,852054,606911312.578132,79495195323031.5,562.56862745098,1557888,19720262.0
1182,BTC,2024-07-14,1276486361,1329283530,269125,767124,1332227255,586548,1041539489,12160,0.931470395196437,852221,662674888.233768,79495195323031.5,515.22891566265,1655121,19720334.0
1182,BTC,2024-07-15,1276826237,1329563271,279741,786894,1332506996,552901,1042092390,17383,1.7178459340984,852374,602175001.374238,79495195323031.5,566.993421052631,1633728,19726181.0
1182,BTC,2024-07-16,1277135903,1329847083,283812,765793,1332790808,529056,1042621446,16848,2.1446870217755,852521,586434273.600068,79495195323031.5,582.212328767124,1578336,19726631.0
1182,BTC,2024-07-17,1277443203,1330126310,279227,739941,1333070035,615870,1043237316,16903,1.3468752765197,852680,633025777.444529,79495195323031.5,539.360759493671,1603771,19727128.0
1182,BTC,2024-07-18,1277805259,1330405949,279639,768899,1333349674,445574,1043682890,15287,1.19664627884948,852809,520795636.285545,80326252623417.9,662.4453125,1653377,19727546.0
1182,BTC,2024-07-19,1278099198,1330696927,290978,755670,1333640652,507940,1044190830,16278,1.51935159779561,852956,605406696.929844,82047728459932.8,582.075342465753,1582488,19728003.0
1182,BTC,2024-07-20,1278401638,1330966293,269366,704209,1333910018,680335,1044871165,13317,0.825808779617424,853121,673374179.006419,82047728459932.8,523.323170731707,1600337,19728534.0
1182,BTC,2024-07-21,1278657304,1331221473,255180,615645,1334165198,859629,1045730794,11853,0.548345154710253,853290,694752070.165491,82047728459932.8,507.220238095238,1580112,19729034.0
1182,BTC,2024-07-22,1278989165,1331509608,288135,766008,1334453333,824999,1046555793,16185,0.989016343809011,853469,731112900.046354,82047728459932.8,481.994382022472,1599160,19729621.0
1182,BTC,2024-07-23,1279247019,1331799066,289458,671226,1334742791,838977,1047394770,16298,1.1602355168622,853638,687267481.861273,82047728459932.8,512.744047619048,1591590,19730134.0
1182,BTC,2024-07-24,1279542139,1332099058,299992,699632,1335042783,596458,1047991228,15749,1.24914595277473,853778,576909853.978723,82047728459932.8,610.827338129496,1606471,19730578.0
1182,BTC,2024-07-25,1279838442,1332422097,323039,721189,1335365822,719711,1048710939,16027,1.04476097589153,853941,663415350.110201,82047728459932.8,531.179012345679,1592445,19731087.0
1182,BTC,2024-07-26,1280111161,1332735351,313254,705212,1335679076,459067,1049170006,15793,1.3093657366211,854101,673782166.009205,82047728459932.8,523.006289308176,1772434,19731593.0
1182,BTC,2024-07-27,1280412833,1333053840,318489,710081,1335997565,445730,1049615736,14684,1.29794411363473,854255,632230953.673406,82047728459932.8,557.379084967321,1768343,19732062.0
1182,BTC,2024-07-28,1280651401,1333326482,272642,596191,1336270207,753703,1050369439,12547,0.498581665934022,854403,605449685.429183,82047728459932.8,582.034013605442,1628477,19732531.0
1182,BTC,2024-07-29,1281010073,1333668109,341627,798502,1336611834,826129,1051195568,18724,1.08488784972299,854581,734219782.336265,82047728459932.8,479.954802259887,1621344,19733084.0
1182,BTC,2024-07-30,1281280601,1333973444,305335,683511,1336917169,683096,1051878664,16579,1.42348918295979,854731,613529337.779746,82047728459932.8,574.369127516779,1727032,19733575.0
1182,BTC,2024-07-31,1281601909,1334299667,326223,758030,1337243392,562819,1052441483,17139,1.77301975024646,854872,618015557.644019,87487947532069.9,608.007142857143,1671133,19733978.0
1182,BTC,2024-08-01,1281930702,1334630312,330645,779211,1337574037,544430,1052985913,17350,1.44763877560643,855012,633282749.502772,90666502495565.8,614.906474820144,1647649,19734434.0
1182,BTC,2024-08-02,1282250219,1334946587,316275,763309,1337890312,410113,1053396026,16723,2.73114215153092,855137,564896620.451614,90666502495565.8,689.346774193548,1623253,19735228.0
1182,BTC,2024-08-03,1282554585,1335247165,300578,712723,1338190890,504062,1053900088,14468,0.92828835870016,855272,640657280.631991,90666502495565.8,607.828358208956,1630010,19735228.0
1182,BTC,2024-08-04,1282835075,1335528613,281448,687640,1338472338,524595,1054424683,14036,1.12923326659497,855415,644297307.917184,90666502495565.8,604.394366197183,1586410,19735690.0
1182,BTC,2024-08-05,1283181385,1335867035,338422,819383,1338810760,548857,1054973540,23984,2.49673585238317,855571,718194447.710424,90666502495565.8,542.206451612903,1635567,19736612.0
1182,BTC,2024-08-06,1283495691,1336165610,298575,741470,1339109335,485173,1055458713,17918,2.01616536962345,855711,658274571.193171,90666502495565.8,591.561151079137,1621725,19736612.0
1182,BTC,2024-08-07,1283812732,1336451340,285730,730289,1339395065,380097,1055838810,16559,2.46651898856455,855833,553951601.011064,90666502495565.8,702.96694214876,1642792,19737384.0
1182,BTC,2024-08-08,1284103478,1336777491,326151,732232,1339721216,487399,1056326209,17107,1.76269530553462,855962,581269453.088922,90666502495565.8,669.9296875,1585968,19737384.0
1182,BTC,2024-08-09,1284384452,1337075748,298257,698355,1340019473,396419,1056722628,15919,2.25163191344002,856092,589329374.287466,90666502495565.8,660.767441860465,1842825,19737781.0
1182,BTC,2024-08-10,1284638457,1337346839,271091,617452,1340290564,548777,1057271405,12393,0.958994455421765,856221,608408037.397507,90666502495565.8,640.046875,1605718,19738209.0
1182,BTC,2024-08-11,1284932642,1337598812,251973,637110,1340542537,644814,1057916219,11390,0.906552791328398,856382,730719701.754335,90666502495565.8,532.9125,1541161,19738721.0
1182,BTC,2024-08-12,1285272148,1337876223,277411,713522,1340819948,450024,1058366243,15577,1.85290305389937,856519,622184402.734025,90666502495565.8,625.875,1672700,19739112.0
1182,BTC,2024-08-13,1285594141,1338181138,304915,715028,1341124863,579618,1058945861,17313,1.547156056907,856668,673884570.619029,90666502495565.8,577.858108108109,1603523,19739600.0
1182,BTC,2024-08-14,1285877603,1338499858,318720,679822,1341443583,504701,1059450562,17291,1.83077012254238,856800,591195105.730467,90637752282067.3,658.473282442748,1626691,19739978.0
1182,BTC,2024-08-15,1286195500,1338811077,311219,728143,1341754802,660924,1060111486,16736,1.08163459056232,856960,692380108.309014,86871474313762.0,538.880503144654,1571723,19740525.0
1182,BTC,2024-08-16,1286494393,1339133811,322734,719578,1342077536,575811,1060687297,15607,1.21880220850357,857102,613010136.328834,86871474313762.0,608.652482269504,1611705,19740981.0
1182,BTC,2024-08-17,1286738313,1339427528,293717,623753,1342371253,702540,1061389837,11944,0.576645170862613,857251,642372891.68213,86871474313762.0,580.831081081081,1565858,19741437.0
1182,BTC,2024-08-18,1286960322,1339717427,289899,597378,1342661152,769702,1062159539,11008,0.587130515041029,857407,684071301.21008,86871474313762.0,545.425806451613,1678853,19741875.0
1182,BTC,2024-08-19,1287274307,1340011802,294375,702919,1342955527,553394,1062712933,14938,1.53547084659998,857537,581294785.098377,86871474313762.0,641.860465116279,1672389,19742775.0
1182,BTC,2024-08-20,1287545017,1340329417,317615,699632,1343273142,717337,1063430270,16533,1.15707075394172,857687,645864248.208605,86871474313762.0,577.691275167785,1620614,19742775.0
1182,BTC,2024-08-21,1287829179,1340652860,323443,712964,1343596585,687685,1064117955,15830,1.13586865956163,857834,668598718.691686,86871474313762.0,558.047945205479,1600996,19743234.0
1182,BTC,2024-08-22,1288151772,1340995718,342858,749407,1343939443,795102,1064913057,16009,0.963189463845494,857994,695488955.792365,86871474313762.0,536.471698113207,1588139,19743765.0
1182,BTC,2024-08-23,1288441554,1341313537,317819,710740,1344257262,799839,1065712896,17550,1.12042268787396,858158,708211484.321967,86871474313762.0,526.834355828221,1641721,19744278.0
1182,BTC,2024-08-24,1288687039,1341601737,288200,620619,1344545462,794380,1066507276,13790,0.707884534203555,858311,679129442.115756,86871474313762.0,549.394736842105,1598629,19744740.0
1182,BTC,2024-08-25,1288906420,1341856691,254954,546066,1344800416,705838,1067213114,12504,0.702119513305929,858444,573614472.741024,86871474313762.0,650.454545454546,1613048,19745153.0
1182,BTC,2024-08-26,1289209458,1342136998,280307,675125,1345080723,600722,1067813836,15779,1.28515228177976,858578,577912920.804002,86871474313762.0,645.616541353383,1669892,19745559.0
1182,BTC,2024-08-27,1289509232,1342437781,300783,696573,1345381506,673811,1068487647,17389,1.64067574515265,858720,613582107.53138,86871474313762.0,608.085106382979,1608522,19746025.0
1182,BTC,2024-08-28,1289848486,1342749466,311685,742764,1345693191,733530,1069221177,17157,1.3612454020781,858881,708085196.004019,87937390901164.3,533.39375,1659849,19746506.0
1182,BTC,2024-08-29,1290140182,1343080589,331123,734910,1346024314,524362,1069745539,16982,1.48086400108904,859013,586964245.042036,89471664776970.8,654.687022900764,1602930,19746946.0
1182,BTC,2024-08-30,1290528324,1343420305,339716,842120,1346364030,542101,1070287640,18920,1.33237924507974,859155,632294122.66046,89471664776970.8,607.751773049646,1653585,19747331.0
1182,BTC,2024-08-31,1290797776,1343727374,307069,672744,1346671099,701952,1070989592,15999,0.579518179704196,859302,662579356.887685,89471664776970.8,579.972602739726,1623522,19747837.0
1182,BTC,2024-09-01,1291087462,1344017633,290259,673641,1346961358,651871,1071641463,13098,1.25574407972505,859444,635468014.462473,89471664776970.8,604.716312056738,1696484,19748296.0
1182,BTC,2024-09-02,1291400430,1344316455,298822,715494,1347260180,754904,1072396367,16943,0.963177556542461,859611,747701190.957475,89471664776970.8,513.94578313253,1730503,19748818.0
1182,BTC,2024-09-03,1291691233,1344636221,319766,707139,1347579946,582751,1072979118,17995,1.68453185144993,859760,663800805.01521,89471664776970.8,578.905405405405,1752698,19749275.0
1182,BTC,2024-09-04,1291989904,1344947412,311191,710784,1347891137,722736,1073701854,16617,1.29941773753189,859911,675934673.128331,89471664776970.8,568.513333333333,1655527,19749750.0
1182,BTC,2024-09-05,1292298538,1345278426,331014,734270,1348222151,721251,1074423105,15959,1.17009097486717,860066,689239498.921603,89471664776970.8,557.538961038961,1666892,19750221.0
1182,BTC,2024-09-06,1292590962,1345602569,324143,731754,1348546294,667267,1075090372,16275,1.36248900271995,860211,657330029.525558,89471664776970.8,584.604166666667,1624362,19750662.0
1182,BTC,2024-09-07,1292846017,1345891498,288929,630274,1348835223,781426,1075871798,12557,0.587950152386496,860369,708683294.640265,89471664776970.8,542.242038216561,1634313,19751896.0
1182,BTC,2024-09-08,1293089101,1346170335,278837,602205,1349114060,910083,1076781881,13192,0.594701519956389,860536,743457344.893323,89471664776970.8,516.879518072289,1657237,19751896.0
1182,BTC,2024-09-09,1293437360,1346460768,290433,740521,1349404493,572398,1077354279,16238,1.57362476552939,860681,650239290.672849,89471664776970.8,590.979166666666,1697745,19752168.0
1182,BTC,2024-09-10,1293740357,1346757328,296560,726277,1349701053,568630,1077922909,17125,2.44619304378269,860818,611807156.030812,89471664776970.8,628.10294117647,1618473,19752559.0
1182,BTC,2024-09-11,1294001618,1347048126,290798,674875,1349991851,411402,1078334311,16453,3.03208661110444,860926,498856431.9204,92286401734175.2,794.551401869159,1636213,19752896.0
1182,BTC,2024-09-12,1294320917,1347379068,330942,787812,1350322793,563521,1078897832,16550,1.87419412764064,861078,708039557.377988,92671576265161.1,562.145695364238,1562302,19753371.0
1182,BTC,2024-09-13,1294676525,1347699113,320045,800112,1350642838,419047,1079316879,17583,2.76715064343317,861201,573972051.133812,92671576265161.1,693.450819672131,1648040,19753781.0
1182,BTC,2024-09-14,1294951414,1348006896,307783,685192,1350950621,638989,1079955868,13055,1.05088439052685,861340,644591744.439913,92671576265161.1,617.478260869565,1666151,19754190.0
1182,BTC,2024-09-15,1295238494,1348290054,283158,677072,1351233779,712474,1080668342,12523,0.821068906373973,861491,695841589.73363,92671576265161.1,572.0,1627577,19754687.0
1182,BTC,2024-09-16,1295553978,1348604690,314636,729869,1351548415,504540,1081172882,15735,1.85544917968391,861616,577051669.920459,92671576265161.1,689.75,1675311,19755053.0
1182,BTC,2024-09-17,1295911541,1348918762,314072,760469,1351862487,539113,1081711995,16526,1.57267447633452,861766,700816409.366459,92671576265161.1,567.939597315436,1850085,19755521.0
1182,BTC,2024-09-18,1296215855,1349224189,305427,717057,1352167914,541476,1082253471,16555,1.52187812071831,861904,640838292.841535,92671576265161.1,621.094890510949,1673340,19755953.0
1182,BTC,2024-09-19,1296532582,1349548942,324753,751202,1352492667,455707,1082709178,17979,1.9280325256725,862026,568306760.462617,92671576265161.1,700.363636363636,1624399,19756312.0
1182,BTC,2024-09-20,1296893581,1349878855,329913,825475,1352822580,526390,1083235568,17093,1.86175740392899,862171,672112670.190671,92671576265161.1,592.194444444445,1661256,19757209.0
1182,BTC,2024-09-21,1297170653,1350186754,307899,681013,1353130479,557444,1083793012,12564,0.746077448729164,862306,619351861.136438,92671576265161.1,642.641791044777,1654005,19757209.0
1182,BTC,2024-09-22,1297418203,1350464852,278098,606358,1353408577,628230,1084421242,11758,0.651921722269551,862442,630904653.851575,92671576265161.1,630.874074074074,1651272,19757634.0
1182,BTC,2024-09-23,1297799354,1350785505,320653,799866,1353729230,580102,1085001344,16937,1.29669325562773,862588,672905679.952747,92671576265161.1,591.496551724138,1669087,19758100.0
1182,BTC,2024-09-24,1298135115,1351104844,319339,759426,1354048569,532220,1085533564,17100,1.57065541521873,862733,671113193.484768,92671576265161.1,593.076388888889,1728119,19759006.0
1182,BTC,2024-09-25,1298435102,1351417050,312206,723710,1354360775,503460,1086037024,17632,1.62250079548073,862877,658848243.417088,91782581703877.5,598.321678321678,1714965,19759006.0
1182,BTC,2024-09-26,1298724864,1351728525,311475,732944,1354672250,474766,1086511790,18424,1.77246243828429,863007,579767860.91589,88404402370999.9,654.906976744186,1597736,19759400.0
1182,BTC,2024-09-27,1299017716,1352052841,324316,762364,1354996566,451723,1086963513,18894,1.78788561305831,863144,603675313.453335,88404402370999.9,628.970588235294,1736522,19759809.0
1182,BTC,2024-09-28,1299263900,1352346915,294074,656818,1355290640,507707,1087471220,13366,0.910854811300691,863273,569563274.074198,88404402370999.9,666.640625,1775521,19760221.0
1182,BTC,2024-09-29,1299565843,1352637777,290862,689180,1355581502,687427,1088158647,12641,0.711778317138576,863428,684605947.932982,88404402370999.9,554.616883116883,1641796,19760703.0
1182,BTC,2024-09-30,1299867170,1352949554,311777,738362,1355893279,594224,1088752871,18256,1.65967541265243,863565,600886536.797866,88404402370999.9,631.889705882353,1637883,19761156.0
1182,BTC,2024-10-01,1300196032,1353268071,318517,868160,1356211796,632894,1089385765,18791,1.42431289780044,863722,695957732.471485,88404402370999.9,545.570512820513,1612238,19761668.0
1182,BTC,2024-10-02,1300501306,1353570892,302821,729992,1356514617,590981,1089976746,17697,1.34312117948015,863877,693192638.304553,88404402370999.9,547.746753246753,1645308,19762140.0
1182,BTC,2024-10-03,1300801325,1353888656,317764,749547,1356832381,582777,1090559523,17264,1.52017696182632,864035,693130094.762121,88404402370999.9,547.796178343949,1647164,19762634.0
1182,BTC,2024-10-04,1301114820,1354229221,340565,784401,1357172946,561425,1091120948,16094,1.43043346341014,864204,751337984.181225,88404402370999.9,505.357142857143,1740484,19763153.0
1182,BTC,2024-10-05,1301327871,1354513151,283930,624064,1357456876,757575,1091878523,12663,0.556442150081853,864355,663932277.384568,88404402370999.9,571.886666666667,1533021,19763643.0
1182,BTC,2024-10-06,1301565319,1354786281,273130,626048,1357730006,742158,1092620681,12209,0.758500651378143,864507,664863007.257999,88404402370999.9,571.086092715232,1573013,19764062.0
1182,BTC,2024-10-07,1301854617,1355082745,296464,721075,1358026470,717700,1093338381,15945,1.39225477421594,864662,683022563.269094,88404402370999.9,555.902597402597,1593140,19764584.0
1182,BTC,2024-10-08,1302226193,1355438015,355270,839864,1358381740,719458,1094057839,17620,1.48537928141554,864829,737123356.251235,88404402370999.9,515.102409638554,1595826,19765093.0
1182,BTC,2024-10-09,1302484390,1355724004,285989,682217,1358667729,536887,1094594726,15424,1.51292579324098,864956,580600176.435498,91073716327741.3,673.714285714286,1575953,19765478.0
1182,BTC,2024-10-10,1302768954,1356016794,292790,706423,1358960519,746211,1095340937,16149,0.860549522355728,865111,716939070.230965,92049594548485.5,551.441558441558,1561843,19765953.0
1182,BTC,2024-10-11,1303054208,1356285178,268384,724227,1359228903,633252,1095974189,16583,1.01019191997747,865251,645579335.188103,92049594548485.5,612.395683453238,1624266,19766412.0
1182,BTC,2024-10-12,1303261806,1356542734,257556,609678,1359486459,736321,1096710510,13748,0.525577491525435,865394,652870713.042416,92049594548485.5,605.556338028169,1537605,19766859.0
1182,BTC,2024-10-13,1303508326,1356791356,248622,616041,1359735081,648739,1097359249,11496,0.558484004483097,865532,639437922.091345,92049594548485.5,618.277372262774,1537622,19767303.0
1182,BTC,2024-10-14,1303823607,1357072292,280936,723207,1360016017,611683,1097970932,17271,0.990648818712863,865671,636100032.074398,92049594548485.5,621.521739130435,1576203,19767725.0
1182,BTC,2024-10-15,1304184087,1357373187,300895,798170,1360316912,646891,1098617823,18354,1.29286371483587,865827,722615618.975375,92049594548485.5,547.109677419355,1612333,19768221.0
1182,BTC,2024-10-16,1304407495,1357640602,267415,637523,1360584327,708342,1099326165,17256,0.990870183258821,865968,663856068.934486,92049594548485.5,595.535714285714,1532007,19768671.0
1182,BTC,2024-10-17,1304737744,1357961465,320863,764377,1360905190,653027,1099979192,16746,0.90804138015128,866125,724782002.47427,92049594548485.5,545.474358974359,1618090,19769162.0
1182,BTC,2024-10-18,1305102592,1358339255,377790,816309,1361282980,474279,1100453471,17460,1.38621764596632,866261,624843412.393712,92049594548485.5,632.718518518519,1512212,19769568.0
1182,BTC,2024-10-19,1305433418,1358678029,338774,740487,1361621754,735561,1101189032,12775,0.517037219049202,866434,790562107.651903,92049594548485.5,500.087209302326,1687283,19770109.0
1182,BTC,2024-10-20,1305810755,1359025575,347546,764811,1361969300,778073,1101967105,12098,0.477289110229374,866607,792459994.752047,92049594548485.5,498.889534883721,1581188,19770671.0
1182,BTC,2024-10-21,1306117480,1359316079,290504,729651,1362259804,835011,1102802116,17433,0.790711892301,866778,783081078.137263,92049594548485.5,504.864705882353,1579282,19771171.0
1182,BTC,2024-10-22,1306350041,1359596942,280863,638458,1362540667,700174,1103502290,16478,0.96052307648853,866916,646346250.428266,93021007793487.8,618.124087591241,1576744,19771596.0
1182,BTC,2024-10-23,1306669236,1359891359,294417,733376,1362835084,665187,1104167477,16256,0.798719170217939,867067,736910521.493203,95672703408223.9,557.613333333333,1604572,19772096.0
1182,BTC,2024-10-24,1306933223,1360151857,260498,686982,1363095582,681834,1104849311,16201,0.854327800403617,867214,700174192.193335,95672703408223.9,586.869863013699,1580098,19772571.0
1182,BTC,2024-10-25,1307319966,1360505085,353228,858793,1363448810,524014,1105373325,18387,1.10757549546892,867367,734140744.30517,95672703408223.9,559.717105263158,1748851,19773493.0
1182,BTC,2024-10-26,1307653718,1360829732,324648,747097,1363773458,597744,1105971069,13411,0.595416420082042,867513,690526907.080527,95672703408223.9,595.068965517242,1719949,19773493.0
1182,BTC,2024-10-27,1307954636,1361123816,294084,660312,1364067542,700814,1106671883,12811,0.447189965948297,867674,766732532.086075,95672703408223.9,535.925,1730560,19774509.0
1182,BTC,2024-10-28,1308312705,1361455514,331698,780691,1364399240,702824,1107374707,18787,0.914480006369717,867842,821065114.650255,95672703408223.9,500.461077844311,1703211,19774509.0
1182,BTC,2024-10-29,1308670905,1361806962,351448,841195,1364750688,614981,1107989688,24069,1.57684548677234,867999,758569258.642003,95672703408223.9,541.692307692308,1705674,19775028.0
1182,BTC,2024-10-30,1309010972,1362142382,335420,799374,1365086108,682099,1108671787,21571,1.34061410257164,868168,817346320.381039,95672703408223.9,502.738095238095,1723988,19775528.0
1182,BTC,2024-10-31,1309370422,1362483158,340776,805207,1365426884,562237,1109234024,20086,1.49731132106444,868326,752040564.260725,95672703408223.9,546.394904458599,1729589,19776056.0
1182,BTC,2024-11-01,1309727174,1362811475,328317,818905,1365755201,547888,1109781912,19039,1.42059258112187,868479,737521604.298781,95672703408223.9,557.151315789474,1764261,19776515.0
1182,BTC,2024-11-02,1310011832,1363115921,304446,701405,1366059647,544612,1110326524,14649,0.586966160844473,868620,694668210.500189,95672703408223.9,591.521428571429,1736121,19776940.0
1182,BTC,2024-11-03,1310279841,1363395444,279523,642388,1366339170,455402,1110781926,13133,0.763289116852583,868752,630342498.28247,95672703408223.9,651.885496183206,1779220,19777378.0
1182,BTC,2024-11-04,1310653272,1363704499,309055,803703,1366648225,456826,1111238752,16983,1.42342838228505,868903,727527680.041741,95989214149657.6,566.673333333333,1785635,19777825.0
1182,BTC,2024-11-05,1310965886,1364023007,318508,768687,1366966733,465286,1111704038,18434,1.57539686493415,869042,706896194.325584,101646843652785.0,617.586956521739,1742826,19778253.0
1182,BTC,2024-11-06,1311349853,1364397674,374667,904330,1367341400,501641,1112205679,27416,2.52957238964606,869195,774032965.006956,101646843652785.0,564.019736842105,1665464,19778753.0
1182,BTC,2024-11-07,1311687487,1364755540,357866,811824,1367699266,553047,1112758726,22406,1.63124392422657,869351,797007523.063994,101646843652785.0,547.761290322581,1697452,19779246.0
1182,BTC,2024-11-08,1312031432,1365106300,350760,835696,1368050026,497146,1113255872,21941,1.91775643019976,869493,724209411.532949,101646843652785.0,602.822695035461,1626071,19780103.0
1182,BTC,2024-11-09,1312282402,1365413210,306910,674902,1368356936,577368,1113833240,15335,0.954444388161363,869632,712615378.609543,101646843652785.0,612.630434782609,1550832,19780550.0
1182,BTC,2024-11-10,1312611215,1365762549,349339,799147,1368706275,558278,1114391518,21441,1.44902969469401,869780,749979791.712745,101646843652785.0,582.108843537415,1637452,19780990.0
1182,BTC,2024-11-11,1312994822,1366136912,374363,935463,1369080638,462458,1114853976,30503,2.60492404979241,869916,692398171.359206,101646843652785.0,630.518518518518,1628185,19780990.0
1182,BTC,2024-11-12,1313451495,1366579728,442816,1008034,1369523454,503677,1115357653,33334,2.74753985340355,870062,767146539.966298,101646843652785.0,569.082758620689,1605913,19781459.0
1182,BTC,2024-11-13,1313760681,1366959737,380009,873041,1369903463,570979,1115928632,30625,2.14177457724216,870200,693643124.864383,101646843652785.0,629.386861313868,1564433,19781884.0
1182,BTC,2024-11-14,1314088363,1367311834,352097,845136,1370255560,503566,1116432198,25558,2.10125668232643,870327,644723435.572228,101646843652785.0,677.142857142857,1571146,19782284.0
1182,BTC,2024-11-15,1314490027,1367686353,374519,904538,1370630079,562223,1116994421,23501,1.65080952018203,870477,758950757.975478,101646843652785.0,575.228187919463,1606008,19782768.0
1182,BTC,2024-11-16,1314858063,1368051065,364712,826693,1370994791,602655,1117597076,19384,0.870818624143316,870634,796027158.819167,101646843652785.0,548.435897435897,1670356,19783209.0
1182,BTC,2024-11-17,1315154946,1368373035,321970,724309,1371316761,598496,1118195572,18016,0.743150003170113,870784,760023724.299204,101646843652785.0,574.41610738255,1704733,19783721.0
1182,BTC,2024-11-18,1315506714,1368703695,330660,818905,1371647421,673308,1118868880,22946,1.32022916097317,870940,789988696.432045,101766294632437.0,553.277419354839,1598452,19784221.0
1182,BTC,2024-11-19,1315812784,1369023463,319768,766309,1371967189,810805,1119679685,23185,1.16355285723434,871115,895498815.213529,102289407543324.0,490.597701149426,1575986,19784737.0
1182,BTC,2024-11-20,1316101182,1369356998,333535,769104,1372300724,664866,1120344551,25390,1.51966676096236,871262,754063275.9442,102289407543324.0,582.616438356164,1543573,19785215.0
1182,BTC,2024-11-21,1316517607,1369769276,412278,978212,1372713002,498512,1120843063,32017,2.88387234755671,871406,730674700.201069,102289407543324.0,601.265734265734,1592671,19785687.0
1182,BTC,2024-11-22,1316858957,1370150493,381217,899823,1373094219,540305,1121383368,28081,1.98869061095244,871549,735427120.0295,102289407543324.0,597.38028169014,1584046,19786525.0
1182,BTC,2024-11-23,1317254750,1370521337,370844,889745,1373465063,444699,1121828067,22828,1.61839495968918,871687,702197580.759659,102289407543324.0,625.649635036496,1598747,19786525.0
1182,BTC,2024-11-24,1317614408,1370846094,324757,815204,1373789820,463289,1122291356,19498,1.22258191464164,871821,692193768.767387,102289407543324.0,634.691729323309,1631773,19787487.0
1182,BTC,2024-11-25,1318073335,1371209541,363447,948901,1374153267,604870,1122896226,24696,1.67282917792058,871990,863607868.823517,102289407543324.0,508.714285714285,1656095,19787487.0
1182,BTC,2024-11-26,1318400900,1371544395,334854,806448,1374488121,475689,1123371915,24065,2.03218026441801,872129,703490248.399987,102289407543324.0,624.5,1546172,19787918.0
1182,BTC,2024-11-27,1318736737,1371907804,363409,821359,1374851530,462119,1123834034,23200,1.67410036390743,872262,685284495.374887,102289407543324.0,641.090909090909,1640345,19788775.0
1182,BTC,2024-11-28,1319024112,1372253488,345684,754855,1375197214,523480,1124357514,20560,1.13589880615338,872404,724839190.715491,102289407543324.0,606.106382978723,1639523,19788775.0
1182,BTC,2024-11-29,1319292054,1372579362,325874,781192,1375523088,341781,1124699295,22008,2.06147519054772,872525,613846108.880525,102289407543324.0,715.7,1504183,19789106.0
1182,BTC,2024-11-30,1319637829,1372926325,346963,835567,1375870051,640943,1125340238,19405,0.736511396413176,872689,834332221.83973,102289407543324.0,526.564417177914,1634260,19789671.0
1182,BTC,2024-12-01,1319896238,1373222143,295818,731961,1376165869,698223,1126038461,17962,0.593863396069436,872847,814178460.518541,102289407543324.0,539.598726114649,1574708,19790153.0
1182,BTC,2024-12-02,1320297546,1373564001,341858,937039,1376507727,311811,1126350272,24133,2.96442764703064,872974,675400328.351115,102892719959890.0,654.309523809524,1533307,19790568.0
1182,BTC,2024-12-03,1320675336,1373923482,359481,934682,1376867208,439519,1126789791,25833,1.92411566493576,873131,809059998.486028,103919634711492.0,551.666666666667,1547664,19790568.0
1182,BTC,2024-12-04,1321057268,1374291783,368301,902545,1377235509,502912,1127292703,25956,1.70011220390882,873278,758272116.464501,103919634711492.0,588.616438356165,1557698,19790568.0
1182,BTC,2024-12-05,1321436208,1374705417,413634,978951,1377649143,512490,1127805193,33450,2.84505935575557,873433,805633519.35947,103919634711492.0,554.012987012987,1597057,19790568.0
1182,BTC,2024-12-06,1321784922,1375053994,348577,893460,1377997720,414643,1128219836,25440,2.55381693358935,873569,708062979.003583,103919634711492.0,630.355555555556,1555760,19790568.0
1182,BTC,2024-12-07,1322083598,1375369763,315769,793000,1378313489,456101,1128675937,19241,1.00056202902853,873711,745860576.256704,103919634711492.0,598.411347517731,1475381,19790568.0
1182,BTC,2024-12-08,1322471016,1375675669,305906,861718,1378619395,420320,1129096257,18916,1.0541365703346,873857,752439312.555698,103919634711492.0,593.179310344828,1582743,19790568.0
1182,BTC,2024-12-09,1322896450,1376005366,329697,919925,1378949092,403264,1129499521,24846,2.39499170093921,874024,872881066.371612,103919634711492.0,511.331325301205,1512851,19791915.0
1182,BTC,2024-12-10,1323337711,1376402428,397062,1009424,1379346154,441944,1129941465,25186,1.89972819702818,874178,793021984.99876,103919634711492.0,562.823529411764,1600045,19794318.0
1182,BTC,2024-12-11,1323659052,1376798581,396153,889366,1379742307,481168,1130422633,24469,1.78511101764562,874320,739732377.105327,103919634711492.0,603.368794326241,1571591,19794440.0
1182,BTC,2024-12-12,1324033601,1377217144,418563,922909,1380160870,474978,1130897611,25163,1.54410773065081,874468,765014698.209324,103919634711492.0,583.428571428571,1580802,19795237.0
1182,BTC,2024-12-13,1324439465,1377599359,382215,954034,1380543085,523585,1131421196,23902,1.41123794738417,874638,875332320.937917,103919634711492.0,509.899408284024,1603435,19795587.0
1182,BTC,2024-12-14,1324736926,1377937672,338313,794542,1380881398,517482,1131938678,20063,0.83222492727577,874797,836123951.705009,103919634711492.0,533.810126582278,1555422,19796178.0
1182,BTC,2024-12-15,1325032621,1378270203,332531,791611,1381213929,378527,1132317205,19166,1.15075585413653,874934,715839886.077869,103919634711492.0,623.507352941176,1501376,19796690.0
1182,BTC,2024-12-16,1325451679,1378660185,389982,967456,1381603911,412747,1132729952,29144,2.28747779662227,875082,791918071.388302,108242734681594.0,587.054421768708,1599290,19797134.0
1182,BTC,2024-12-17,1325760666,1379008822,348637,843371,1381952548,419707,1133149659,26982,2.14431371776861,875218,738445330.178353,108522647629298.0,631.192592592593,1613485,19797559.0
1182,BTC,2024-12-18,1326147790,1379364802,355980,887283,1382308528,414366,1133564025,25099,2.08300135096905,875362,796563786.1891,108522647629298.0,585.13986013986,1591547,19798003.0
1182,BTC,2024-12-19,1326501017,1379753576,388774,881579,1382697302,437574,1134001599,26511,2.15092228967957,875507,787887684.084802,108522647629298.0,591.583333333333,1557361,19798462.0
1182,BTC,2024-12-20,1326859732,1380142193,388617,897589,1383085919,398670,1134400269,26148,2.43396184673841,875658,816451407.36019,108522647629298.0,570.886666666667,1546212,19799412.0
1182,BTC,2024-12-21,1327149102,1380458655,316462,747213,1383402381,330225,1134730494,17603,1.36714500936413,875803,795008303.604573,108522647629298.0,586.284722222222,1618850,19799412.0
1182,BTC,2024-12-22,1327488982,1380756020,297365,767798,1383699746,336217,1135066711,15693,1.09316763732045,875958,842275827.040844,108522647629298.0,553.383116883117,1641078,19800306.0
1182,BTC,2024-12-23,1327823495,1381066552,310532,797697,1384010278,292681,1135359392,21682,3.24248446681032,876097,757138789.193648,108522647629298.0,615.608695652174,1673251,19800306.0
1182,BTC,2024-12-24,1328140950,1381386223,319671,776540,1384329949,326570,1135685962,23655,2.0128982514317,876229,737974354.778943,108522647629298.0,631.595419847328,1561172,19800734.0
1182,BTC,2024-12-25,1328429522,1381671629,285406,704587,1384615355,405831,1136091793,16733,1.12334962773115,876380,833633607.174072,108522647629298.0,559.12,1618173,19801190.0
1182,BTC,2024-12-26,1328756142,1381974522,302893,746238,1384918248,298916,1136390709,18654,2.01823106213274,876511,719864551.78753,108522647629298.0,647.484615384615,1620958,19801612.0
1182,BTC,2024-12-27,1329146249,1382321132,346610,858804,1385264858,348241,1136738950,20943,1.86620142852591,876669,856863913.299188,108522647629298.0,543.961783439491,1546255,19802109.0
1182,BTC,2024-12-28,1329441395,1382638986,317854,728645,1385582712,298580,1137037530,17549,1.28398634238331,876812,770146306.573537,108522647629298.0,605.211267605634,1685794,19802540.0
1182,BTC,2024-12-29,1329755762,1382935802,296816,714768,1385879528,419112,1137456642,17355,1.39515872836514,876970,853120897.361801,108610329323385.0,546.789808917198,1715176,19803034.0
1182,BTC,2024-12-30,1330152383,1383269669,333867,831648,1386213395,374721,1137831363,22113,2.32585413673771,877129,886698648.536254,109782075598905.0,531.759493670886,1759092,19803553.0
1182,BTC,2024-12-31,1330488167,1383591875,322206,779998,1386535601,312513,1138143876,21342,2.65032477916771,877258,700463479.505931,109782075598905.0,673.140625,1730569,19804000.0
